id_employee_employee,id_last_boss_employee,seniority_employee,work_modality_employee,office_distance_employee,low_health_days_employee,gender_employee,recruitment_channel_employee,average_permanence_employee,salary_employee,performance_score_employee,psi_score_employee,marital_estatus_employee,join_age_employee,join_year_employee,join_month_employee,performance_employee,id_last_boss_boss,work_modality_boss,office_distance_boss,low_health_days_boss,gender_boss,recruitment_channel_boss,average_permanence_boss,salary_boss,performance_score_boss,psi_score_boss,marital_estatus_boss,join_age_boss,join_year_boss,join_month_boss,performance_boss,office_distance_diff,low_health_days_diff,average_permanence_diff,salary_diff,join_days_diff,joined_after_boss,age_diff
100486,102115,1,Híbrida,0.795,2,Hombre,Ferias & Networking,2,181654,99.0,81,Soltero,24,2021,7,high,102116,Presencial,2.0,2,Mujer,Portal Web,4,1616000,94.0,76,Soltero,35,2018,12,high,1.205,0,2,1434346,-940,1,11
103752,102074,1,Híbrida,1.715,1,Mujer,Ferias & Networking,1,140986,97.0,75,Soltero,18,2018,1,high,102028,Presencial,1.35,0,Hombre,Ferias & Networking,4,1616000,80.0,83,Viudo,43,2015,12,high,-0.365,-1,3,1475014,-759,1,25
103937,102150,1,Híbrida,2.375,1,Hombre,Portal Web,6,406690,96.0,69,Soltero,37,2022,4,high,102085,Presencial,3.9,8,Mujer,Portal Web,10,1358450,85.0,75,Casado,32,2012,12,high,1.525,7,4,951760,-3413,1,-5
101744,102172,1,Híbrida,2.185,3,Hombre,Linkedin,3,249107,95.0,73,Casado,30,2023,5,high,102020,Presencial,5.58,1,Hombre,Portal Web,7,1049000,57.0,70,Casado,29,2016,4,low,3.395,-2,4,799893,-2586,1,-1
101037,102060,1,Híbrida,4.66,3,Hombre,Referidos,10,698318,95.0,81,Viudo,45,2015,6,high,102041,Presencial,4.42,3,Hombre,Referidos,16,1616000,82.0,62,Casado,45,2013,10,high,-0.2400000000000002,0,6,917682,-601,1,0
103465,102172,1,Híbrida,2.16,3,Hombre,Linkedin,3,245356,95.0,73,Casado,30,2023,5,high,102020,Presencial,5.58,1,Hombre,Portal Web,7,1049000,57.0,70,Casado,29,2016,4,low,3.42,-2,4,803644,-2586,1,-1
103718,102078,1,Híbrida,0.925,2,Mujer,Portal Web,3,370517,95.0,70,Soltero,30,2017,3,high,102143,Presencial,2.17,1,Hombre,Ferias & Networking,9,998000,83.0,76,Casado,29,2017,5,high,1.2449999999999999,-1,6,627483,57,0,-1
103206,102060,1,Híbrida,4.965,2,Mujer,Referidos,11,676490,95.0,74,Viudo,45,2016,7,high,102041,Presencial,4.42,3,Hombre,Referidos,16,1616000,82.0,62,Casado,45,2013,10,high,-0.5449999999999999,1,5,939510,-989,1,0
102932,102060,1,Híbrida,4.665,3,Hombre,Referidos,10,697802,95.0,81,Viudo,45,2015,6,high,102041,Presencial,4.42,3,Hombre,Referidos,16,1616000,82.0,62,Casado,45,2013,10,high,-0.2450000000000001,0,6,918198,-599,1,0
103179,102144,1,Híbrida,1.715,7,Mujer,Linkedin,5,856648,95.0,65,Soltero,55,2022,9,high,102156,Presencial,2.13,8,Mujer,Portal Web,11,1616000,5.0,82,Viudo,58,2015,6,low,0.4149999999999998,1,6,759352,-2649,1,3
101424,102039,1,Híbrida,2.345,3,Mujer,Portal Web,5,412667,94.0,76,Casado,30,2015,4,high,102054,Presencial,3.66,0,Hombre,Referidos,5,1616000,93.0,75,Viudo,49,2018,6,high,1.315,-3,0,1203333,1158,0,19
103534,102039,1,Híbrida,2.365,2,Mujer,Portal Web,5,407037,94.0,76,Casado,30,2015,4,high,102054,Presencial,3.66,0,Hombre,Referidos,5,1616000,93.0,75,Viudo,49,2018,6,high,1.295,-2,0,1208963,1157,0,19
101680,102061,1,Híbrida,5.21,8,Mujer,Linkedin,10,677898,92.0,87,Divorciado,45,2016,7,high,102115,Presencial,2.14,2,Hombre,Ferias & Networking,10,1203920,37.0,80,Casado,29,2012,11,low,-3.07,-6,0,526022,-1345,1,-16
100332,102140,1,Híbrida,4.34,10,Hombre,Portal Web,9,854702,92.0,75,Viudo,54,2022,8,high,102040,Presencial,2.55,0,Mujer,Portal Web,16,1616000,46.0,69,Casado,39,2012,2,low,-1.79,-10,7,761298,-3849,1,-15
103739,102070,1,Híbrida,1.545,3,Hombre,Ferias & Networking,2,228780,92.0,76,Soltero,23,2017,3,high,102035,Presencial,1.7,1,Mujer,Referidos,4,1616000,77.0,73,Viudo,38,2013,3,low,0.15500000000000003,-2,2,1387220,-1452,1,15
100086,102140,1,Híbrida,3.98,1,Hombre,Referidos,1,82596,91.0,75,Soltero,19,2022,4,high,102040,Presencial,2.55,0,Mujer,Portal Web,16,1616000,46.0,69,Casado,39,2012,2,low,-1.4300000000000002,-1,15,1533404,-3723,1,20
101520,102015,1,Híbrida,5.94,2,Mujer,Referidos,1,102758,91.0,80,Casado,11,2012,9,high,102121,Presencial,6.18,1,Mujer,Referidos,10,1358450,74.0,82,Soltero,33,2014,6,low,0.23999999999999932,-1,9,1255692,635,0,22
101657,102118,1,Híbrida,1.745,2,Mujer,Referidos,3,138291,91.0,77,Soltero,21,2020,8,high,102171,Presencial,4.76,17,Mujer,Linkedin,4,1616000,86.0,74,Soltero,39,2023,8,high,3.0149999999999997,15,1,1477709,1109,0,18
101410,102044,1,Híbrida,5.175,3,Hombre,Portal Web,2,141023,91.0,72,Casado,13,2013,2,high,102155,Presencial,1.54,1,Hombre,Ferias & Networking,14,1616000,56.0,68,Soltero,47,2023,3,low,-3.635,-2,12,1474977,3689,0,34
101277,102083,1,Híbrida,1.075,2,Mujer,Referidos,4,164792,91.0,73,Soltero,19,2017,7,high,102147,Presencial,1.61,0,Mujer,Portal Web,5,1564490,83.0,71,Soltero,44,2021,2,high,0.5350000000000001,-2,1,1399698,1313,0,25
101655,102117,1,Híbrida,2.76,2,Hombre,Linkedin,1,231963,91.0,78,Casado,27,2021,10,high,102154,Presencial,4.05,1,Mujer,Linkedin,10,1616000,90.0,80,Divorciado,48,2021,1,high,1.29,-1,9,1384037,-259,1,21
101753,102125,1,Híbrida,2.21,0,Hombre,Ferias & Networking,5,305031,91.0,79,Soltero,30,2020,12,high,102096,Híbrida,4.0,2,Mujer,Referidos,5,692000,87.0,82,Casado,29,2022,7,high,1.79,2,0,386969,583,0,-1
101737,102112,1,Híbrida,1.11,0,Mujer,Portal Web,7,329714,91.0,74,Casado,30,2019,7,high,102031,Presencial,2.27,7,Hombre,Linkedin,1,692000,83.0,74,Soltero,26,2020,6,high,1.16,7,-6,362286,354,0,-4
101275,102050,1,Híbrida,1.055,2,Hombre,Portal Web,2,327251,91.0,78,Soltero,25,2014,8,high,102069,Presencial,3.7,0,Mujer,Linkedin,11,1512980,90.0,88,Soltero,40,2017,10,high,2.6450000000000005,-2,9,1185729,1161,0,15
100408,102022,1,Híbrida,2.53,5,Mujer,Linkedin,5,351175,91.0,73,Soltero,25,2014,2,high,102081,Presencial,2.07,0,Hombre,Portal Web,6,1616000,94.0,66,Viudo,47,2020,5,high,-0.45999999999999996,-5,1,1264825,2285,0,22
100158,102134,1,Híbrida,5.64,3,Hombre,Referidos,4,428085,91.0,72,Soltero,38,2022,10,high,102135,Presencial,2.25,2,Hombre,Portal Web,5,1358450,90.0,69,Viudo,31,2012,7,high,-3.3899999999999997,-1,1,930365,-3744,1,-7
100729,102113,1,Híbrida,3.325,1,Hombre,Linkedin,5,448262,91.0,70,Casado,37,2020,12,high,102041,Presencial,2.96,2,Hombre,Portal Web,6,1152410,46.0,75,Casado,27,2012,1,low,-0.3650000000000002,1,1,704148,-3255,1,-10
100851,102104,1,Híbrida,3.74,5,Hombre,Linkedin,10,430638,91.0,77,Soltero,37,2020,11,high,102129,Híbrida,6.72,1,Mujer,Portal Web,6,743000,91.0,61,Soltero,30,2023,4,high,2.9799999999999995,-4,-4,312362,877,0,-7
101000,102071,1,Híbrida,3.43,1,Hombre,Referidos,11,428419,91.0,76,Soltero,32,2016,6,high,102171,Presencial,0.87,1,Hombre,Portal Web,11,1616000,85.0,72,Viudo,51,2023,11,high,-2.56,0,0,1187581,2715,0,19
101409,102031,1,Híbrida,5.405,3,Hombre,Portal Web,4,473280,91.0,63,Casado,31,2013,1,high,102111,Presencial,2.95,2,Hombre,Portal Web,8,1610000,76.0,87,Casado,31,2017,7,low,-2.455,-1,4,1136720,1634,0,0
101824,102045,1,Híbrida,1.605,9,Hombre,Linkedin,11,252043,91.0,83,Soltero,33,2012,11,high,102171,Presencial,3.19,3,Hombre,Portal Web,11,1616000,97.0,65,Casado,53,2023,9,high,1.585,-6,0,1363957,3979,0,20
101259,102045,1,Híbrida,1.575,2,Mujer,Linkedin,5,257498,91.0,81,Soltero,37,2015,7,high,102171,Presencial,3.19,3,Hombre,Portal Web,11,1616000,97.0,65,Casado,53,2023,9,high,1.615,1,6,1358502,2981,0,16
100736,102042,1,Híbrida,2.705,2,Mujer,Ferias & Networking,10,378369,91.0,64,Casado,36,2014,5,high,102107,Presencial,2.19,2,Hombre,Ferias & Networking,8,1616000,38.0,78,Divorciado,57,2018,6,low,-0.5150000000000001,0,-2,1237631,1511,0,21
101903,102054,1,Híbrida,2.28,2,Mujer,Portal Web,14,282057,91.0,78,Divorciado,37,2013,6,high,102044,Presencial,2.91,1,Hombre,Linkedin,17,1616000,85.0,74,Divorciado,41,2012,11,high,0.6300000000000003,-1,3,1333943,-207,1,4
100171,102159,1,Híbrida,2.34,1,Mujer,Linkedin,11,294147,91.0,70,Viudo,48,2023,4,high,102120,Híbrida,0.98,2,Hombre,Referidos,14,808000,90.0,86,Soltero,44,2022,8,high,-1.3599999999999999,1,3,513853,-248,1,-4
101949,102153,1,Híbrida,3.79,1,Hombre,Ferias & Networking,3,400367,91.0,76,Divorciado,47,2022,8,high,102143,Presencial,6.39,1,Mujer,Linkedin,5,1616000,90.0,68,Casado,41,2019,6,high,2.5999999999999996,0,2,1215633,-1151,1,-6
101371,102073,1,Híbrida,0.86,0,Hombre,Referidos,8,680247,91.0,82,Viudo,44,2015,4,high,102139,Presencial,1.98,2,Hombre,Portal Web,11,1306940,95.0,86,Soltero,37,2019,7,high,1.12,2,3,626693,1541,0,-7
100451,102043,1,Híbrida,1.58,5,Mujer,Portal Web,11,761732,91.0,74,Divorciado,44,2014,4,high,102051,Presencial,1.03,0,Hombre,Portal Web,5,1616000,60.0,76,Casado,44,2019,5,low,-0.55,-5,-6,854268,1864,0,0
101952,102077,1,Híbrida,2.81,3,Mujer,Linkedin,7,815402,91.0,76,Divorciado,49,2018,3,high,102146,Presencial,2.27,0,Hombre,Ferias & Networking,11,1306940,31.0,64,Soltero,39,2021,6,low,-0.54,-3,4,491538,1191,0,-10
101721,102129,1,Híbrida,2.72,2,Hombre,Portal Web,4,895670,91.0,68,Viudo,57,2020,4,high,102142,Presencial,2.1,2,Mujer,Linkedin,3,590000,41.0,74,Soltero,24,2020,1,low,-0.6200000000000001,0,-1,-305670,-112,1,-33
102802,102133,1,Híbrida,5.1,0,Mujer,Ferias & Networking,1,141446,91.0,77,Soltero,20,2020,12,high,102151,Híbrida,2.61,2,Hombre,Linkedin,4,1255430,98.0,65,Soltero,35,2018,2,high,-2.4899999999999998,2,3,1113984,-1010,1,15
103824,102026,1,Híbrida,1.85,6,Hombre,Portal Web,3,120417,91.0,76,Soltero,11,2012,7,high,102101,Presencial,2.7,1,Mujer,Portal Web,15,1616000,97.0,79,Casado,58,2017,6,high,0.8500000000000001,-5,12,1495583,1807,0,47
104042,102132,1,Híbrida,3.44,2,Mujer,Portal Web,3,142128,91.0,85,Soltero,22,2021,4,high,102138,Presencial,4.51,1,Hombre,Linkedin,16,1616000,25.0,80,Viudo,45,2014,3,low,1.0699999999999998,-1,13,1473872,-2595,1,23
103566,102069,1,Híbrida,2.19,2,Hombre,Linkedin,3,140841,91.0,81,Soltero,16,2014,11,high,102069,Presencial,4.64,1,Mujer,Ferias & Networking,19,1616000,47.0,74,Casado,60,2021,10,low,2.4499999999999997,-1,16,1475159,2543,0,44
104031,102084,1,Híbrida,1.5,2,Hombre,Ferias & Networking,3,183516,91.0,74,Soltero,19,2016,7,high,102171,Presencial,2.62,3,Mujer,Portal Web,14,1616000,89.0,76,Divorciado,50,2023,7,high,1.12,1,11,1432484,2562,0,31
103381,102142,1,Híbrida,3.18,6,Hombre,Portal Web,4,209682,91.0,74,Casado,28,2023,3,high,102047,Presencial,2.48,2,Hombre,Portal Web,3,1255430,90.0,66,Soltero,36,2019,7,high,-0.7000000000000002,-4,-1,1045748,-1356,1,8
103594,102065,1,Híbrida,2.09,2,Mujer,Portal Web,5,251797,91.0,77,Casado,23,2016,9,high,102026,Presencial,2.44,2,Hombre,Ferias & Networking,13,1616000,45.0,60,Divorciado,35,2014,10,low,0.3500000000000001,0,8,1364203,-721,1,12
103053,102050,1,Híbrida,2.255,4,Mujer,Portal Web,7,284920,91.0,73,Casado,22,2013,9,high,102069,Presencial,3.7,0,Mujer,Linkedin,11,1512980,90.0,88,Soltero,40,2017,10,high,1.4450000000000003,-4,4,1228060,1481,0,18
102297,102025,1,Híbrida,4.695,3,Hombre,Portal Web,3,291458,91.0,76,Casado,22,2013,1,high,102132,Presencial,1.6,0,Hombre,Portal Web,9,1616000,90.0,81,Viudo,56,2018,4,high,-3.095,-3,6,1324542,1912,0,34
103210,102068,1,Híbrida,3.99,0,Mujer,Linkedin,4,305028,91.0,73,Soltero,27,2016,12,high,102043,Híbrida,2.17,3,Mujer,Referidos,4,896000,41.0,81,Soltero,23,2012,8,low,-1.8200000000000003,3,0,590972,-1560,1,-4
103521,102069,1,Híbrida,3.265,8,Mujer,Portal Web,5,309212,91.0,77,Divorciado,27,2016,10,high,102069,Presencial,4.64,1,Mujer,Ferias & Networking,19,1616000,47.0,74,Casado,60,2021,10,low,1.3749999999999996,-7,14,1306788,1833,0,33
104099,102080,1,Híbrida,5.185,3,Hombre,Portal Web,2,327551,91.0,79,Casado,27,2016,7,high,102035,Presencial,1.93,0,Mujer,Linkedin,18,1616000,94.0,75,Viudo,47,2016,8,high,-3.255,-3,16,1288449,16,0,20
103121,102050,1,Híbrida,1.1,1,Hombre,Portal Web,2,333345,91.0,78,Soltero,25,2014,8,high,102069,Presencial,3.7,0,Mujer,Linkedin,11,1512980,90.0,88,Soltero,40,2017,10,high,2.6,-1,9,1179635,1161,0,15
103168,102126,1,Híbrida,1.865,1,Hombre,Referidos,7,370173,91.0,70,Casado,36,2022,8,high,102141,Presencial,2.5,1,Mujer,Referidos,2,1049000,94.0,79,Casado,34,2021,1,high,0.635,0,-5,678827,-574,1,-2
102526,102158,1,Híbrida,3.785,1,Mujer,Portal Web,10,390316,91.0,81,Casado,37,2022,11,high,102093,Presencial,1.79,1,Mujer,Referidos,27,1900000,87.0,74,Viudo,54,2013,9,high,-1.995,0,17,1509684,-3347,1,17
103712,102044,1,Híbrida,2.33,1,Mujer,Ferias & Networking,6,391289,91.0,61,Soltero,28,2013,8,high,102155,Presencial,1.54,1,Hombre,Ferias & Networking,14,1616000,56.0,68,Soltero,47,2023,3,low,-0.79,0,8,1224711,3506,0,19
102670,102040,1,Híbrida,1.18,1,Hombre,Portal Web,9,427278,91.0,81,Soltero,30,2014,2,high,102106,Presencial,3.21,1,Hombre,Linkedin,15,1616000,91.0,84,Soltero,45,2016,7,high,2.0300000000000002,0,6,1188722,884,0,15
103556,102067,1,Híbrida,3.91,3,Hombre,Linkedin,5,831125,91.0,73,Soltero,32,2014,9,high,102058,Presencial,0.92,1,Mujer,Portal Web,5,1616000,90.0,70,Divorciado,46,2020,8,high,-2.99,-2,0,784875,2188,0,14
102817,102028,1,Híbrida,2.06,11,Mujer,Linkedin,10,464595,91.0,73,Soltero,31,2013,2,high,102085,Presencial,1.39,2,Mujer,Linkedin,12,1358450,97.0,72,Soltero,35,2016,12,high,-0.6700000000000002,-9,2,893855,1421,0,4
102391,102031,1,Híbrida,5.405,3,Hombre,Portal Web,4,467480,91.0,63,Casado,31,2013,1,high,102111,Presencial,2.95,2,Hombre,Portal Web,8,1610000,76.0,87,Casado,31,2017,7,low,-2.455,-1,4,1142520,1636,0,0
104145,102119,1,Híbrida,1.285,0,Mujer,Portal Web,14,254905,91.0,81,Divorciado,42,2022,1,high,102107,Presencial,2.22,2,Hombre,Portal Web,12,1616000,38.0,70,Divorciado,52,2021,1,low,0.9350000000000003,2,-2,1361095,-354,1,10
102944,102086,1,Híbrida,3.88,3,Mujer,Referidos,6,248830,91.0,80,Soltero,39,2018,8,high,102085,Presencial,2.22,2,Mujer,Linkedin,7,1306940,87.0,68,Divorciado,39,2021,3,high,-1.6599999999999997,-1,1,1058110,935,0,0
103705,102056,1,Híbrida,2.52,5,Mujer,Portal Web,7,911302,91.0,73,Casado,34,2013,11,high,102014,Presencial,5.24,1,Hombre,Ferias & Networking,16,1616000,70.0,63,Viudo,65,2023,3,low,2.72,-4,9,704698,3410,0,31
102682,102133,1,Híbrida,3.58,3,Hombre,Portal Web,13,255157,91.0,65,Soltero,41,2020,1,high,102151,Híbrida,2.61,2,Hombre,Linkedin,4,1255430,98.0,65,Soltero,35,2018,2,high,-0.9700000000000002,-1,-9,1000273,-698,1,-6
103690,102142,1,Híbrida,2.365,1,Hombre,Portal Web,13,264979,91.0,89,Soltero,44,2022,8,high,102047,Presencial,2.48,2,Hombre,Portal Web,3,1255430,90.0,66,Soltero,36,2019,7,high,0.11499999999999977,1,-10,990451,-1120,1,-8
104076,102054,1,Híbrida,2.27,2,Mujer,Portal Web,14,274224,91.0,78,Divorciado,37,2013,6,high,102044,Presencial,2.91,1,Hombre,Linkedin,17,1616000,85.0,74,Divorciado,41,2012,11,high,0.6400000000000001,-1,3,1341776,-206,1,4
104094,102039,1,Híbrida,4.91,21,Mujer,Portal Web,15,413558,91.0,81,Soltero,38,2013,12,high,102054,Presencial,3.66,0,Hombre,Referidos,5,1616000,93.0,75,Viudo,49,2018,6,high,-1.25,-21,-10,1202442,1647,0,11
103592,102103,1,Híbrida,4.505,2,Mujer,Linkedin,15,300844,91.0,66,Divorciado,44,2019,6,high,102023,Presencial,1.69,6,Hombre,Portal Web,3,1616000,90.0,74,Casado,45,2013,5,high,-2.815,4,-12,1315156,-2218,1,1
102681,102064,1,Híbrida,4.805,2,Hombre,Ferias & Networking,10,778707,91.0,73,Viudo,46,2017,4,high,102067,Presencial,1.34,0,Hombre,Portal Web,6,1616000,92.0,92,Casado,43,2018,2,high,-3.465,-2,-4,837293,292,0,-3
104049,102084,1,Híbrida,2.235,10,Hombre,Linkedin,16,676291,91.0,80,Divorciado,47,2018,10,high,102171,Presencial,2.62,3,Mujer,Portal Web,14,1616000,89.0,76,Divorciado,50,2023,7,high,0.38500000000000023,-7,-2,939709,1751,0,3
102598,102061,1,Híbrida,4.665,1,Mujer,Portal Web,8,679378,91.0,76,Casado,43,2014,4,high,102115,Presencial,2.14,2,Hombre,Ferias & Networking,10,1203920,37.0,80,Casado,29,2012,11,low,-2.525,1,2,524542,-520,1,-14
104082,102077,1,Híbrida,2.82,3,Mujer,Linkedin,7,816455,91.0,76,Divorciado,49,2018,3,high,102146,Presencial,2.27,0,Hombre,Ferias & Networking,11,1306940,31.0,64,Soltero,39,2021,6,low,-0.5499999999999998,-3,4,490485,1189,0,-10
103544,102068,1,Híbrida,3.04,1,Hombre,Ferias & Networking,18,741713,91.0,71,Divorciado,49,2017,2,high,102043,Híbrida,2.17,3,Mujer,Referidos,4,896000,41.0,81,Soltero,23,2012,8,low,-0.8700000000000001,2,-14,154287,-1641,1,-26
102954,102068,1,Híbrida,1.23,2,Hombre,Ferias & Networking,6,733700,91.0,80,Viudo,48,2015,5,high,102043,Híbrida,2.17,3,Mujer,Referidos,4,896000,41.0,81,Soltero,23,2012,8,low,0.94,1,-2,162300,-1001,1,-25
101362,102082,1,Híbrida,1.42,2,Mujer,Referidos,1,78932,90.0,89,Soltero,14,2016,8,high,102050,Presencial,5.5,2,Mujer,Linkedin,7,1616000,81.0,70,Casado,36,2018,8,high,4.08,0,6,1537068,728,0,22
100255,102127,1,Híbrida,1.425,7,Hombre,Linkedin,1,142966,90.0,71,Soltero,21,2020,3,high,102028,Presencial,4.03,2,Mujer,Linkedin,9,1306940,88.0,78,Divorciado,32,2014,5,high,2.6050000000000004,-5,8,1163974,-2124,1,11
100647,102156,1,Híbrida,2.155,1,Mujer,Portal Web,3,188544,90.0,87,Soltero,26,2022,8,high,102154,Presencial,4.23,2,Hombre,Portal Web,22,1616000,92.0,76,Soltero,63,2023,12,high,2.0750000000000006,1,19,1427456,474,0,37
101953,102067,1,Híbrida,4.285,0,Mujer,Portal Web,1,186190,90.0,68,Soltero,20,2016,7,high,102058,Presencial,0.92,1,Mujer,Portal Web,5,1616000,90.0,70,Divorciado,46,2020,8,high,-3.365,1,4,1429810,1497,0,26
101339,102171,1,Híbrida,2.295,1,Hombre,Portal Web,5,210218,90.0,66,Soltero,28,2023,6,high,102088,Presencial,2.57,4,Hombre,Linkedin,8,1616000,80.0,69,Casado,43,2017,10,high,0.2749999999999999,3,3,1405782,-2090,1,15
101826,102126,1,Híbrida,3.475,2,Hombre,Ferias & Networking,3,207356,90.0,86,Soltero,26,2021,6,high,102141,Presencial,2.5,1,Mujer,Referidos,2,1049000,94.0,79,Casado,34,2021,1,high,-0.9750000000000001,-1,-1,841644,-153,1,8
100415,102141,1,Híbrida,1.555,1,Hombre,Referidos,3,248798,90.0,73,Casado,29,2022,6,high,102134,Presencial,1.88,1,Mujer,Linkedin,3,1100900,64.0,69,Soltero,32,2018,5,low,0.32499999999999996,0,0,852102,-1474,1,3
101170,102036,1,Híbrida,2.715,1,Mujer,Portal Web,5,267679,90.0,74,Casado,21,2013,12,high,102054,Presencial,1.68,8,Hombre,Portal Web,5,1616000,92.0,76,Viudo,54,2022,1,high,-1.035,7,0,1348321,2934,0,33
100850,102050,1,Híbrida,2.22,4,Mujer,Portal Web,7,292096,90.0,73,Casado,22,2013,9,high,102069,Presencial,3.7,0,Mujer,Linkedin,11,1512980,90.0,88,Soltero,40,2017,10,high,1.48,-4,4,1220884,1483,0,18
101984,102074,1,Híbrida,1.55,1,Mujer,Linkedin,6,288111,90.0,64,Soltero,26,2017,5,high,102028,Presencial,1.35,0,Hombre,Ferias & Networking,4,1616000,80.0,83,Viudo,43,2015,12,high,-0.19999999999999996,-1,-2,1327889,-498,1,17
100419,102024,1,Híbrida,4.59,0,Mujer,Portal Web,4,311613,90.0,59,Soltero,22,2012,7,high,102074,Presencial,2.28,0,Hombre,Headhunter,9,1616000,84.0,70,Casado,48,2018,3,high,-2.31,0,5,1304387,2071,0,26
100062,102126,1,Híbrida,1.875,1,Hombre,Referidos,7,370388,90.0,70,Casado,35,2022,8,high,102141,Presencial,2.5,1,Mujer,Referidos,2,1049000,94.0,79,Casado,34,2021,1,high,0.625,0,-5,678612,-573,1,-1
100800,102158,1,Híbrida,3.79,2,Mujer,Portal Web,10,389553,90.0,81,Casado,37,2022,11,high,102093,Presencial,1.79,1,Mujer,Referidos,27,1900000,87.0,74,Viudo,54,2013,9,high,-2.0,-1,17,1510447,-3348,1,17
100353,102129,1,Híbrida,1.82,3,Hombre,Ferias & Networking,2,384951,90.0,66,Soltero,36,2022,1,high,102142,Presencial,2.1,2,Mujer,Linkedin,3,590000,41.0,74,Soltero,24,2020,1,low,0.28,-1,1,205049,-737,1,-12
101200,102035,1,Híbrida,3.375,3,Mujer,Ferias & Networking,11,406978,90.0,74,Soltero,28,2013,3,high,102041,Presencial,2.86,1,Hombre,Portal Web,23,1900000,83.0,72,Casado,57,2013,8,high,-0.5150000000000001,-2,12,1493022,135,0,29
101397,102003,1,Híbrida,1.735,6,Mujer,Linkedin,8,772441,90.0,77,Soltero,27,2012,3,high,102130,Presencial,4.05,12,Hombre,Portal Web,8,1616000,83.0,82,Divorciado,49,2023,2,high,2.3149999999999995,6,0,843559,4011,0,22
101820,102052,1,Híbrida,2.635,3,Hombre,Ferias & Networking,4,769448,90.0,80,Casado,34,2016,5,high,102093,Presencial,4.45,0,Hombre,Linkedin,5,641000,84.0,76,Divorciado,17,2012,4,high,1.8150000000000004,-3,1,-128448,-1517,1,-17
100079,102028,1,Híbrida,2.03,10,Mujer,Linkedin,10,466737,90.0,73,Soltero,31,2013,2,high,102085,Presencial,1.39,2,Mujer,Linkedin,12,1358450,97.0,72,Soltero,35,2016,12,high,-0.6399999999999999,-8,2,891713,1418,0,4
100650,102105,1,Híbrida,1.485,1,Hombre,Referidos,3,529395,90.0,77,Casado,41,2020,4,high,102113,Híbrida,2.07,0,Hombre,Linkedin,8,1616000,85.0,71,Viudo,45,2017,3,high,0.5849999999999997,-1,5,1086605,-1106,1,4
100634,102086,1,Híbrida,3.855,3,Mujer,Referidos,6,245459,90.0,80,Soltero,39,2018,8,high,102085,Presencial,2.22,2,Mujer,Linkedin,7,1306940,87.0,68,Divorciado,39,2021,3,high,-1.6349999999999998,-1,1,1061481,932,0,0
101026,102042,1,Híbrida,6.465,1,Mujer,Portal Web,13,272032,90.0,73,Casado,35,2013,5,high,102107,Presencial,2.19,2,Hombre,Ferias & Networking,8,1616000,38.0,78,Divorciado,57,2018,6,low,-4.275,1,-5,1343968,1858,0,22
101908,102142,1,Híbrida,2.4,2,Hombre,Portal Web,13,267966,90.0,89,Soltero,45,2022,8,high,102047,Presencial,2.48,2,Hombre,Portal Web,3,1255430,90.0,66,Soltero,36,2019,7,high,0.08000000000000007,0,-10,987464,-1121,1,-9
101472,102126,1,Híbrida,2.645,9,Mujer,Portal Web,7,281771,90.0,73,Casado,45,2021,8,high,102141,Presencial,2.5,1,Mujer,Referidos,2,1049000,94.0,79,Casado,34,2021,1,high,-0.14500000000000002,-8,-5,767229,-213,1,-11
100757,102078,1,Híbrida,1.45,10,Hombre,Linkedin,10,275691,90.0,73,Casado,41,2018,2,high,102143,Presencial,2.17,1,Hombre,Ferias & Networking,9,998000,83.0,76,Casado,29,2017,5,high,0.72,-9,-1,722309,-253,1,-12
100251,102012,1,Híbrida,1.87,1,Mujer,Portal Web,14,293524,90.0,75,Viudo,38,2013,2,high,102122,Presencial,2.09,1,Mujer,Portal Web,7,1100000,90.0,80,Casado,34,2019,7,high,0.21999999999999975,0,-7,806476,2326,0,-4
101474,102028,1,Híbrida,1.495,1,Hombre,Portal Web,13,387143,90.0,71,Soltero,40,2014,8,high,102085,Presencial,1.39,2,Mujer,Linkedin,12,1358450,97.0,72,Soltero,35,2016,12,high,-0.1050000000000002,1,-1,971307,862,0,-5
101588,102034,1,Híbrida,2.725,0,Hombre,Portal Web,14,642641,90.0,68,Casado,41,2014,2,high,102113,Presencial,7.84,7,Hombre,Linkedin,5,1564490,90.0,70,Casado,35,2012,9,high,5.115,7,-9,921849,-527,1,-6
101745,102106,1,Híbrida,1.505,4,Hombre,Portal Web,4,675783,90.0,74,Soltero,49,2019,6,high,102081,Presencial,1.39,1,Mujer,Ferias & Networking,5,1049000,86.0,86,Soltero,32,2019,6,high,-0.11499999999999999,-3,1,373217,-11,1,-17
100847,102061,1,Híbrida,4.66,0,Mujer,Portal Web,8,680049,90.0,76,Casado,43,2014,4,high,102115,Presencial,2.14,2,Hombre,Ferias & Networking,10,1203920,37.0,80,Casado,29,2012,11,low,-2.52,2,2,523871,-520,1,-14
100549,102100,1,Híbrida,3.68,1,Hombre,Portal Web,19,718149,90.0,87,Divorciado,49,2017,8,high,102007,Presencial,3.3,1,Mujer,Portal Web,3,1255430,21.0,59,Casado,30,2013,2,low,-0.38000000000000034,0,-16,537281,-1644,1,-19
101868,102114,1,Híbrida,6.385,11,Mujer,Linkedin,7,917317,90.0,74,Viudo,50,2018,9,high,102050,Presencial,1.44,1,Mujer,Portal Web,5,1616000,91.0,69,Divorciado,47,2021,5,high,-4.945,-10,-2,698683,986,0,-3
102121,102127,2,Híbrida,1.63,2,Hombre,Portal Web,4,1616000,90.0,77,Divorciado,44,2012,2,high,102028,Presencial,4.03,2,Mujer,Linkedin,9,1306940,88.0,78,Divorciado,32,2014,5,high,2.4000000000000004,0,5,-309060,816,0,-12
104154,102127,1,Híbrida,1.42,6,Hombre,Linkedin,1,141787,90.0,71,Soltero,21,2020,3,high,102028,Presencial,4.03,2,Mujer,Linkedin,9,1306940,88.0,78,Divorciado,32,2014,5,high,2.6100000000000003,-4,8,1165153,-2127,1,11
102865,102124,1,Híbrida,1.005,1,Mujer,Referidos,2,180573,90.0,66,Casado,23,2019,7,high,102099,Presencial,2.84,2,Mujer,Linkedin,4,947000,90.0,70,Soltero,24,2012,10,high,1.835,1,2,766427,-2445,1,1
102313,102067,1,Híbrida,4.275,1,Mujer,Portal Web,1,185388,90.0,68,Soltero,20,2016,7,high,102058,Presencial,0.92,1,Mujer,Portal Web,5,1616000,90.0,70,Divorciado,46,2020,8,high,-3.3550000000000004,0,4,1430612,1496,0,26
103025,102117,1,Híbrida,2.76,2,Hombre,Linkedin,1,232322,90.0,78,Casado,28,2021,10,high,102154,Presencial,4.05,1,Mujer,Linkedin,10,1616000,90.0,80,Divorciado,48,2021,1,high,1.29,-1,9,1383678,-258,1,20
103717,102074,1,Híbrida,1.55,1,Mujer,Linkedin,6,292555,90.0,64,Soltero,26,2017,5,high,102028,Presencial,1.35,0,Hombre,Ferias & Networking,4,1616000,80.0,83,Viudo,43,2015,12,high,-0.19999999999999996,-1,-2,1323445,-500,1,17
103229,102112,1,Híbrida,1.105,1,Mujer,Portal Web,7,326478,90.0,74,Casado,30,2019,7,high,102031,Presencial,2.27,7,Hombre,Linkedin,1,692000,83.0,74,Soltero,26,2020,6,high,1.165,6,-6,365522,354,0,-4
104002,102022,1,Híbrida,2.525,6,Mujer,Linkedin,5,350184,90.0,73,Soltero,25,2014,2,high,102081,Presencial,2.07,0,Hombre,Portal Web,6,1616000,94.0,66,Viudo,47,2020,5,high,-0.45500000000000007,-6,1,1265816,2287,0,22
103635,102111,1,Híbrida,3.165,1,Hombre,Ferias & Networking,2,366504,90.0,67,Soltero,32,2019,7,high,102097,Híbrida,2.04,1,Mujer,Referidos,15,1616000,94.0,67,Soltero,50,2021,5,high,-1.125,0,13,1249496,656,0,18
103688,102035,1,Híbrida,3.365,2,Mujer,Ferias & Networking,11,404653,90.0,74,Soltero,28,2013,3,high,102041,Presencial,2.86,1,Hombre,Portal Web,23,1900000,83.0,72,Casado,57,2013,8,high,-0.5050000000000003,-1,12,1495347,138,0,29
103734,102003,1,Híbrida,1.73,6,Mujer,Linkedin,8,769704,90.0,77,Casado,28,2012,3,high,102130,Presencial,4.05,12,Hombre,Portal Web,8,1616000,83.0,82,Divorciado,49,2023,2,high,2.32,6,0,846296,4010,0,21
103871,102042,1,Híbrida,5.555,1,Mujer,Portal Web,3,424477,90.0,74,Viudo,28,2012,9,high,102107,Presencial,2.19,2,Hombre,Ferias & Networking,8,1616000,38.0,78,Divorciado,57,2018,6,low,-3.3649999999999998,1,5,1191523,2122,0,29
102712,102045,1,Híbrida,1.605,9,Hombre,Linkedin,11,246554,90.0,83,Soltero,33,2012,11,high,102171,Presencial,3.19,3,Hombre,Portal Web,11,1616000,97.0,65,Casado,53,2023,9,high,1.585,-6,0,1369446,3980,0,20
103495,102099,1,Híbrida,4.17,5,Hombre,Portal Web,3,269781,90.0,65,Divorciado,39,2017,2,high,102080,Presencial,1.71,0,Hombre,Portal Web,11,1616000,76.0,80,Viudo,51,2021,10,low,-2.46,-5,8,1346219,1707,0,12
103942,102126,1,Híbrida,2.65,8,Mujer,Portal Web,7,281601,90.0,73,Casado,45,2021,8,high,102141,Presencial,2.5,1,Mujer,Referidos,2,1049000,94.0,79,Casado,34,2021,1,high,-0.1499999999999999,-7,-5,767399,-215,1,-11
103213,102078,1,Híbrida,1.45,9,Hombre,Linkedin,10,275572,90.0,73,Casado,41,2018,2,high,102143,Presencial,2.17,1,Hombre,Ferias & Networking,9,998000,83.0,76,Casado,29,2017,5,high,0.72,-8,-1,722428,-252,1,-12
102374,102012,1,Híbrida,1.905,1,Mujer,Portal Web,14,299734,90.0,75,Viudo,38,2013,2,high,102122,Presencial,2.09,1,Mujer,Portal Web,7,1100000,90.0,80,Casado,34,2019,7,high,0.18499999999999983,0,-7,800266,2325,0,-4
102520,102034,1,Híbrida,2.015,7,Hombre,Linkedin,5,299717,90.0,80,Casado,37,2012,1,high,102113,Presencial,7.84,7,Hombre,Linkedin,5,1564490,90.0,70,Casado,35,2012,9,high,5.824999999999999,0,0,1264773,261,0,-2
103779,102082,1,Híbrida,1.625,2,Hombre,Portal Web,7,774688,90.0,65,Divorciado,45,2017,12,high,102050,Presencial,5.5,2,Mujer,Linkedin,7,1616000,81.0,70,Casado,36,2018,8,high,3.875,0,0,841312,230,0,-9
102300,102034,1,Híbrida,2.755,1,Hombre,Portal Web,14,634294,90.0,68,Casado,41,2014,2,high,102113,Presencial,7.84,7,Hombre,Linkedin,5,1564490,90.0,70,Casado,35,2012,9,high,5.085,6,-9,930196,-525,1,-6
102287,102079,1,Híbrida,2.32,0,Mujer,Portal Web,15,817952,90.0,70,Casado,44,2016,4,high,102146,Presencial,2.63,1,Mujer,Portal Web,4,1358450,80.0,81,Soltero,35,2016,3,high,0.31000000000000005,1,-11,540498,-38,1,-9
102535,102112,1,Híbrida,0.88,1,Hombre,Portal Web,10,701522,90.0,72,Soltero,51,2021,2,high,102031,Presencial,2.27,7,Hombre,Linkedin,1,692000,83.0,74,Soltero,26,2020,6,high,1.3900000000000001,6,-9,-9522,-242,1,-25
103986,102100,1,Híbrida,3.705,1,Hombre,Portal Web,19,721711,90.0,87,Divorciado,49,2017,8,high,102007,Presencial,3.3,1,Mujer,Portal Web,3,1255430,21.0,59,Casado,30,2013,2,low,-0.40500000000000025,0,-16,533719,-1643,1,-19
100100,102125,1,Híbrida,1.91,5,Mujer,Portal Web,2,209741,89.0,62,Casado,27,2021,7,high,102096,Híbrida,4.0,2,Mujer,Referidos,5,692000,87.0,82,Casado,29,2022,7,high,2.09,-3,3,482259,361,0,2
101631,102042,1,Híbrida,5.58,2,Mujer,Portal Web,3,426271,89.0,74,Viudo,28,2012,9,high,102107,Presencial,2.19,2,Hombre,Ferias & Networking,8,1616000,38.0,78,Divorciado,57,2018,6,low,-3.39,0,5,1189729,2119,0,29
101989,102068,1,Híbrida,1.475,1,Mujer,Ferias & Networking,5,430836,88.0,68,Casado,31,2015,8,high,102043,Híbrida,2.17,3,Mujer,Referidos,4,896000,41.0,81,Soltero,23,2012,8,low,0.6949999999999998,2,-1,465164,-1076,1,-8
101232,102064,1,Híbrida,2.215,0,Hombre,Referidos,7,696295,88.0,78,Viudo,45,2015,5,high,102067,Presencial,1.34,0,Hombre,Portal Web,6,1616000,92.0,92,Casado,43,2018,2,high,-0.8749999999999998,0,-1,919705,980,0,-2
102438,102059,1,Híbrida,1.335,0,Hombre,Linkedin,4,425511,88.0,68,Soltero,33,2017,1,high,102021,Presencial,2.55,2,Hombre,Portal Web,16,1616000,27.0,76,Viudo,50,2019,6,low,1.2149999999999999,2,12,1190489,868,0,17
102291,102064,1,Híbrida,2.2,1,Hombre,Referidos,7,694163,88.0,78,Viudo,45,2015,5,high,102067,Presencial,1.34,0,Hombre,Portal Web,6,1616000,92.0,92,Casado,43,2018,2,high,-0.8600000000000001,-1,-1,921837,980,0,-2
100643,102054,1,Híbrida,1.505,1,Hombre,Portal Web,2,180814,87.0,88,Casado,18,2015,11,high,102044,Presencial,2.91,1,Hombre,Linkedin,17,1616000,85.0,74,Divorciado,41,2012,11,high,1.4050000000000002,0,15,1435186,-1092,1,23
100287,102059,1,Híbrida,1.315,1,Hombre,Linkedin,4,427406,87.0,68,Soltero,33,2017,1,high,102021,Presencial,2.55,2,Hombre,Portal Web,16,1616000,27.0,76,Viudo,50,2019,6,low,1.2349999999999999,1,12,1188594,868,0,17
101786,102035,1,Híbrida,3.01,1,Mujer,Ferias & Networking,4,287978,87.0,78,Casado,37,2012,7,high,102041,Presencial,2.86,1,Hombre,Portal Web,23,1900000,83.0,72,Casado,57,2013,8,high,-0.1499999999999999,0,19,1612022,397,0,20
100382,102035,1,Híbrida,2.155,0,Mujer,Ferias & Networking,2,661749,87.0,76,Soltero,40,2012,4,high,102041,Presencial,2.86,1,Hombre,Portal Web,23,1900000,83.0,72,Casado,57,2013,8,high,0.7050000000000001,1,21,1238251,487,0,17
102650,102054,1,Híbrida,1.495,0,Hombre,Portal Web,2,183947,87.0,88,Casado,18,2015,11,high,102044,Presencial,2.91,1,Hombre,Linkedin,17,1616000,85.0,74,Divorciado,41,2012,11,high,1.415,1,15,1432053,-1092,1,23
102588,102106,1,Híbrida,1.475,3,Mujer,Portal Web,6,788525,87.0,62,Soltero,36,2021,2,high,102081,Presencial,1.39,1,Mujer,Ferias & Networking,5,1049000,86.0,86,Soltero,32,2019,6,high,-0.08500000000000019,-2,-1,260475,-606,1,-4
103283,102035,1,Híbrida,3.005,1,Mujer,Ferias & Networking,5,290314,87.0,78,Casado,37,2012,7,high,102041,Presencial,2.86,1,Hombre,Portal Web,23,1900000,83.0,72,Casado,57,2013,8,high,-0.14500000000000002,0,18,1609686,398,0,20
100737,102092,1,Híbrida,5.28,1,Mujer,Ferias & Networking,1,121171,86.0,90,Soltero,18,2018,8,high,102120,Presencial,1.23,6,Mujer,Linkedin,13,1616000,98.0,95,Viudo,41,2013,6,high,-4.050000000000001,5,12,1494829,-1868,1,23
102373,102064,1,Híbrida,2.315,2,Hombre,Ferias & Networking,6,307294,86.0,78,Casado,24,2014,10,high,102067,Presencial,1.34,0,Hombre,Portal Web,6,1616000,92.0,92,Casado,43,2018,2,high,-0.9749999999999999,-2,0,1308706,1211,0,19
102224,102017,1,Híbrida,5.41,2,Mujer,Portal Web,13,277708,86.0,86,Casado,36,2012,10,high,102035,Presencial,4.62,0,Mujer,Linkedin,2,641000,90.0,84,Casado,25,2019,11,high,-0.79,-2,-11,363292,2567,0,-11
102565,102035,1,Híbrida,2.195,0,Mujer,Ferias & Networking,2,659393,86.0,76,Soltero,40,2012,4,high,102041,Presencial,2.86,1,Hombre,Portal Web,23,1900000,83.0,72,Casado,57,2013,8,high,0.665,1,21,1240607,488,0,17
103614,102066,1,Híbrida,2.64,2,Hombre,Referidos,7,780052,86.0,75,Viudo,47,2016,3,high,102171,Presencial,3.62,3,Hombre,Referidos,5,1616000,97.0,84,Casado,55,2023,12,high,0.98,1,-2,835948,2814,0,8
101875,102063,1,Híbrida,1.03,3,Hombre,Ferias & Networking,3,168402,85.0,83,Soltero,17,2015,3,high,102135,Presencial,2.73,0,Mujer,Linkedin,1,539000,26.0,75,Soltero,24,2021,4,low,1.7,-3,-2,370598,2228,0,7
101457,102091,1,Híbrida,5.27,0,Mujer,Portal Web,5,425593,85.0,73,Soltero,34,2017,11,high,102149,Presencial,1.54,1,Mujer,Portal Web,4,1616000,73.0,77,Casado,39,2014,12,low,-3.7299999999999995,1,-1,1190407,-1066,1,5
101635,102142,1,Híbrida,3.41,11,Hombre,Portal Web,8,301780,85.0,74,Divorciado,48,2022,4,high,102047,Presencial,2.48,2,Hombre,Portal Web,3,1255430,90.0,66,Soltero,36,2019,7,high,-0.9300000000000002,-9,-5,953650,-997,1,-12
101815,102066,1,Híbrida,2.605,2,Hombre,Referidos,7,774831,85.0,75,Viudo,47,2016,3,high,102171,Presencial,3.62,3,Hombre,Referidos,5,1616000,97.0,84,Casado,55,2023,12,high,1.0150000000000001,1,-2,841169,2813,0,8
102666,102137,1,Híbrida,3.4,12,Mujer,Portal Web,10,386747,85.0,73,Casado,45,2023,4,high,102046,Presencial,1.18,0,Mujer,Portal Web,2,845000,37.0,79,Casado,27,2017,12,low,-2.2199999999999998,-12,-8,458253,-1934,1,-18
101372,102087,1,Híbrida,2.47,2,Mujer,Referidos,4,143282,84.0,77,Soltero,17,2016,11,high,102111,Presencial,7.16,9,Mujer,Linkedin,10,1616000,98.0,79,Casado,42,2012,5,high,4.6899999999999995,7,6,1472718,-1663,1,25
101158,102117,1,Híbrida,2.97,0,Mujer,Referidos,6,247486,84.0,73,Soltero,40,2020,3,high,102154,Presencial,4.05,1,Mujer,Linkedin,10,1616000,90.0,80,Divorciado,48,2021,1,high,1.0799999999999996,1,4,1368514,313,0,8
100858,102137,1,Híbrida,3.38,11,Mujer,Portal Web,10,384696,84.0,73,Casado,45,2023,4,high,102046,Presencial,1.18,0,Mujer,Portal Web,2,845000,37.0,79,Casado,27,2017,12,low,-2.2,-11,-8,460304,-1933,1,-18
104156,102063,1,Híbrida,1.04,2,Hombre,Ferias & Networking,3,164991,84.0,83,Soltero,17,2015,3,high,102135,Presencial,2.73,0,Mujer,Linkedin,1,539000,26.0,75,Soltero,24,2021,4,low,1.69,-2,-2,374009,2231,0,7
103917,102108,1,Híbrida,1.8,2,Hombre,Portal Web,4,269267,84.0,73,Soltero,27,2019,1,high,102040,Presencial,2.92,1,Mujer,Portal Web,5,1616000,46.0,75,Casado,50,2023,5,low,1.1199999999999999,-1,1,1346733,1605,0,23
101400,102061,1,Híbrida,1.835,3,Hombre,Portal Web,16,774236,83.0,78,Soltero,44,2014,3,high,102115,Presencial,2.14,2,Hombre,Ferias & Networking,10,1203920,37.0,80,Casado,29,2012,11,low,0.30500000000000016,-1,-6,429684,-485,1,-15
101441,102086,1,Híbrida,2.665,14,Hombre,Ferias & Networking,6,426429,82.0,86,Soltero,35,2018,8,high,102085,Presencial,2.22,2,Mujer,Linkedin,7,1306940,87.0,68,Divorciado,39,2021,3,high,-0.44499999999999984,-12,1,880511,938,0,4
100233,102031,1,Híbrida,1.47,7,Mujer,Linkedin,4,839816,82.0,78,Casado,42,2013,2,high,102111,Presencial,2.95,2,Hombre,Portal Web,8,1610000,76.0,87,Casado,31,2017,7,low,1.4800000000000002,-5,4,770184,1611,0,-11
100830,102134,1,Híbrida,1.92,3,Hombre,Referidos,4,209256,81.0,80,Soltero,28,2023,4,high,102135,Presencial,2.25,2,Hombre,Portal Web,5,1358450,90.0,69,Viudo,31,2012,7,high,0.33000000000000007,-1,1,1149194,-3938,1,3
101511,102028,1,Híbrida,1.825,4,Mujer,Portal Web,6,331238,81.0,79,Casado,25,2013,7,high,102085,Presencial,1.39,2,Mujer,Linkedin,12,1358450,97.0,72,Soltero,35,2016,12,high,-0.43500000000000005,-2,6,1027212,1268,0,10
100996,102038,1,Híbrida,3.44,1,Mujer,Portal Web,9,505872,81.0,79,Casado,35,2014,9,high,102125,Presencial,2.06,1,Hombre,Portal Web,12,1616000,81.0,82,Casado,44,2018,1,high,-1.38,0,3,1110128,1224,0,9
100054,102060,1,Híbrida,4.705,6,Hombre,Portal Web,16,310561,81.0,84,Viudo,42,2016,1,high,102041,Presencial,4.42,3,Hombre,Referidos,16,1616000,82.0,62,Casado,45,2013,10,high,-0.28500000000000014,-3,0,1305439,-821,1,3
102474,102134,1,Híbrida,1.89,3,Hombre,Referidos,4,212769,81.0,80,Soltero,28,2023,4,high,102135,Presencial,2.25,2,Hombre,Portal Web,5,1358450,90.0,69,Viudo,31,2012,7,high,0.3600000000000001,-1,1,1145681,-3941,1,3
103253,102060,1,Híbrida,4.74,6,Hombre,Portal Web,16,306316,81.0,84,Viudo,42,2016,1,high,102041,Presencial,4.42,3,Hombre,Referidos,16,1616000,82.0,62,Casado,45,2013,10,high,-0.3200000000000003,-3,0,1309684,-821,1,3
103539,102042,1,Híbrida,6.385,3,Hombre,Linkedin,3,634592,81.0,74,Divorciado,42,2014,10,high,102107,Presencial,2.19,2,Hombre,Ferias & Networking,8,1616000,38.0,78,Divorciado,57,2018,6,low,-4.195,-1,5,981408,1340,0,15
103019,102031,1,Híbrida,1.43,7,Mujer,Linkedin,4,833884,81.0,78,Casado,42,2013,2,high,102111,Presencial,2.95,2,Hombre,Portal Web,8,1610000,76.0,87,Casado,31,2017,7,low,1.5200000000000002,-5,4,776116,1609,0,-11
100081,102056,1,Híbrida,2.925,3,Hombre,Portal Web,6,309463,81.0,67,Casado,24,2014,3,high,102014,Presencial,5.24,1,Hombre,Ferias & Networking,16,1616000,70.0,63,Viudo,65,2023,3,low,2.3150000000000004,-2,10,1306537,3276,0,41
100165,102144,1,Híbrida,2.195,1,Mujer,Portal Web,7,489901,83.0,79,Casado,42,2023,1,high,102156,Presencial,2.13,8,Mujer,Portal Web,11,1616000,5.0,82,Viudo,58,2015,6,low,-0.06499999999999995,7,4,1126099,-2777,1,16
100652,102076,1,Híbrida,3.29,2,Hombre,Linkedin,9,512929,83.0,72,Divorciado,37,2017,1,high,102168,Híbrida,1.95,1,Hombre,Referidos,9,1616000,95.0,82,Soltero,53,2023,9,high,-1.34,-1,0,1103071,2422,0,16
101503,102031,1,Híbrida,6.775,2,Hombre,Ferias & Networking,8,277183,82.0,77,Casado,37,2014,2,high,102111,Presencial,2.95,2,Hombre,Portal Web,8,1610000,76.0,87,Casado,31,2017,7,low,-3.825,0,0,1332817,1238,0,-6
103069,102085,1,Híbrida,3.485,2,Mujer,Referidos,3,145034,81.0,63,Soltero,18,2016,3,high,102145,Presencial,6.59,4,Hombre,Portal Web,12,1616000,47.0,71,Casado,39,2015,8,low,3.105,2,9,1470966,-223,1,21
103036,102028,1,Híbrida,1.81,4,Mujer,Portal Web,6,329443,87.0,79,Casado,25,2013,7,high,102085,Presencial,1.39,2,Mujer,Linkedin,12,1358450,97.0,72,Soltero,35,2016,12,high,-0.42000000000000015,-2,6,1029007,1269,0,10
102483,102076,1,Híbrida,3.26,2,Hombre,Linkedin,9,507016,93.0,72,Divorciado,37,2017,1,high,102168,Híbrida,1.95,1,Hombre,Referidos,9,1616000,95.0,82,Soltero,53,2023,9,high,-1.3099999999999998,-1,0,1108984,2420,0,16
103847,102052,1,Híbrida,2.09,2,Mujer,Linkedin,6,507656,84.0,75,Casado,35,2015,9,high,102093,Presencial,4.45,0,Hombre,Linkedin,5,641000,84.0,76,Divorciado,17,2012,4,high,2.3600000000000003,-2,-1,133344,-1271,1,-18
102581,102108,1,Híbrida,1.04,3,Mujer,Linkedin,4,255758,96.0,78,Divorciado,42,2021,2,high,102040,Presencial,2.92,1,Mujer,Portal Web,5,1616000,46.0,75,Casado,50,2023,5,low,1.88,-2,1,1360242,826,0,8
100990,102037,1,Híbrida,6.995,7,Hombre,Linkedin,1,140589,86.0,74,Soltero,13,2013,10,high,102057,Presencial,1.12,1,Mujer,Linkedin,2,641000,50.0,76,Casado,21,2016,12,low,-5.875,-6,1,500411,1155,0,8
100836,102108,1,Híbrida,1.05,4,Mujer,Linkedin,4,261381,96.0,78,Divorciado,42,2021,2,high,102040,Presencial,2.92,1,Mujer,Portal Web,5,1616000,46.0,75,Casado,50,2023,5,low,1.8699999999999999,-3,1,1354619,827,0,8
100844,102143,1,Híbrida,2.135,7,Hombre,Linkedin,5,259594,90.0,89,Soltero,42,2021,1,high,102142,Presencial,1.07,2,Hombre,Portal Web,2,590000,90.0,78,Casado,25,2022,2,high,-1.0649999999999997,-5,-3,330406,373,0,-17
103749,102133,1,Híbrida,1.895,2,Mujer,Ferias & Networking,1,117204,91.0,75,Soltero,21,2022,9,high,102151,Híbrida,2.61,2,Hombre,Linkedin,4,1255430,98.0,65,Soltero,35,2018,2,high,0.7149999999999999,0,3,1138226,-1673,1,14
104151,102037,1,Híbrida,7.015,7,Hombre,Linkedin,1,141097,80.0,74,Soltero,13,2013,10,high,102057,Presencial,1.12,1,Mujer,Linkedin,2,641000,50.0,76,Casado,21,2016,12,low,-5.895,-6,1,499903,1153,0,8
102906,102056,1,Híbrida,2.925,3,Hombre,Portal Web,6,313655,91.0,67,Casado,24,2014,3,high,102014,Presencial,5.24,1,Hombre,Ferias & Networking,16,1616000,70.0,63,Viudo,65,2023,3,low,2.3150000000000004,-2,10,1302345,3277,0,41
102826,102103,1,Híbrida,2.98,1,Hombre,Portal Web,3,389604,95.0,82,Casado,33,2019,2,high,102023,Presencial,1.69,6,Hombre,Portal Web,3,1616000,90.0,74,Casado,45,2013,5,high,-1.29,5,0,1226396,-2092,1,12
103140,102094,1,Híbrida,3.085,2,Mujer,Portal Web,14,642595,96.0,87,Casado,44,2017,8,high,102095,Presencial,1.32,1,Hombre,Portal Web,4,998000,90.0,85,Casado,28,2016,2,high,-1.765,-1,-10,355405,-561,1,-16
102586,102154,1,Híbrida,1.73,2,Hombre,Linkedin,1,901603,88.0,76,Viudo,55,2023,2,high,102172,Presencial,5.45,1,Hombre,Portal Web,7,1512980,93.0,69,Soltero,39,2017,10,high,3.72,-1,6,611377,-1974,1,-16
100484,102041,1,Híbrida,4.35,1,Hombre,Ferias & Networking,1,115391,89.0,80,Soltero,14,2015,7,high,102147,Presencial,1.29,0,Mujer,Portal Web,8,1616000,44.0,73,Casado,51,2014,5,low,-3.0599999999999996,-1,7,1500609,-424,1,37
100700,102040,1,Híbrida,1.77,8,Hombre,Portal Web,1,118314,82.0,63,Soltero,14,2015,3,high,102106,Presencial,3.21,1,Hombre,Linkedin,15,1616000,91.0,84,Soltero,45,2016,7,high,1.44,-7,14,1497686,478,0,31
101747,102160,1,Híbrida,2.29,2,Hombre,Referidos,4,165624,84.0,65,Soltero,25,2022,6,high,102087,Presencial,2.21,0,Hombre,Portal Web,3,794000,83.0,78,Casado,28,2019,8,high,-0.08000000000000007,-2,-1,628376,-1030,1,3
101623,102131,1,Híbrida,4.205,2,Hombre,Linkedin,5,490460,95.0,80,Casado,40,2021,2,high,102109,Presencial,5.54,0,Hombre,Linkedin,3,998000,39.0,77,Soltero,34,2021,12,low,1.335,-2,-2,507540,301,0,-6
101803,102033,1,Híbrida,4.675,3,Hombre,Linkedin,8,288057,92.0,74,Divorciado,37,2012,10,high,102172,Presencial,6.25,2,Mujer,Portal Web,16,1616000,90.0,79,Divorciado,39,2014,5,high,1.5750000000000002,-1,8,1327943,569,0,2
101975,102107,1,Híbrida,2.74,8,Mujer,Portal Web,14,312306,92.0,73,Casado,45,2019,4,high,102069,Presencial,2.4,1,Mujer,Linkedin,8,1616000,47.0,79,Casado,63,2023,6,low,-0.3400000000000003,-7,-6,1303694,1537,0,18
102978,102039,1,Híbrida,6.935,1,Hombre,Portal Web,4,206350,87.0,64,Casado,18,2012,11,high,102054,Presencial,3.66,0,Hombre,Referidos,5,1616000,93.0,75,Viudo,49,2018,6,high,-3.2749999999999995,-1,1,1409650,2043,0,31
103281,102075,1,Híbrida,3.105,1,Hombre,Linkedin,9,332572,86.0,77,Soltero,29,2017,7,high,102047,Presencial,2.7,1,Hombre,Referidos,11,1255430,90.0,76,Casado,30,2013,3,high,-0.4049999999999998,0,2,922858,-1562,1,1
103523,102129,1,Híbrida,1.265,2,Hombre,Referidos,8,468281,84.0,67,Soltero,41,2022,5,high,102142,Presencial,2.1,2,Mujer,Linkedin,3,590000,41.0,74,Soltero,24,2020,1,low,0.8350000000000002,0,-5,121719,-849,1,-17
102328,102131,1,Híbrida,4.19,2,Hombre,Linkedin,5,490891,82.0,80,Casado,40,2021,2,high,102109,Presencial,5.54,0,Hombre,Linkedin,3,998000,39.0,77,Soltero,34,2021,12,low,1.3499999999999996,-2,-2,507109,302,0,-6
102707,102134,1,Híbrida,1.79,3,Hombre,Linkedin,7,489873,84.0,78,Casado,40,2020,2,high,102135,Presencial,2.25,2,Hombre,Portal Web,5,1358450,90.0,69,Viudo,31,2012,7,high,0.45999999999999996,-1,-2,868577,-2772,1,-9
103420,102033,1,Híbrida,4.66,2,Hombre,Linkedin,8,291042,83.0,74,Divorciado,37,2012,10,high,102172,Presencial,6.25,2,Mujer,Portal Web,16,1616000,90.0,79,Divorciado,39,2014,5,high,1.5899999999999999,0,8,1324958,568,0,2
104018,102042,1,Híbrida,5.74,11,Mujer,Linkedin,3,287253,89.0,79,Soltero,36,2012,7,high,102107,Presencial,2.19,2,Hombre,Ferias & Networking,8,1616000,38.0,78,Divorciado,57,2018,6,low,-3.5500000000000003,-9,5,1328747,2178,0,21
103170,102011,1,Híbrida,2.455,1,Mujer,Linkedin,15,304412,96.0,73,Viudo,38,2012,6,high,102048,Presencial,5.37,1,Hombre,Ferias & Networking,7,845000,52.0,74,Casado,22,2012,11,low,2.915,0,-8,540588,172,0,-16
100032,102094,1,Híbrida,6.22,3,Mujer,Ferias & Networking,5,351231,90.0,77,Soltero,28,2016,8,high,102095,Presencial,1.32,1,Hombre,Portal Web,4,998000,90.0,85,Casado,28,2016,2,high,-4.8999999999999995,-2,-1,646769,-204,1,0
101139,102067,1,Híbrida,1.645,1,Mujer,Referidos,3,366822,88.0,73,Soltero,28,2014,12,high,102058,Presencial,0.92,1,Mujer,Portal Web,5,1616000,90.0,70,Divorciado,46,2020,8,high,-0.725,0,2,1249178,2072,0,18
101886,102134,1,Híbrida,3.885,11,Mujer,Linkedin,4,466002,87.0,59,Divorciado,40,2022,11,high,102135,Presencial,2.25,2,Hombre,Portal Web,5,1358450,90.0,69,Viudo,31,2012,7,high,-1.6349999999999998,-9,1,892448,-3792,1,-9
102133,102151,2,Híbrida,2.61,2,Hombre,Linkedin,4,1255430,98.0,65,Soltero,35,2018,2,high,102105,Presencial,1.51,2,Hombre,Ferias & Networking,10,1616000,85.0,80,Divorciado,45,2021,11,high,-1.0999999999999999,0,6,360570,1357,0,10
101449,102151,1,Híbrida,2.935,8,Hombre,Linkedin,15,280724,92.0,73,Casado,45,2023,2,high,102105,Presencial,1.51,2,Hombre,Ferias & Networking,10,1616000,85.0,80,Divorciado,45,2021,11,high,-1.425,-6,-5,1335276,-455,1,0
100172,102049,1,Híbrida,2.08,11,Hombre,Portal Web,13,781171,83.0,70,Viudo,41,2013,9,high,102029,Presencial,6.89,0,Mujer,Portal Web,9,1616000,19.0,77,Divorciado,49,2023,3,low,4.81,-11,-4,834829,3481,0,8
100201,102028,1,Híbrida,5.71,6,Hombre,Linkedin,15,639005,89.0,76,Casado,40,2013,4,high,102085,Presencial,1.39,2,Mujer,Linkedin,12,1358450,97.0,72,Soltero,35,2016,12,high,-4.32,-4,-3,719445,1339,0,-5
103251,102041,1,Híbrida,4.35,1,Hombre,Ferias & Networking,1,123145,89.0,80,Soltero,14,2015,7,high,102147,Presencial,1.29,0,Mujer,Portal Web,8,1616000,44.0,73,Casado,51,2014,5,low,-3.0599999999999996,-1,7,1492855,-425,1,37
103965,102096,1,Híbrida,2.12,5,Hombre,Linkedin,2,168731,94.0,80,Soltero,22,2019,12,high,102116,Presencial,5.11,8,Mujer,Linkedin,13,1461470,90.0,74,Soltero,42,2021,5,high,2.99,3,11,1292739,498,0,20
103729,102105,1,Híbrida,2.34,2,Hombre,Portal Web,2,190540,86.0,71,Soltero,24,2020,11,high,102113,Híbrida,2.07,0,Hombre,Linkedin,8,1616000,85.0,71,Viudo,45,2017,3,high,-0.27,-2,6,1425460,-1319,1,21
103295,102094,1,Híbrida,6.22,2,Mujer,Ferias & Networking,5,348107,82.0,77,Soltero,28,2016,8,high,102095,Presencial,1.32,1,Hombre,Portal Web,4,998000,90.0,85,Casado,28,2016,2,high,-4.8999999999999995,-1,-1,649893,-205,1,0
103394,102122,1,Híbrida,2.13,2,Mujer,Portal Web,7,391176,91.0,65,Soltero,33,2019,3,high,102075,Presencial,1.83,4,Hombre,Portal Web,6,1616000,90.0,66,Viudo,48,2019,3,high,-0.2999999999999998,2,-1,1224824,-10,1,15
103738,102130,1,Híbrida,5.595,0,Mujer,Portal Web,4,447108,81.0,77,Soltero,37,2020,8,high,102068,Presencial,1.97,6,Hombre,Linkedin,5,1616000,84.0,73,Soltero,31,2014,4,high,-3.625,6,1,1168892,-2296,1,-6
102980,102060,1,Híbrida,2.07,2,Mujer,Ferias & Networking,5,432682,81.0,65,Soltero,31,2015,3,high,102041,Presencial,4.42,3,Hombre,Referidos,16,1616000,82.0,62,Casado,45,2013,10,high,2.35,1,11,1183318,-490,1,14
102773,102134,1,Híbrida,1.99,1,Hombre,Linkedin,7,445164,90.0,83,Casado,37,2020,1,high,102135,Presencial,2.25,2,Hombre,Portal Web,5,1358450,90.0,69,Viudo,31,2012,7,high,0.26,1,-2,913286,-2753,1,-6
102733,102160,1,Híbrida,7.17,3,Hombre,Portal Web,10,489576,85.0,87,Soltero,41,2022,6,high,102087,Presencial,2.21,0,Hombre,Portal Web,3,794000,83.0,78,Casado,28,2019,8,high,-4.96,-3,-7,304424,-1025,1,-13
103845,102172,1,Híbrida,2.075,1,Mujer,Ferias & Networking,13,396914,82.0,74,Soltero,44,2022,12,high,102020,Presencial,5.58,1,Hombre,Portal Web,7,1049000,57.0,70,Casado,29,2016,4,low,3.505,0,-6,652086,-2415,1,-15
103864,102131,1,Híbrida,2.78,1,Hombre,Ferias & Networking,10,781434,82.0,73,Divorciado,47,2020,2,high,102109,Presencial,5.54,0,Hombre,Linkedin,3,998000,39.0,77,Soltero,34,2021,12,low,2.7600000000000002,-1,-7,216566,666,0,-13
104058,102049,1,Híbrida,2.08,11,Hombre,Portal Web,13,774948,95.0,70,Viudo,41,2013,9,high,102029,Presencial,6.89,0,Mujer,Portal Web,9,1616000,19.0,77,Divorciado,49,2023,3,low,4.81,-11,-4,841052,3481,0,8
101544,102055,1,Híbrida,2.565,4,Hombre,Portal Web,8,406928,90.0,70,Divorciado,30,2015,8,high,102129,Presencial,1.92,2,Hombre,Referidos,8,1616000,97.0,63,Casado,42,2013,2,high,-0.645,-2,0,1209072,-909,1,12
100945,102080,1,Híbrida,4.015,3,Mujer,Portal Web,8,469298,83.0,66,Casado,34,2016,8,high,102035,Presencial,1.93,0,Mujer,Linkedin,18,1616000,94.0,75,Viudo,47,2016,8,high,-2.085,-3,10,1146702,4,0,13
100446,102172,1,Híbrida,2.075,1,Mujer,Ferias & Networking,13,399733,83.0,74,Soltero,44,2022,12,high,102020,Presencial,5.58,1,Hombre,Portal Web,7,1049000,57.0,70,Casado,29,2016,4,low,3.505,0,-6,649267,-2418,1,-15
101534,102026,1,Híbrida,6.765,1,Mujer,Linkedin,5,262300,95.0,81,Casado,35,2014,4,high,102101,Presencial,2.7,1,Mujer,Portal Web,15,1616000,97.0,79,Casado,58,2017,6,high,-4.0649999999999995,0,10,1353700,1173,0,23
101998,102002,1,Híbrida,2.525,1,Mujer,Portal Web,4,271551,85.0,74,Soltero,34,2012,2,high,102144,Presencial,2.16,12,Hombre,Linkedin,10,1616000,97.0,69,Divorciado,48,2023,9,high,-0.36499999999999977,11,6,1344449,4225,0,14
101028,102130,1,Híbrida,1.225,1,Mujer,Portal Web,12,634324,95.0,74,Casado,48,2020,12,high,102068,Presencial,1.97,6,Hombre,Linkedin,5,1616000,84.0,73,Soltero,31,2014,4,high,0.7449999999999999,5,-7,981676,-2436,1,-17
101124,102129,1,Híbrida,2.175,1,Mujer,Portal Web,15,696574,87.0,71,Viudo,52,2022,1,high,102142,Presencial,2.1,2,Mujer,Linkedin,3,590000,41.0,74,Soltero,24,2020,1,low,-0.07499999999999973,1,-12,-106574,-726,1,-28
100936,102124,1,Híbrida,1.705,2,Hombre,Linkedin,5,741716,88.0,70,Casado,51,2019,4,high,102099,Presencial,2.84,2,Mujer,Linkedin,4,947000,90.0,70,Soltero,24,2012,10,high,1.1349999999999998,0,-1,205284,-2347,1,-27
102493,102046,1,Híbrida,3.685,2,Mujer,Portal Web,6,269828,82.0,79,Casado,24,2015,12,high,102007,Presencial,1.68,0,Mujer,Portal Web,8,1616000,41.0,71,Soltero,50,2015,10,low,-2.005,-2,2,1346172,-43,1,26
102936,102055,1,Híbrida,2.58,3,Hombre,Portal Web,8,412142,94.0,70,Divorciado,30,2015,8,high,102129,Presencial,1.92,2,Hombre,Referidos,8,1616000,97.0,63,Casado,42,2013,2,high,-0.6600000000000001,-1,0,1203858,-908,1,12
102963,102170,1,Híbrida,3.785,2,Mujer,Portal Web,7,785378,87.0,78,Casado,39,2023,6,high,102055,Presencial,1.62,0,Mujer,Portal Web,8,1616000,78.0,72,Viudo,48,2013,2,low,-2.165,-2,1,830622,-3765,1,9
103952,102162,1,Híbrida,1.58,2,Hombre,Portal Web,10,472417,82.0,69,Casado,41,2023,4,high,102146,Presencial,1.12,0,Mujer,Referidos,9,1616000,31.0,74,Casado,41,2022,11,low,-0.45999999999999996,-2,-1,1143583,-139,1,0
103559,102102,1,Híbrida,2.57,9,Mujer,Portal Web,11,407030,90.0,83,Casado,41,2019,7,high,102018,Presencial,2.48,0,Hombre,Portal Web,5,1616000,92.0,63,Viudo,49,2019,4,high,-0.08999999999999986,-9,-6,1208970,-103,1,8
102632,102002,1,Híbrida,2.515,0,Mujer,Portal Web,4,263689,86.0,74,Soltero,34,2012,2,high,102144,Presencial,2.16,12,Hombre,Linkedin,10,1616000,97.0,69,Divorciado,48,2023,9,high,-0.355,12,6,1352311,4225,0,14
103217,102146,1,Híbrida,5.18,5,Mujer,Portal Web,8,274088,82.0,77,Soltero,44,2021,8,high,102035,Presencial,2.66,0,Mujer,Portal Web,15,1616000,77.0,78,Casado,39,2013,10,low,-2.5199999999999996,-5,7,1341912,-2871,1,-5
102543,102054,1,Híbrida,7.555,0,Mujer,Portal Web,4,284916,80.0,70,Casado,38,2013,6,high,102044,Presencial,2.91,1,Hombre,Linkedin,17,1616000,85.0,74,Divorciado,41,2012,11,high,-4.645,1,13,1331084,-217,1,3
103532,102140,1,Híbrida,6.89,1,Hombre,Referidos,10,676357,83.0,76,Divorciado,51,2022,4,high,102040,Presencial,2.55,0,Mujer,Portal Web,16,1616000,46.0,69,Casado,39,2012,2,low,-4.34,-1,6,939643,-3734,1,-12
102734,102106,1,Híbrida,1.77,0,Hombre,Ferias & Networking,20,801620,92.0,80,Divorciado,47,2018,10,high,102081,Presencial,1.39,1,Mujer,Ferias & Networking,5,1049000,86.0,86,Soltero,32,2019,6,high,-0.3800000000000001,1,-15,247380,249,0,-15
103359,102129,1,Híbrida,2.19,1,Mujer,Portal Web,15,696061,93.0,71,Viudo,52,2022,1,high,102142,Presencial,2.1,2,Mujer,Linkedin,3,590000,41.0,74,Soltero,24,2020,1,low,-0.08999999999999986,1,-12,-106061,-725,1,-28
101113,102014,1,Híbrida,3.505,5,Mujer,Portal Web,1,82186,92.0,81,Soltero,10,2013,4,high,102096,Presencial,1.78,1,Mujer,Portal Web,2,488000,98.0,78,Soltero,25,2023,1,high,-1.7249999999999999,-4,1,405814,3554,0,15
101011,102097,1,Híbrida,2.965,0,Mujer,Portal Web,3,119998,88.0,61,Soltero,18,2019,8,high,102024,Presencial,1.95,6,Hombre,Portal Web,4,1100900,57.0,77,Soltero,31,2016,10,low,-1.015,6,1,980902,-1034,1,13
101012,102068,1,Híbrida,1.94,2,Mujer,Ferias & Networking,1,101487,85.0,83,Soltero,16,2017,12,high,102043,Híbrida,2.17,3,Mujer,Referidos,4,896000,41.0,81,Soltero,23,2012,8,low,0.22999999999999998,1,3,794513,-1950,1,7
101914,102051,1,Híbrida,1.52,0,Mujer,Referidos,4,288245,85.0,66,Divorciado,25,2016,7,high,102075,Híbrida,1.39,1,Hombre,Portal Web,11,1616000,83.0,76,Casado,46,2019,11,high,-0.13000000000000012,1,7,1327755,1215,0,21
101798,102122,1,Híbrida,5.125,1,Hombre,Referidos,5,811507,80.0,87,Casado,38,2018,12,high,102075,Presencial,1.83,4,Hombre,Portal Web,6,1616000,90.0,66,Viudo,48,2019,3,high,-3.295,3,1,804493,82,0,10
100159,102097,1,Híbrida,3.2,3,Mujer,Linkedin,6,261390,89.0,73,Viudo,39,2018,2,high,102024,Presencial,1.95,6,Hombre,Portal Web,4,1100900,57.0,77,Soltero,31,2016,10,low,-1.2500000000000002,3,-2,839510,-477,1,-8
100124,102102,1,Híbrida,2.56,9,Mujer,Portal Web,11,406373,81.0,83,Casado,41,2019,7,high,102018,Presencial,2.48,0,Hombre,Portal Web,5,1616000,92.0,63,Viudo,49,2019,4,high,-0.08000000000000007,-9,-6,1209627,-104,1,8
100943,102090,1,Híbrida,3.595,1,Mujer,Linkedin,13,309188,95.0,81,Viudo,43,2016,10,high,102171,Presencial,6.83,0,Hombre,Linkedin,4,488000,92.0,76,Soltero,19,2017,2,high,3.235,-1,-9,178812,121,0,-24
101187,102152,1,Híbrida,2.56,1,Mujer,Portal Web,8,720127,95.0,63,Casado,53,2021,9,high,102089,Presencial,2.75,5,Hombre,Portal Web,7,1616000,15.0,68,Soltero,47,2019,8,low,0.18999999999999995,4,-1,895873,-736,1,-6
101881,102051,1,Híbrida,3.96,2,Hombre,Referidos,12,914684,80.0,76,Casado,46,2014,5,high,102075,Híbrida,1.39,1,Hombre,Portal Web,11,1616000,83.0,76,Casado,46,2019,11,high,-2.5700000000000003,-1,-1,701316,1996,0,0
103227,102014,1,Híbrida,3.525,5,Mujer,Portal Web,1,77097,93.0,81,Soltero,11,2013,4,high,102096,Presencial,1.78,1,Mujer,Portal Web,2,488000,98.0,78,Soltero,25,2023,1,high,-1.7449999999999999,-4,1,410903,3553,0,14
103772,102158,1,Híbrida,5.595,1,Hombre,Referidos,2,230031,82.0,85,Casado,28,2022,3,high,102093,Presencial,1.79,1,Mujer,Referidos,27,1900000,87.0,74,Viudo,54,2013,9,high,-3.8049999999999997,0,25,1669969,-3113,1,26
103627,102051,1,Híbrida,1.545,1,Mujer,Referidos,4,285575,87.0,66,Divorciado,26,2016,7,high,102075,Híbrida,1.39,1,Hombre,Portal Web,11,1616000,83.0,76,Casado,46,2019,11,high,-0.15500000000000003,0,7,1330425,1213,0,20
102334,102128,1,Híbrida,1.65,1,Mujer,Portal Web,3,371196,96.0,73,Casado,34,2020,7,high,102056,Presencial,4.11,10,Mujer,Portal Web,16,1616000,46.0,72,Soltero,55,2021,2,low,2.4600000000000004,9,13,1244804,203,0,21
102955,102080,1,Híbrida,4.035,3,Mujer,Portal Web,8,471092,92.0,66,Casado,34,2016,8,high,102035,Presencial,1.93,0,Mujer,Linkedin,18,1616000,94.0,75,Viudo,47,2016,8,high,-2.1050000000000004,-3,10,1144908,5,0,13
102991,102143,1,Híbrida,2.55,8,Hombre,Linkedin,5,273716,98.0,87,Soltero,44,2021,6,high,102142,Presencial,1.07,2,Hombre,Portal Web,2,590000,90.0,78,Casado,25,2022,2,high,-1.4799999999999998,-6,-3,316284,227,0,-19
103435,102124,1,Híbrida,1.73,2,Hombre,Linkedin,5,735216,91.0,70,Casado,51,2019,4,high,102099,Presencial,2.84,2,Mujer,Linkedin,4,947000,90.0,70,Soltero,24,2012,10,high,1.1099999999999999,0,-1,211784,-2345,1,-27
100821,102088,1,Híbrida,5.205,0,Mujer,Portal Web,2,208240,84.0,71,Soltero,24,2019,4,high,102139,Presencial,4.96,1,Mujer,Portal Web,3,488000,82.0,65,Soltero,20,2018,4,high,-0.2450000000000001,1,1,279760,-365,1,-4
100722,102113,1,Híbrida,1.95,2,Mujer,Linkedin,2,211088,90.0,77,Casado,23,2018,8,high,102041,Presencial,2.96,2,Hombre,Portal Web,6,1152410,46.0,75,Casado,27,2012,1,low,1.01,0,4,941322,-2410,1,4
101814,102158,1,Híbrida,5.575,0,Hombre,Referidos,2,228396,87.0,85,Casado,28,2022,3,high,102093,Presencial,1.79,1,Mujer,Referidos,27,1900000,87.0,74,Viudo,54,2013,9,high,-3.785,1,25,1671604,-3111,1,26
100924,102128,1,Híbrida,1.695,1,Mujer,Portal Web,3,370483,89.0,73,Casado,34,2020,7,high,102056,Presencial,4.11,10,Mujer,Portal Web,16,1616000,46.0,72,Soltero,55,2021,2,low,2.415,9,13,1245517,205,0,21
103157,102047,1,Híbrida,1.65,2,Hombre,Ferias & Networking,3,504839,98.0,80,Soltero,35,2015,5,high,102089,Presencial,2.67,1,Hombre,Linkedin,4,743000,14.0,70,Casado,22,2015,11,low,1.02,-1,1,238161,186,0,-13
103216,102097,1,Híbrida,3.225,3,Mujer,Linkedin,6,257510,93.0,73,Viudo,39,2018,2,high,102024,Presencial,1.95,6,Hombre,Portal Web,4,1100900,57.0,77,Soltero,31,2016,10,low,-1.2750000000000001,3,-2,843390,-477,1,-8
100559,102062,1,Híbrida,2.405,0,Hombre,Portal Web,2,386000,89.0,73,Casado,28,2014,1,high,102149,Presencial,0.92,2,Mujer,Referidos,6,692000,38.0,72,Soltero,21,2014,10,low,-1.4849999999999999,2,4,306000,254,0,-7
103294,102062,1,Híbrida,2.435,0,Hombre,Portal Web,2,387304,86.0,73,Casado,28,2014,1,high,102149,Presencial,0.92,2,Mujer,Referidos,6,692000,38.0,72,Soltero,21,2014,10,low,-1.5150000000000001,2,4,304696,254,0,-7
101591,102107,1,Híbrida,3.68,3,Mujer,Referidos,2,142094,82.0,75,Soltero,19,2019,2,high,102069,Presencial,2.4,1,Mujer,Linkedin,8,1616000,47.0,79,Casado,63,2023,6,low,-1.2800000000000002,-2,6,1473906,1578,0,44
100607,102099,1,Híbrida,1.8,8,Mujer,Portal Web,5,291624,88.0,83,Soltero,28,2019,6,high,102080,Presencial,1.71,0,Hombre,Portal Web,11,1616000,76.0,80,Viudo,51,2021,10,low,-0.09000000000000008,-8,6,1324376,858,0,23
100225,102113,1,Híbrida,1.525,2,Hombre,Linkedin,13,311094,85.0,91,Viudo,45,2019,1,high,102041,Presencial,2.96,2,Hombre,Portal Web,6,1152410,46.0,75,Casado,27,2012,1,low,1.435,0,-7,841316,-2553,1,-18
100709,102012,1,Híbrida,3.08,1,Hombre,Referidos,7,642683,98.0,73,Casado,40,2012,10,high,102122,Presencial,2.09,1,Mujer,Portal Web,7,1100000,90.0,80,Casado,34,2019,7,high,-0.9900000000000002,0,0,457317,2454,0,-6
102396,102150,1,Híbrida,3.185,2,Mujer,Referidos,7,281661,80.0,83,Soltero,44,2021,12,high,102085,Presencial,3.9,8,Mujer,Portal Web,10,1358450,85.0,75,Casado,32,2012,12,high,0.7149999999999999,6,3,1076789,-3287,1,-12
102758,102012,1,Híbrida,3.06,0,Hombre,Referidos,7,634492,82.0,73,Casado,40,2012,10,high,102122,Presencial,2.09,1,Mujer,Portal Web,7,1100000,90.0,80,Casado,34,2019,7,high,-0.9700000000000002,1,0,465508,2453,0,-6
100816,102081,1,Híbrida,1.19,2,Mujer,Portal Web,17,720841,81.0,88,Casado,49,2018,2,high,102135,Presencial,2.5,2,Hombre,Portal Web,4,488000,26.0,64,Soltero,18,2015,8,low,1.31,0,-13,-232841,-895,1,-31
103280,102023,1,Híbrida,1.97,1,Hombre,Portal Web,2,102719,84.0,66,Soltero,11,2013,5,high,102105,Híbrida,4.9,1,Hombre,Portal Web,4,539000,80.0,65,Casado,23,2019,12,high,2.9300000000000006,0,2,436281,2416,0,12
102253,102107,1,Híbrida,3.67,3,Mujer,Referidos,2,140792,98.0,75,Soltero,19,2019,2,high,102069,Presencial,2.4,1,Mujer,Linkedin,8,1616000,47.0,79,Casado,63,2023,6,low,-1.27,-2,6,1475208,1576,0,44
104090,102081,1,Híbrida,1.17,3,Mujer,Portal Web,17,717126,90.0,88,Casado,49,2018,2,high,102135,Presencial,2.5,2,Hombre,Portal Web,4,488000,26.0,64,Soltero,18,2015,8,low,1.33,-1,-13,-229126,-897,1,-31
101957,102054,1,Híbrida,2.27,2,Mujer,Referidos,3,407200,94.0,79,Casado,29,2014,6,high,102044,Presencial,2.91,1,Hombre,Linkedin,17,1616000,85.0,74,Divorciado,41,2012,11,high,0.6400000000000001,-1,14,1208800,-575,1,12
100450,102134,1,Híbrida,1.335,0,Mujer,Portal Web,12,816997,97.0,64,Casado,49,2021,9,high,102135,Presencial,2.25,2,Hombre,Portal Web,5,1358450,90.0,69,Viudo,31,2012,7,high,0.915,2,-7,541453,-3358,1,-18
102992,102011,1,Híbrida,2.72,2,Mujer,Portal Web,8,441648,85.0,78,Casado,37,2012,10,high,102048,Presencial,5.37,1,Hombre,Ferias & Networking,7,845000,52.0,74,Casado,22,2012,11,low,2.65,-1,-1,403352,28,0,-15
101669,102131,1,Híbrida,2.905,2,Hombre,Ferias & Networking,2,118801,97.0,74,Soltero,22,2022,8,high,102109,Presencial,5.54,0,Hombre,Linkedin,3,998000,39.0,77,Soltero,34,2021,12,low,2.6350000000000002,-2,1,879199,-239,1,12
102730,102049,1,Híbrida,6.75,1,Mujer,Linkedin,1,185949,80.0,84,Casado,17,2012,11,high,102029,Presencial,6.89,0,Mujer,Portal Web,9,1616000,19.0,77,Divorciado,49,2023,3,low,0.13999999999999968,-1,8,1430051,3771,0,32
103611,102068,1,Híbrida,1.215,1,Hombre,Linkedin,3,225522,95.0,77,Viudo,22,2016,8,high,102043,Híbrida,2.17,3,Mujer,Referidos,4,896000,41.0,81,Soltero,23,2012,8,low,0.9549999999999998,2,1,670478,-1451,1,1
103570,102023,1,Híbrida,2.74,2,Mujer,Portal Web,6,306754,91.0,76,Soltero,23,2013,11,high,102105,Híbrida,4.9,1,Hombre,Portal Web,4,539000,80.0,65,Casado,23,2019,12,high,2.16,-1,-2,232246,2225,0,0
102638,102064,1,Híbrida,6.09,1,Hombre,Ferias & Networking,8,351896,87.0,71,Soltero,27,2015,3,high,102067,Presencial,1.34,0,Hombre,Portal Web,6,1616000,92.0,92,Casado,43,2018,2,high,-4.75,-1,-2,1264104,1062,0,16
103888,102134,1,Híbrida,2.855,0,Mujer,Portal Web,12,505481,87.0,67,Casado,42,2022,11,high,102135,Presencial,2.25,2,Hombre,Portal Web,5,1358450,90.0,69,Viudo,31,2012,7,high,-0.605,2,-7,852969,-3790,1,-11
102999,102115,1,Híbrida,5.25,0,Hombre,Portal Web,12,279134,97.0,71,Casado,42,2018,12,high,102116,Presencial,2.0,2,Mujer,Portal Web,4,1616000,94.0,76,Soltero,35,2018,12,high,-3.25,2,-8,1336866,21,0,-7
101983,102068,1,Híbrida,1.225,1,Hombre,Linkedin,3,226438,88.0,77,Viudo,22,2016,8,high,102043,Híbrida,2.17,3,Mujer,Referidos,4,896000,41.0,81,Soltero,23,2012,8,low,0.9449999999999998,2,1,669562,-1450,1,1
101967,102023,1,Híbrida,2.77,3,Mujer,Referidos,6,307880,92.0,76,Soltero,23,2013,11,high,102105,Híbrida,4.9,1,Hombre,Portal Web,4,539000,80.0,65,Casado,23,2019,12,high,2.1300000000000003,-2,-2,231120,2227,0,0
100301,102143,1,Híbrida,3.49,1,Mujer,Linkedin,11,827629,86.0,71,Casado,40,2021,10,high,102142,Presencial,1.07,2,Hombre,Portal Web,2,590000,90.0,78,Casado,25,2022,2,high,-2.42,1,-9,-237629,119,0,-15
102836,102064,1,Híbrida,1.92,1,Mujer,Referidos,1,146993,82.0,74,Soltero,18,2017,3,high,102067,Presencial,1.34,0,Hombre,Portal Web,6,1616000,92.0,92,Casado,43,2018,2,high,-0.5799999999999998,-1,5,1469007,320,0,25
103248,102124,1,Híbrida,6.71,2,Mujer,Portal Web,6,268165,93.0,86,Casado,29,2021,4,high,102099,Presencial,2.84,2,Mujer,Linkedin,4,947000,90.0,70,Soltero,24,2012,10,high,-3.87,0,-2,678835,-3094,1,-5
102510,102059,1,Híbrida,4.345,3,Hombre,Ferias & Networking,4,386354,86.0,69,Soltero,30,2016,7,high,102021,Presencial,2.55,2,Hombre,Portal Web,16,1616000,27.0,76,Viudo,50,2019,6,low,-1.795,-1,12,1229646,1057,0,20
104077,102054,1,Híbrida,1.825,3,Hombre,Linkedin,13,265162,88.0,77,Divorciado,38,2016,2,high,102044,Presencial,2.91,1,Hombre,Linkedin,17,1616000,85.0,74,Divorciado,41,2012,11,high,1.0850000000000002,-2,4,1350838,-1182,1,3
100793,102124,1,Híbrida,6.725,1,Mujer,Portal Web,6,270932,94.0,86,Casado,29,2021,4,high,102099,Presencial,2.84,2,Mujer,Linkedin,4,947000,90.0,70,Soltero,24,2012,10,high,-3.885,1,-2,676068,-3091,1,-5
100035,102150,1,Híbrida,1.79,1,Hombre,Referidos,5,425866,83.0,72,Casado,39,2023,4,high,102085,Presencial,3.9,8,Mujer,Portal Web,10,1358450,85.0,75,Casado,32,2012,12,high,2.11,7,5,932584,-3783,1,-7
100367,102145,1,Híbrida,5.505,1,Hombre,Referidos,9,468469,97.0,76,Casado,40,2022,2,high,102116,Presencial,1.43,1,Mujer,Portal Web,3,692000,89.0,73,Viudo,23,2016,12,high,-4.075,0,-6,223531,-1908,1,-17
100991,102076,1,Híbrida,4.36,2,Hombre,Linkedin,13,266712,88.0,80,Soltero,37,2015,8,high,102168,Híbrida,1.95,1,Hombre,Referidos,9,1616000,95.0,82,Soltero,53,2023,9,high,-2.41,-1,-4,1349288,2957,0,16
101966,102118,1,Híbrida,1.39,2,Hombre,Referidos,8,319452,93.0,70,Divorciado,46,2019,11,high,102171,Presencial,4.76,17,Mujer,Linkedin,4,1616000,86.0,74,Soltero,39,2023,8,high,3.37,15,-4,1296548,1378,0,-7
104147,102109,1,Híbrida,1.84,2,Hombre,Portal Web,1,144569,96.0,75,Soltero,22,2020,12,high,102123,Presencial,3.86,1,Mujer,Portal Web,5,998000,97.0,82,Casado,32,2019,9,high,2.0199999999999996,-1,4,853431,-447,1,10
103698,102145,1,Híbrida,5.515,2,Hombre,Referidos,9,470520,90.0,76,Casado,40,2022,2,high,102116,Presencial,1.43,1,Mujer,Portal Web,3,692000,89.0,73,Viudo,23,2016,12,high,-4.085,-1,-6,221480,-1909,1,-17
103741,102150,1,Híbrida,4.26,2,Mujer,Referidos,11,443635,98.0,80,Divorciado,43,2022,6,high,102085,Presencial,3.9,8,Mujer,Portal Web,10,1358450,85.0,75,Casado,32,2012,12,high,-0.3599999999999999,6,-1,914815,-3478,1,-11
103340,102118,1,Híbrida,1.39,2,Hombre,Referidos,8,319609,80.0,70,Divorciado,46,2019,11,high,102171,Presencial,4.76,17,Mujer,Linkedin,4,1616000,86.0,74,Soltero,39,2023,8,high,3.37,15,-4,1296391,1378,0,-7
100033,102109,1,Híbrida,1.855,1,Hombre,Portal Web,1,144872,90.0,75,Soltero,22,2020,12,high,102123,Presencial,3.86,1,Mujer,Portal Web,5,998000,97.0,82,Casado,32,2019,9,high,2.005,0,4,853128,-447,1,10
103388,102076,1,Híbrida,4.355,3,Hombre,Linkedin,13,265975,98.0,80,Soltero,37,2015,8,high,102168,Híbrida,1.95,1,Hombre,Referidos,9,1616000,95.0,82,Soltero,53,2023,9,high,-2.4050000000000002,-2,-4,1350025,2957,0,16
103296,102032,1,Híbrida,4.0,6,Hombre,Portal Web,17,681511,94.0,73,Casado,42,2013,4,high,102065,Presencial,1.78,7,Hombre,Portal Web,14,1616000,42.0,71,Casado,42,2015,11,low,-2.2199999999999998,1,-3,934489,938,0,0
101446,102127,1,Híbrida,2.23,1,Mujer,Portal Web,8,330668,96.0,74,Casado,33,2022,3,high,102028,Presencial,4.03,2,Mujer,Linkedin,9,1306940,88.0,78,Divorciado,32,2014,5,high,1.8000000000000003,1,1,976272,-2864,1,-1
100808,102119,1,Híbrida,6.985,1,Hombre,Portal Web,7,308775,80.0,67,Soltero,32,2021,10,high,102107,Presencial,2.22,2,Hombre,Portal Web,12,1616000,38.0,70,Divorciado,52,2021,1,low,-4.765000000000001,1,5,1307225,-281,1,20
101394,102127,1,Híbrida,2.17,5,Hombre,Linkedin,7,465192,94.0,80,Soltero,38,2020,6,high,102028,Presencial,4.03,2,Mujer,Linkedin,9,1306940,88.0,78,Divorciado,32,2014,5,high,1.8600000000000003,-3,2,841748,-2200,1,-6
100641,102050,1,Híbrida,1.865,6,Mujer,Portal Web,12,807538,97.0,66,Casado,32,2013,9,high,102069,Presencial,3.7,0,Mujer,Linkedin,11,1512980,90.0,88,Soltero,40,2017,10,high,1.8350000000000002,-6,-1,705442,1485,0,8
100529,102129,1,Híbrida,2.78,10,Mujer,Portal Web,11,917445,81.0,70,Soltero,47,2019,9,high,102142,Presencial,2.1,2,Mujer,Linkedin,3,590000,41.0,74,Soltero,24,2020,1,low,-0.6799999999999997,-8,-8,-327445,107,0,-23
101272,102100,1,Híbrida,2.235,7,Mujer,Portal Web,8,858522,87.0,79,Soltero,46,2018,5,high,102007,Presencial,3.3,1,Mujer,Portal Web,3,1255430,21.0,59,Casado,30,2013,2,low,1.065,-6,-5,396908,-1914,1,-16
102788,102098,1,Híbrida,6.6,1,Mujer,Linkedin,6,410330,88.0,73,Casado,34,2019,4,high,102049,Presencial,1.8,1,Mujer,Portal Web,16,1616000,90.0,86,Casado,46,2021,1,high,-4.8,0,10,1205670,657,0,12
102858,102050,1,Híbrida,1.885,5,Mujer,Portal Web,12,811396,85.0,66,Casado,31,2013,9,high,102069,Presencial,3.7,0,Mujer,Linkedin,11,1512980,90.0,88,Soltero,40,2017,10,high,1.8150000000000002,-5,-1,701584,1486,0,9
100907,102071,1,Híbrida,1.99,0,Hombre,Portal Web,1,84347,97.0,79,Soltero,12,2014,10,high,102171,Presencial,0.87,1,Hombre,Portal Web,11,1616000,85.0,72,Viudo,51,2023,11,high,-1.12,1,10,1531653,3327,0,39
100598,102042,1,Híbrida,1.39,8,Hombre,Portal Web,4,164920,84.0,73,Soltero,18,2015,10,high,102107,Presencial,2.19,2,Hombre,Ferias & Networking,8,1616000,38.0,78,Divorciado,57,2018,6,low,0.8,-6,4,1451080,991,0,39
101842,102095,1,Híbrida,1.455,1,Mujer,Linkedin,7,309884,85.0,75,Soltero,28,2017,12,high,102171,Presencial,3.28,2,Mujer,Portal Web,3,1616000,80.0,75,Soltero,42,2023,10,high,1.8249999999999997,1,-4,1306116,2120,0,14
103261,102071,1,Híbrida,1.99,1,Hombre,Portal Web,1,79070,84.0,79,Soltero,11,2014,10,high,102171,Presencial,0.87,1,Hombre,Portal Web,11,1616000,85.0,72,Viudo,51,2023,11,high,-1.12,0,10,1536930,3326,0,40
103859,102042,1,Híbrida,1.395,8,Hombre,Portal Web,4,168808,87.0,73,Soltero,18,2015,10,high,102107,Presencial,2.19,2,Hombre,Ferias & Networking,8,1616000,38.0,78,Divorciado,57,2018,6,low,0.7949999999999999,-6,4,1447192,989,0,39
103768,102110,1,Híbrida,3.82,3,Hombre,Portal Web,4,183599,94.0,72,Casado,25,2021,3,high,102045,Presencial,1.6,5,Mujer,Linkedin,2,998000,87.0,76,Soltero,29,2016,11,high,-2.2199999999999998,2,-2,814401,-1584,1,4
102846,102095,1,Híbrida,1.46,0,Mujer,Linkedin,7,313021,93.0,75,Soltero,28,2017,12,high,102171,Presencial,3.28,2,Mujer,Portal Web,3,1616000,80.0,75,Soltero,42,2023,10,high,1.8199999999999998,2,-4,1302979,2120,0,14
103836,102072,1,Híbrida,1.645,3,Mujer,Referidos,5,411629,89.0,81,Casado,31,2016,8,high,102046,Presencial,2.61,2,Hombre,Ferias & Networking,3,947000,41.0,71,Soltero,30,2018,11,low,0.9649999999999999,-1,-2,535371,840,0,-1
102330,102007,1,Híbrida,1.88,3,Mujer,Portal Web,4,259970,86.0,83,Casado,33,2012,2,high,102070,Presencial,5.11,2,Mujer,Portal Web,6,1358450,96.0,62,Soltero,41,2022,4,high,3.2300000000000004,-1,2,1098480,3730,0,8
101801,102046,1,Híbrida,1.595,0,Hombre,Portal Web,5,261229,84.0,77,Soltero,35,2014,5,high,102007,Presencial,1.68,0,Mujer,Portal Web,8,1616000,41.0,71,Soltero,50,2015,10,low,0.08499999999999996,0,3,1354771,538,0,15
101765,102128,1,Híbrida,2.265,11,Mujer,Headhunter,13,301057,83.0,69,Casado,47,2022,8,high,102056,Presencial,4.11,10,Mujer,Portal Web,16,1616000,46.0,72,Soltero,55,2021,2,low,1.8450000000000002,-1,3,1314943,-536,1,8
103517,102047,1,Híbrida,2.82,2,Mujer,Referidos,4,428330,88.0,88,Casado,30,2013,9,high,102089,Presencial,2.67,1,Hombre,Linkedin,4,743000,14.0,70,Casado,22,2015,11,low,-0.1499999999999999,-1,0,314670,794,0,-8
103761,102054,1,Híbrida,1.465,2,Mujer,Linkedin,5,381819,85.0,87,Soltero,35,2014,11,high,102044,Presencial,2.91,1,Hombre,Linkedin,17,1616000,85.0,74,Divorciado,41,2012,11,high,1.445,-1,12,1234181,-752,1,6
100949,102139,1,Híbrida,4.79,1,Mujer,Portal Web,3,208884,97.0,71,Casado,25,2021,3,high,102154,Presencial,6.48,1,Hombre,Ferias & Networking,5,590000,90.0,67,Casado,25,2021,6,high,1.6900000000000004,0,2,381116,111,0,0
102104,102129,2,Híbrida,6.72,1,Mujer,Portal Web,6,743000,91.0,61,Soltero,30,2023,4,high,102142,Presencial,2.1,2,Mujer,Linkedin,3,590000,41.0,74,Soltero,24,2020,1,low,-4.619999999999999,1,-3,-153000,-1179,1,-6
100375,102129,1,Híbrida,1.425,3,Mujer,Referidos,4,431734,86.0,80,Soltero,38,2021,6,high,102142,Presencial,2.1,2,Mujer,Linkedin,3,590000,41.0,74,Soltero,24,2020,1,low,0.675,-1,-1,158266,-518,1,-14
103520,102172,1,Híbrida,2.49,2,Hombre,Portal Web,7,305135,84.0,67,Casado,33,2023,1,high,102020,Presencial,5.58,1,Hombre,Portal Web,7,1049000,57.0,70,Casado,29,2016,4,low,3.09,-1,0,743865,-2457,1,-4
102205,102038,1,Híbrida,4.89,1,Hombre,Portal Web,7,371567,83.0,73,Soltero,27,2014,5,high,102125,Presencial,2.06,1,Hombre,Portal Web,12,1616000,81.0,82,Casado,44,2018,1,high,-2.8299999999999996,0,5,1244433,1350,0,17
102956,102129,1,Híbrida,1.42,2,Mujer,Referidos,4,430964,85.0,80,Soltero,38,2021,6,high,102142,Presencial,2.1,2,Mujer,Linkedin,3,590000,41.0,74,Soltero,24,2020,1,low,0.6800000000000002,0,-1,159036,-518,1,-14
102910,102046,1,Híbrida,1.635,0,Hombre,Portal Web,5,259833,86.0,77,Soltero,35,2014,5,high,102007,Presencial,1.68,0,Mujer,Portal Web,8,1616000,41.0,71,Soltero,50,2015,10,low,0.04499999999999993,0,3,1356167,537,0,15
101546,102123,1,Híbrida,4.91,1,Hombre,Linkedin,5,716735,92.0,75,Divorciado,51,2019,4,high,102043,Presencial,5.5,1,Mujer,Linkedin,16,1616000,42.0,66,Soltero,51,2021,9,low,0.5899999999999999,0,11,899265,892,0,0
103707,102087,1,Híbrida,1.405,1,Hombre,Portal Web,4,328697,92.0,60,Casado,29,2017,9,high,102111,Presencial,7.16,9,Mujer,Linkedin,10,1616000,98.0,79,Casado,42,2012,5,high,5.755,8,6,1287303,-1972,1,13
103953,102074,1,Híbrida,2.45,11,Mujer,Portal Web,6,391429,81.0,73,Soltero,30,2015,5,high,102028,Presencial,1.35,0,Hombre,Ferias & Networking,4,1616000,80.0,83,Viudo,43,2015,12,high,-1.1,-11,-2,1224571,214,0,13
103374,102059,1,Híbrida,2.445,0,Mujer,Linkedin,3,717366,86.0,80,Casado,44,2014,1,high,102021,Presencial,2.55,2,Hombre,Portal Web,16,1616000,27.0,76,Viudo,50,2019,6,low,0.10499999999999998,2,13,898634,1969,0,6
101055,102134,1,Híbrida,1.605,2,Mujer,Ferias & Networking,2,116906,80.0,71,Soltero,20,2021,4,high,102135,Presencial,2.25,2,Hombre,Portal Web,5,1358450,90.0,69,Viudo,31,2012,7,high,0.645,0,3,1241544,-3199,1,11
101297,102142,1,Híbrida,3.65,1,Hombre,Ferias & Networking,1,227685,97.0,75,Casado,28,2021,10,high,102047,Presencial,2.48,2,Hombre,Portal Web,3,1255430,90.0,66,Soltero,36,2019,7,high,-1.17,1,2,1027745,-839,1,8
101396,102087,1,Híbrida,1.42,1,Hombre,Portal Web,4,326924,93.0,60,Casado,29,2017,9,high,102111,Presencial,7.16,9,Mujer,Linkedin,10,1616000,98.0,79,Casado,42,2012,5,high,5.74,8,6,1289076,-1971,1,13
100819,102023,1,Híbrida,3.21,0,Mujer,Linkedin,7,365292,91.0,73,Casado,25,2012,4,high,102105,Híbrida,4.9,1,Hombre,Portal Web,4,539000,80.0,65,Casado,23,2019,12,high,1.6900000000000004,1,-3,173708,2828,0,-2
101819,102125,1,Híbrida,5.825,3,Mujer,Portal Web,14,276802,81.0,74,Casado,45,2021,8,high,102096,Híbrida,4.0,2,Mujer,Referidos,5,692000,87.0,82,Casado,29,2022,7,high,-1.8250000000000002,-1,-9,415198,332,0,-16
101096,102115,1,Híbrida,4.84,2,Hombre,Portal Web,9,390386,98.0,76,Soltero,45,2020,6,high,102116,Presencial,2.0,2,Mujer,Portal Web,4,1616000,94.0,76,Soltero,35,2018,12,high,-2.84,0,-5,1225614,-547,1,-10
103582,102134,1,Híbrida,1.58,3,Mujer,Portal Web,2,115484,93.0,71,Soltero,20,2021,4,high,102135,Presencial,2.25,2,Hombre,Portal Web,5,1358450,90.0,69,Viudo,31,2012,7,high,0.6699999999999999,-1,3,1242966,-3198,1,11
103928,102042,1,Híbrida,4.51,11,Mujer,Linkedin,3,863449,83.0,81,Casado,35,2015,5,high,102107,Presencial,2.19,2,Hombre,Ferias & Networking,8,1616000,38.0,78,Divorciado,57,2018,6,low,-2.32,-9,5,752551,1154,0,22
102883,102040,1,Híbrida,1.855,1,Mujer,Portal Web,12,301002,82.0,73,Casado,39,2014,1,high,102106,Presencial,3.21,1,Hombre,Linkedin,15,1616000,91.0,84,Soltero,45,2016,7,high,1.355,0,3,1314998,923,0,6
103608,102123,1,Híbrida,4.925,2,Hombre,Linkedin,5,717745,91.0,75,Divorciado,51,2019,4,high,102043,Presencial,5.5,1,Mujer,Linkedin,16,1616000,42.0,66,Soltero,51,2021,9,low,0.5750000000000002,-1,11,898255,890,0,0
100494,102069,1,Híbrida,2.85,1,Hombre,Ferias & Networking,1,142592,84.0,76,Soltero,14,2014,12,high,102069,Presencial,4.64,1,Mujer,Ferias & Networking,19,1616000,47.0,74,Casado,60,2021,10,low,1.7899999999999996,0,18,1473408,2491,0,46
100128,102130,1,Híbrida,5.805,8,Mujer,Linkedin,3,205851,88.0,73,Casado,28,2023,2,high,102068,Presencial,1.97,6,Hombre,Linkedin,5,1616000,84.0,73,Soltero,31,2014,4,high,-3.835,-2,2,1410149,-3219,1,3
100676,102060,1,Híbrida,1.5,9,Mujer,Linkedin,1,225508,97.0,67,Soltero,20,2014,6,high,102041,Presencial,4.42,3,Hombre,Referidos,16,1616000,82.0,62,Casado,45,2013,10,high,2.92,-6,15,1390492,-217,1,25
100708,102045,1,Híbrida,2.965,4,Hombre,Linkedin,6,287046,83.0,73,Casado,24,2014,12,high,102171,Presencial,3.19,3,Hombre,Portal Web,11,1616000,97.0,65,Casado,53,2023,9,high,0.2250000000000001,-1,5,1328954,3208,0,29
101125,102122,1,Híbrida,1.885,10,Hombre,Linkedin,9,425333,98.0,74,Divorciado,47,2020,10,high,102075,Presencial,1.83,4,Hombre,Portal Web,6,1616000,90.0,66,Viudo,48,2019,3,high,-0.05499999999999994,-6,-3,1190667,-582,1,1
102541,102069,1,Híbrida,2.895,0,Hombre,Ferias & Networking,1,144093,95.0,76,Soltero,14,2014,12,high,102069,Presencial,4.64,1,Mujer,Ferias & Networking,19,1616000,47.0,74,Casado,60,2021,10,low,1.7449999999999997,1,18,1471907,2491,0,46
103546,102138,1,Híbrida,4.41,3,Mujer,Linkedin,5,210944,97.0,73,Soltero,28,2023,6,high,102059,Presencial,3.26,1,Hombre,Linkedin,5,1616000,57.0,75,Soltero,44,2018,4,low,-1.1500000000000004,-2,0,1405056,-1889,1,16
103844,102045,1,Híbrida,2.94,3,Hombre,Linkedin,6,291530,82.0,73,Casado,24,2014,12,high,102171,Presencial,3.19,3,Hombre,Portal Web,11,1616000,97.0,65,Casado,53,2023,9,high,0.25,0,5,1324470,3208,0,29
103603,102143,1,Híbrida,0.805,4,Mujer,Referidos,8,366632,96.0,76,Soltero,34,2020,12,high,102142,Presencial,1.07,2,Hombre,Portal Web,2,590000,90.0,78,Casado,25,2022,2,high,0.265,-2,-6,223368,406,0,-9
102897,102023,1,Híbrida,3.21,1,Mujer,Linkedin,7,368755,80.0,73,Casado,25,2012,4,high,102105,Híbrida,4.9,1,Hombre,Portal Web,4,539000,80.0,65,Casado,23,2019,12,high,1.6900000000000004,0,-3,170245,2827,0,-2
103313,102115,1,Híbrida,2.575,0,Hombre,Portal Web,8,453171,80.0,70,Casado,36,2019,5,high,102116,Presencial,2.0,2,Mujer,Portal Web,4,1616000,94.0,76,Soltero,35,2018,12,high,-0.5750000000000002,2,-4,1162829,-147,1,-1
103745,102115,1,Híbrida,4.815,3,Hombre,Portal Web,9,386619,86.0,76,Soltero,45,2020,6,high,102116,Presencial,2.0,2,Mujer,Portal Web,4,1616000,94.0,76,Soltero,35,2018,12,high,-2.8150000000000004,-1,-5,1229381,-548,1,-10
103347,102122,1,Híbrida,1.88,11,Hombre,Linkedin,9,427337,97.0,74,Divorciado,47,2020,10,high,102075,Presencial,1.83,4,Hombre,Portal Web,6,1616000,90.0,66,Viudo,48,2019,3,high,-0.04999999999999982,-7,-3,1188663,-582,1,1
103969,102041,1,Híbrida,1.755,2,Hombre,Portal Web,13,799982,89.0,69,Soltero,43,2015,1,high,102147,Presencial,1.29,0,Mujer,Portal Web,8,1616000,44.0,73,Casado,51,2014,5,low,-0.46499999999999986,-2,-5,816018,-257,1,8
102528,102092,1,Híbrida,5.41,1,Mujer,Linkedin,9,856756,93.0,82,Divorciado,49,2017,4,high,102120,Presencial,1.23,6,Mujer,Linkedin,13,1616000,98.0,95,Viudo,41,2013,6,high,-4.18,5,4,759244,-1397,1,-8
103721,102144,1,Híbrida,7.175,3,Hombre,Linkedin,11,880763,92.0,76,Casado,54,2021,10,high,102156,Presencial,2.13,8,Mujer,Portal Web,11,1616000,5.0,82,Viudo,58,2015,6,low,-5.045,5,0,735237,-2303,1,4
101888,102054,1,Híbrida,1.865,2,Hombre,Linkedin,2,185944,97.0,85,Soltero,18,2015,5,high,102044,Presencial,2.91,1,Hombre,Linkedin,17,1616000,85.0,74,Divorciado,41,2012,11,high,1.0450000000000002,-1,15,1430056,-930,1,23
102619,102054,1,Híbrida,1.865,2,Hombre,Linkedin,2,181818,94.0,85,Soltero,18,2015,5,high,102044,Presencial,2.91,1,Hombre,Linkedin,17,1616000,85.0,74,Divorciado,41,2012,11,high,1.0450000000000002,-1,15,1434182,-928,1,23
103861,102130,1,Híbrida,5.81,7,Mujer,Linkedin,3,205890,92.0,73,Casado,28,2023,2,high,102068,Presencial,1.97,6,Hombre,Linkedin,5,1616000,84.0,73,Soltero,31,2014,4,high,-3.84,-1,2,1410110,-3219,1,3
102499,102124,1,Híbrida,2.64,2,Mujer,Ferias & Networking,15,412009,81.0,73,Casado,43,2020,10,high,102099,Presencial,2.84,2,Mujer,Linkedin,4,947000,90.0,70,Soltero,24,2012,10,high,0.19999999999999973,0,-11,534991,-2912,1,-19
103192,102051,1,Híbrida,2.585,1,Mujer,Portal Web,7,878939,92.0,79,Viudo,49,2013,5,high,102075,Híbrida,1.39,1,Hombre,Portal Web,11,1616000,83.0,76,Casado,46,2019,11,high,-1.195,0,4,737061,2381,0,-3
101726,102055,1,Híbrida,4.245,1,Mujer,Portal Web,1,226087,92.0,76,Casado,22,2016,1,high,102129,Presencial,1.92,2,Hombre,Referidos,8,1616000,97.0,63,Casado,42,2013,2,high,-2.325,1,7,1389913,-1059,1,20
102834,102055,1,Híbrida,4.27,0,Mujer,Portal Web,1,226976,90.0,76,Casado,22,2016,1,high,102129,Presencial,1.92,2,Hombre,Referidos,8,1616000,97.0,63,Casado,42,2013,2,high,-2.3499999999999996,2,7,1389024,-1058,1,20
103547,102101,1,Híbrida,4.135,2,Mujer,Portal Web,9,312171,80.0,74,Soltero,46,2019,3,high,102089,Presencial,6.23,0,Hombre,Portal Web,26,1616000,92.0,68,Divorciado,55,2014,1,high,2.0950000000000006,-2,17,1303829,-1904,1,9
103398,102140,1,Híbrida,1.95,1,Mujer,Referidos,6,734031,80.0,66,Soltero,53,2021,8,high,102040,Presencial,2.55,0,Mujer,Portal Web,16,1616000,46.0,69,Casado,39,2012,2,low,0.5999999999999999,-1,10,881969,-3474,1,-14
101473,102116,1,Híbrida,2.335,0,Hombre,Ferias & Networking,3,265665,91.0,79,Casado,28,2019,9,high,102021,Presencial,2.32,0,Mujer,Portal Web,22,1616000,94.0,76,Casado,59,2020,7,high,-0.015000000000000124,0,19,1350335,313,0,31
103232,102049,1,Híbrida,3.305,2,Mujer,Portal Web,5,271492,83.0,79,Soltero,37,2015,9,high,102029,Presencial,6.89,0,Mujer,Portal Web,9,1616000,19.0,77,Divorciado,49,2023,3,low,3.5849999999999995,-2,4,1344508,2732,0,12
102243,102085,1,Híbrida,1.195,3,Hombre,Linkedin,5,299666,94.0,70,Casado,44,2019,5,high,102145,Presencial,6.59,4,Hombre,Portal Web,12,1616000,47.0,71,Casado,39,2015,8,low,5.395,1,7,1316334,-1383,1,-5
103480,102151,1,Híbrida,3.4,1,Hombre,Ferias & Networking,13,739512,80.0,85,Casado,55,2023,3,high,102105,Presencial,1.51,2,Hombre,Ferias & Networking,10,1616000,85.0,80,Divorciado,45,2021,11,high,-1.89,1,-3,876488,-488,1,-10
101102,102075,1,Híbrida,2.56,2,Mujer,Portal Web,7,276677,98.0,71,Soltero,39,2016,4,high,102047,Presencial,2.7,1,Hombre,Referidos,11,1255430,90.0,76,Casado,30,2013,3,high,0.14000000000000012,-1,4,978753,-1100,1,-9
101702,102151,1,Híbrida,3.385,0,Hombre,Ferias & Networking,13,735351,93.0,85,Casado,55,2023,3,high,102105,Presencial,1.51,2,Hombre,Ferias & Networking,10,1616000,85.0,80,Divorciado,45,2021,11,high,-1.8749999999999998,2,-3,880649,-490,1,-10
102931,102116,1,Híbrida,2.305,0,Hombre,Ferias & Networking,3,271026,95.0,79,Casado,28,2019,9,high,102021,Presencial,2.32,0,Mujer,Portal Web,22,1616000,94.0,76,Casado,59,2020,7,high,0.01499999999999968,0,19,1344974,313,0,31
101864,102122,1,Híbrida,3.905,1,Hombre,Referidos,2,101622,93.0,77,Soltero,20,2022,1,high,102075,Presencial,1.83,4,Hombre,Portal Web,6,1616000,90.0,66,Viudo,48,2019,3,high,-2.0749999999999997,3,4,1514378,-1027,1,28
102995,102122,1,Híbrida,3.935,2,Hombre,Referidos,2,98968,85.0,77,Soltero,20,2022,1,high,102075,Presencial,1.83,4,Hombre,Portal Web,6,1616000,90.0,66,Viudo,48,2019,3,high,-2.105,2,4,1517032,-1028,1,28
102199,102075,1,Híbrida,3.085,1,Hombre,Linkedin,7,329140,83.0,73,Casado,26,2015,1,high,102047,Presencial,2.7,1,Hombre,Referidos,11,1255430,90.0,76,Casado,30,2013,3,high,-0.3849999999999998,0,4,926290,-671,1,4
100637,102107,1,Híbrida,3.125,8,Hombre,Linkedin,1,115713,87.0,77,Soltero,18,2018,6,high,102069,Presencial,2.4,1,Mujer,Linkedin,8,1616000,47.0,79,Casado,63,2023,6,low,-0.7250000000000001,-7,7,1500287,1826,0,45
101129,102009,1,Híbrida,4.465,5,Hombre,Portal Web,4,213899,96.0,75,Soltero,17,2012,2,high,102116,Presencial,2.06,2,Hombre,Referidos,9,1461470,90.0,73,Casado,44,2022,8,high,-2.405,-3,5,1247571,3827,0,27
100053,102094,1,Híbrida,3.35,0,Hombre,Referidos,9,347600,98.0,88,Soltero,31,2018,12,high,102095,Presencial,1.32,1,Hombre,Portal Web,4,998000,90.0,85,Casado,28,2016,2,high,-2.0300000000000002,1,-5,650400,-1061,1,-3
101666,102060,1,Híbrida,5.36,1,Hombre,Referidos,10,386117,85.0,74,Casado,30,2015,8,high,102041,Presencial,4.42,3,Hombre,Referidos,16,1616000,82.0,62,Casado,45,2013,10,high,-0.9400000000000004,2,6,1229883,-651,1,15
101466,102095,1,Híbrida,2.6,8,Mujer,Linkedin,6,469352,86.0,82,Soltero,36,2018,5,high,102171,Presencial,3.28,2,Mujer,Portal Web,3,1616000,80.0,75,Soltero,42,2023,10,high,0.6799999999999997,-6,-3,1146648,1970,0,6
100480,102134,1,Híbrida,3.195,2,Hombre,Linkedin,5,699680,81.0,78,Casado,52,2021,8,high,102135,Presencial,2.25,2,Hombre,Portal Web,5,1358450,90.0,69,Viudo,31,2012,7,high,-0.9449999999999998,0,0,658770,-3320,1,-21
103092,102087,1,Híbrida,6.68,0,Hombre,Ferias & Networking,4,191184,87.0,73,Soltero,21,2017,9,high,102111,Presencial,7.16,9,Mujer,Linkedin,10,1616000,98.0,79,Casado,42,2012,5,high,0.4800000000000004,9,6,1424816,-1946,1,21
102281,102086,1,Híbrida,3.97,0,Mujer,Portal Web,5,233953,81.0,79,Soltero,22,2016,7,high,102085,Presencial,2.22,2,Mujer,Linkedin,7,1306940,87.0,68,Divorciado,39,2021,3,high,-1.75,2,2,1072987,1702,0,17
103264,102143,1,Híbrida,3.215,0,Mujer,Referidos,3,313610,95.0,67,Soltero,32,2022,1,high,102142,Presencial,1.07,2,Hombre,Portal Web,2,590000,90.0,78,Casado,25,2022,2,high,-2.1449999999999996,2,-1,276390,8,0,-7
102559,102094,1,Híbrida,3.345,0,Hombre,Referidos,9,352077,91.0,88,Soltero,31,2018,12,high,102095,Presencial,1.32,1,Hombre,Portal Web,4,998000,90.0,85,Casado,28,2016,2,high,-2.0250000000000004,1,-5,645923,-1058,1,-3
103645,102048,1,Híbrida,6.505,7,Hombre,Linkedin,6,367729,90.0,78,Soltero,26,2012,10,high,102092,Presencial,3.99,0,Mujer,Portal Web,5,590000,59.0,76,Soltero,20,2015,8,low,-2.5149999999999997,-7,-1,222271,1039,0,-6
103114,102022,1,Híbrida,0.91,1,Mujer,Ferias & Networking,3,449462,87.0,81,Casado,29,2013,2,high,102081,Presencial,2.07,0,Hombre,Portal Web,6,1616000,94.0,66,Viudo,47,2020,5,high,1.1599999999999997,-1,3,1166538,2652,0,18
103628,102139,1,Híbrida,4.47,4,Hombre,Portal Web,7,381081,88.0,84,Casado,43,2021,5,high,102154,Presencial,6.48,1,Hombre,Ferias & Networking,5,590000,90.0,67,Casado,25,2021,6,high,2.0100000000000007,-3,-2,208919,36,0,-18
102425,102134,1,Híbrida,3.15,2,Hombre,Linkedin,5,694026,84.0,78,Casado,51,2021,8,high,102135,Presencial,2.25,2,Hombre,Portal Web,5,1358450,90.0,69,Viudo,31,2012,7,high,-0.8999999999999999,0,0,664424,-3319,1,-20
100071,102088,1,Híbrida,2.07,2,Mujer,Referidos,3,220469,84.0,81,Casado,22,2017,6,high,102139,Presencial,4.96,1,Mujer,Portal Web,3,488000,82.0,65,Soltero,20,2018,4,high,2.89,-1,0,267531,295,0,-2
101207,102051,1,Híbrida,3.33,0,Mujer,Portal Web,1,207036,96.0,83,Casado,19,2013,11,high,102075,Híbrida,1.39,1,Hombre,Portal Web,11,1616000,83.0,76,Casado,46,2019,11,high,-1.9400000000000002,1,10,1408964,2181,0,27
101046,102086,1,Híbrida,3.985,0,Mujer,Portal Web,5,227009,85.0,79,Soltero,22,2016,7,high,102085,Presencial,2.22,2,Mujer,Linkedin,7,1306940,87.0,68,Divorciado,39,2021,3,high,-1.7649999999999997,2,2,1079931,1703,0,17
101304,102108,1,Híbrida,4.1,2,Mujer,Linkedin,4,247579,93.0,77,Divorciado,26,2018,10,high,102040,Presencial,2.92,1,Mujer,Portal Web,5,1616000,46.0,75,Casado,50,2023,5,low,-1.1799999999999997,-1,1,1368421,1692,0,24
100492,102071,1,Híbrida,3.73,11,Mujer,Portal Web,3,385425,91.0,76,Casado,31,2017,9,high,102171,Presencial,0.87,1,Hombre,Portal Web,11,1616000,85.0,72,Viudo,51,2023,11,high,-2.86,-10,8,1230575,2259,0,20
101352,102109,1,Híbrida,2.62,9,Mujer,Portal Web,9,387957,88.0,61,Soltero,32,2018,2,high,102123,Presencial,3.86,1,Mujer,Portal Web,5,998000,97.0,82,Casado,32,2019,9,high,1.2399999999999998,-8,-4,610043,599,0,0
100003,102138,1,Híbrida,4.0,2,Mujer,Linkedin,10,311884,92.0,88,Viudo,47,2021,9,high,102059,Presencial,3.26,1,Hombre,Linkedin,5,1616000,57.0,75,Soltero,44,2018,4,low,-0.7400000000000002,-1,-5,1304116,-1272,1,-3
101960,102060,1,Híbrida,1.72,0,Mujer,Ferias & Networking,13,657562,96.0,73,Divorciado,43,2014,9,high,102041,Presencial,4.42,3,Hombre,Referidos,16,1616000,82.0,62,Casado,45,2013,10,high,2.7,3,3,958438,-314,1,2
101210,102101,1,Híbrida,1.825,1,Mujer,Portal Web,7,696894,96.0,73,Soltero,47,2018,1,high,102089,Presencial,6.23,0,Hombre,Portal Web,26,1616000,92.0,68,Divorciado,55,2014,1,high,4.405,-1,19,919106,-1480,1,8
100405,102013,1,Híbrida,3.645,3,Mujer,Portal Web,13,699131,96.0,85,Casado,43,2012,5,high,102139,Presencial,2.0,2,Mujer,Linkedin,4,743000,96.0,79,Casado,30,2022,11,high,-1.645,-1,-9,43869,3827,0,-13
100057,102121,1,Híbrida,6.945,1,Hombre,Linkedin,8,721063,93.0,78,Casado,50,2019,8,high,102127,Híbrida,1.63,2,Hombre,Portal Web,4,1616000,90.0,77,Divorciado,44,2012,2,high,-5.315,1,-4,894937,-2734,1,-6
103369,102066,1,Híbrida,1.51,0,Mujer,Ferias & Networking,1,139917,94.0,65,Soltero,17,2016,10,high,102171,Presencial,3.62,3,Hombre,Referidos,5,1616000,97.0,84,Casado,55,2023,12,high,2.1100000000000003,3,4,1476083,2618,0,38
102587,102088,1,Híbrida,2.075,3,Mujer,Referidos,3,225041,91.0,81,Casado,22,2017,6,high,102139,Presencial,4.96,1,Mujer,Portal Web,3,488000,82.0,65,Soltero,20,2018,4,high,2.885,-2,0,262959,295,0,-2
103126,102051,1,Híbrida,3.34,1,Mujer,Portal Web,1,205118,88.0,83,Casado,19,2013,11,high,102075,Híbrida,1.39,1,Hombre,Portal Web,11,1616000,83.0,76,Casado,46,2019,11,high,-1.95,0,10,1410882,2179,0,27
102569,102009,1,Híbrida,4.475,4,Hombre,Portal Web,4,206775,83.0,75,Soltero,17,2012,2,high,102116,Presencial,2.06,2,Hombre,Referidos,9,1461470,90.0,73,Casado,44,2022,8,high,-2.4149999999999996,-2,5,1254695,3827,0,27
102854,102040,1,Híbrida,1.305,2,Hombre,Referidos,2,293269,91.0,78,Soltero,22,2012,9,high,102106,Presencial,3.21,1,Hombre,Linkedin,15,1616000,91.0,84,Soltero,45,2016,7,high,1.905,-1,13,1322731,1401,0,23
102434,102139,1,Híbrida,2.145,1,Hombre,Linkedin,4,332010,80.0,74,Soltero,34,2022,7,high,102154,Presencial,6.48,1,Hombre,Ferias & Networking,5,590000,90.0,67,Casado,25,2021,6,high,4.335000000000001,0,1,257990,-384,1,-9
103878,102041,1,Híbrida,1.935,7,Hombre,Portal Web,11,811916,83.0,73,Casado,33,2013,5,high,102147,Presencial,1.29,0,Mujer,Portal Web,8,1616000,44.0,73,Casado,51,2014,5,low,-0.645,-7,-3,804084,372,0,18
104053,102138,1,Híbrida,4.02,3,Mujer,Linkedin,10,304846,80.0,88,Viudo,47,2021,9,high,102059,Presencial,3.26,1,Hombre,Linkedin,5,1616000,57.0,75,Soltero,44,2018,4,low,-0.7599999999999998,-2,-5,1311154,-1269,1,-3
102765,102060,1,Híbrida,1.71,0,Mujer,Ferias & Networking,13,657156,90.0,73,Divorciado,43,2014,9,high,102041,Presencial,4.42,3,Hombre,Referidos,16,1616000,82.0,62,Casado,45,2013,10,high,2.71,3,3,958844,-313,1,2
102318,102075,1,Híbrida,1.785,0,Hombre,Linkedin,20,854695,91.0,82,Casado,52,2018,7,high,102047,Presencial,2.7,1,Hombre,Referidos,11,1255430,90.0,76,Casado,30,2013,3,high,0.9150000000000003,1,-9,400735,-1939,1,-22
100085,102137,1,Híbrida,2.84,2,Mujer,Referidos,3,119090,88.0,81,Soltero,21,2022,6,high,102046,Presencial,1.18,0,Mujer,Portal Web,2,845000,37.0,79,Casado,27,2017,12,low,-1.66,-2,-1,725910,-1631,1,6
100187,102070,1,Híbrida,3.92,5,Hombre,Referidos,4,205349,82.0,74,Soltero,20,2014,11,high,102035,Presencial,1.7,1,Mujer,Referidos,4,1616000,77.0,73,Viudo,38,2013,3,low,-2.2199999999999998,-4,0,1410651,-610,1,18
101013,102143,1,Híbrida,2.07,0,Mujer,Referidos,6,418984,91.0,74,Viudo,48,2023,3,high,102142,Presencial,1.07,2,Hombre,Portal Web,2,590000,90.0,78,Casado,25,2022,2,high,-0.9999999999999998,2,-4,171016,-399,1,-23
100638,102129,1,Híbrida,0.825,1,Mujer,Referidos,12,293562,93.0,72,Viudo,48,2023,1,high,102142,Presencial,2.1,2,Mujer,Linkedin,3,590000,41.0,74,Soltero,24,2020,1,low,1.2750000000000001,1,-9,296438,-1099,1,-24
101611,102137,1,Híbrida,3.88,1,Hombre,Linkedin,16,799729,82.0,73,Casado,51,2022,3,high,102046,Presencial,1.18,0,Mujer,Portal Web,2,845000,37.0,79,Casado,27,2017,12,low,-2.7,-1,-14,45271,-1533,1,-24
100655,102049,1,Híbrida,5.11,2,Mujer,Referidos,3,778780,87.0,66,Viudo,45,2015,8,high,102029,Presencial,6.89,0,Mujer,Portal Web,9,1616000,19.0,77,Divorciado,49,2023,3,low,1.7799999999999994,-2,6,837220,2762,0,4
102051,102075,2,Híbrida,1.39,1,Hombre,Portal Web,11,1616000,83.0,76,Casado,46,2019,11,high,102047,Presencial,2.7,1,Hombre,Referidos,11,1255430,90.0,76,Casado,30,2013,3,high,1.3100000000000003,0,0,-360570,-2422,1,-16
101357,102075,1,Híbrida,1.77,1,Hombre,Linkedin,20,861708,85.0,82,Casado,53,2018,7,high,102047,Presencial,2.7,1,Hombre,Referidos,11,1255430,90.0,76,Casado,30,2013,3,high,0.9300000000000002,0,-9,393722,-1941,1,-23
103095,102086,1,Híbrida,1.77,2,Hombre,Referidos,1,210974,87.0,73,Casado,21,2016,6,high,102085,Presencial,2.22,2,Mujer,Linkedin,7,1306940,87.0,68,Divorciado,39,2021,3,high,0.4500000000000002,0,6,1095966,1714,0,18
103277,102070,1,Híbrida,3.935,5,Hombre,Referidos,4,210510,95.0,74,Soltero,20,2014,11,high,102035,Presencial,1.7,1,Mujer,Referidos,4,1616000,77.0,73,Viudo,38,2013,3,low,-2.2350000000000003,-4,0,1405490,-613,1,18
103590,102108,1,Híbrida,4.13,1,Mujer,Linkedin,4,253079,93.0,77,Divorciado,26,2018,10,high,102040,Presencial,2.92,1,Mujer,Portal Web,5,1616000,46.0,75,Casado,50,2023,5,low,-1.21,0,1,1362921,1692,0,24
103029,102060,1,Híbrida,4.41,0,Mujer,Ferias & Networking,8,508151,87.0,76,Divorciado,35,2014,9,high,102041,Presencial,4.42,3,Hombre,Referidos,16,1616000,82.0,62,Casado,45,2013,10,high,0.009999999999999787,3,8,1107849,-327,1,10
103052,102120,1,Híbrida,7.59,2,Hombre,Ferias & Networking,8,426918,93.0,73,Soltero,44,2022,1,high,102171,Presencial,6.48,2,Hombre,Ferias & Networking,9,1616000,80.0,71,Casado,47,2023,8,high,-1.1099999999999994,0,1,1189082,577,0,3
102314,102104,1,Híbrida,1.655,3,Mujer,Linkedin,15,451250,91.0,81,Divorciado,45,2019,11,high,102129,Híbrida,6.72,1,Mujer,Portal Web,6,743000,91.0,61,Soltero,30,2023,4,high,5.0649999999999995,-2,-9,291750,1229,0,-15
102757,102049,1,Híbrida,5.105,3,Mujer,Referidos,3,776268,86.0,66,Viudo,45,2015,8,high,102029,Presencial,6.89,0,Mujer,Portal Web,9,1616000,19.0,77,Divorciado,49,2023,3,low,1.7849999999999993,-3,6,839732,2762,0,4
104085,102127,1,Híbrida,2.395,0,Hombre,Linkedin,11,721980,83.0,86,Divorciado,53,2021,7,high,102028,Presencial,4.03,2,Mujer,Linkedin,9,1306940,88.0,78,Divorciado,32,2014,5,high,1.6350000000000002,2,-2,584960,-2613,1,-21
101276,102017,1,Híbrida,1.705,3,Mujer,Portal Web,1,188783,94.0,68,Soltero,14,2012,2,high,102035,Presencial,4.62,0,Mujer,Linkedin,2,641000,90.0,84,Casado,25,2019,11,high,2.915,-3,1,452217,2832,0,11
100503,102111,1,Híbrida,1.81,2,Hombre,Ferias & Networking,7,826997,84.0,74,Casado,36,2019,12,high,102097,Híbrida,2.04,1,Mujer,Referidos,15,1616000,94.0,67,Soltero,50,2021,5,high,0.22999999999999998,-1,8,789003,519,0,14
101724,102048,1,Híbrida,0.9,1,Mujer,Linkedin,9,831923,87.0,81,Soltero,36,2015,7,high,102092,Presencial,3.99,0,Mujer,Portal Web,5,590000,59.0,76,Soltero,20,2015,8,low,3.0900000000000003,-1,-4,-241923,26,0,-16
100092,102060,1,Híbrida,4.43,1,Mujer,Ferias & Networking,8,511100,85.0,76,Divorciado,35,2014,9,high,102041,Presencial,4.42,3,Hombre,Referidos,16,1616000,82.0,62,Casado,45,2013,10,high,-0.009999999999999787,2,8,1104900,-324,1,10
100784,102128,1,Híbrida,2.935,3,Mujer,Referidos,14,678378,92.0,78,Divorciado,50,2021,1,high,102056,Presencial,4.11,10,Mujer,Portal Web,16,1616000,46.0,72,Soltero,55,2021,2,low,1.1750000000000003,7,2,937622,25,0,5
100330,102101,1,Híbrida,4.01,9,Hombre,Linkedin,11,674546,92.0,76,Soltero,50,2020,9,high,102089,Presencial,6.23,0,Hombre,Portal Web,26,1616000,92.0,68,Divorciado,55,2014,1,high,2.2200000000000006,-9,15,941454,-2458,1,5
101863,102086,1,Híbrida,2.24,1,Hombre,Portal Web,8,677435,80.0,76,Soltero,47,2018,7,high,102085,Presencial,2.22,2,Mujer,Linkedin,7,1306940,87.0,68,Divorciado,39,2021,3,high,-0.020000000000000018,1,-1,629505,967,0,-8
101197,102045,1,Híbrida,2.51,1,Hombre,Linkedin,6,675829,80.0,76,Divorciado,44,2015,6,high,102171,Presencial,3.19,3,Hombre,Portal Web,11,1616000,97.0,65,Casado,53,2023,9,high,0.6800000000000002,2,5,940171,3021,0,9
100448,102131,1,Híbrida,6.78,2,Hombre,Ferias & Networking,6,875123,91.0,76,Casado,51,2021,3,high,102109,Presencial,5.54,0,Hombre,Linkedin,3,998000,39.0,77,Soltero,34,2021,12,low,-1.2400000000000002,-2,-3,122877,288,0,-17
100501,102107,1,Híbrida,3.53,6,Mujer,Portal Web,10,717483,87.0,73,Divorciado,49,2017,10,high,102069,Presencial,2.4,1,Mujer,Linkedin,8,1616000,47.0,79,Casado,63,2023,6,low,-1.13,-5,-2,898517,2076,0,14
103545,102064,1,Híbrida,4.94,9,Hombre,Portal Web,1,186861,93.0,66,Soltero,18,2015,8,high,102067,Presencial,1.34,0,Hombre,Portal Web,6,1616000,92.0,92,Casado,43,2018,2,high,-3.6000000000000005,-9,5,1429139,914,0,25
103113,102036,1,Híbrida,1.4,8,Hombre,Portal Web,14,656915,83.0,73,Divorciado,40,2012,11,high,102054,Presencial,1.68,8,Hombre,Portal Web,5,1616000,92.0,76,Viudo,54,2022,1,high,0.28,0,-9,959085,3356,0,14
102845,102128,1,Híbrida,2.92,2,Mujer,Referidos,14,675600,86.0,78,Divorciado,50,2021,1,high,102056,Presencial,4.11,10,Mujer,Portal Web,16,1616000,46.0,72,Soltero,55,2021,2,low,1.1900000000000004,8,2,940400,26,0,5
103034,102101,1,Híbrida,4.01,8,Hombre,Linkedin,11,673844,96.0,76,Soltero,50,2020,9,high,102089,Presencial,6.23,0,Hombre,Portal Web,26,1616000,92.0,68,Divorciado,55,2014,1,high,2.2200000000000006,-8,15,942156,-2458,1,5
102229,102126,1,Híbrida,3.065,1,Mujer,Referidos,2,200896,94.0,83,Casado,23,2019,5,high,102141,Presencial,2.5,1,Mujer,Referidos,2,1049000,94.0,79,Casado,34,2021,1,high,-0.565,0,0,848104,613,0,11
102985,102111,1,Híbrida,1.805,2,Hombre,Ferias & Networking,7,826324,80.0,74,Casado,36,2019,12,high,102097,Híbrida,2.04,1,Mujer,Referidos,15,1616000,94.0,67,Soltero,50,2021,5,high,0.2350000000000001,-1,8,789676,520,0,14
103119,102149,1,Híbrida,7.495,3,Hombre,Ferias & Networking,13,268966,83.0,81,Soltero,44,2022,6,high,102141,Presencial,2.07,0,Mujer,Headhunter,3,1409960,90.0,86,Casado,37,2017,2,high,-5.425000000000001,-3,-10,1140994,-1944,1,-7
103801,102086,1,Híbrida,2.21,0,Hombre,Portal Web,8,680824,85.0,76,Soltero,47,2018,7,high,102085,Presencial,2.22,2,Mujer,Linkedin,7,1306940,87.0,68,Divorciado,39,2021,3,high,0.010000000000000231,2,-1,626116,966,0,-8
100351,102074,1,Híbrida,1.775,1,Mujer,Portal Web,2,331232,87.0,71,Soltero,29,2017,3,high,102028,Presencial,1.35,0,Hombre,Ferias & Networking,4,1616000,80.0,83,Viudo,43,2015,12,high,-0.4249999999999998,-1,2,1284768,-439,1,14
101010,102150,1,Híbrida,1.4,10,Mujer,Portal Web,4,278933,94.0,74,Divorciado,46,2022,8,high,102085,Presencial,3.9,8,Mujer,Portal Web,10,1358450,85.0,75,Casado,32,2012,12,high,2.5,-2,6,1079517,-3516,1,-14
100197,102075,1,Híbrida,0.825,3,Mujer,Portal Web,4,274104,81.0,81,Soltero,40,2016,10,high,102047,Presencial,2.7,1,Hombre,Referidos,11,1255430,90.0,76,Casado,30,2013,3,high,1.8750000000000002,-2,7,981326,-1310,1,-10
102772,102010,1,Híbrida,1.69,2,Mujer,Linkedin,3,205758,95.0,74,Soltero,17,2012,1,high,102035,Presencial,2.02,0,Mujer,Linkedin,5,1564490,77.0,73,Casado,44,2021,8,low,0.33000000000000007,-2,2,1358732,3487,0,27
102401,102152,1,Híbrida,2.955,3,Hombre,Portal Web,7,328883,87.0,77,Casado,33,2021,8,high,102089,Presencial,2.75,5,Hombre,Portal Web,7,1616000,15.0,68,Soltero,47,2019,8,low,-0.20500000000000007,2,0,1287117,-730,1,14
103267,102115,1,Híbrida,1.235,3,Hombre,Referidos,6,386663,81.0,73,Soltero,33,2019,12,high,102116,Presencial,2.0,2,Mujer,Portal Web,4,1616000,94.0,76,Soltero,35,2018,12,high,0.7649999999999999,-1,-2,1229337,-361,1,2
103704,102150,1,Híbrida,1.42,11,Mujer,Portal Web,4,281904,98.0,74,Divorciado,46,2022,8,high,102085,Presencial,3.9,8,Mujer,Portal Web,10,1358450,85.0,75,Casado,32,2012,12,high,2.48,-3,6,1076546,-3517,1,-14
101315,102056,1,Híbrida,1.71,0,Hombre,Ferias & Networking,3,141647,82.0,81,Soltero,17,2016,2,high,102014,Presencial,5.24,1,Hombre,Ferias & Networking,16,1616000,70.0,63,Viudo,65,2023,3,low,3.5300000000000002,1,13,1474353,2584,0,48
100050,102032,1,Híbrida,4.445,5,Mujer,Portal Web,5,250902,85.0,74,Soltero,19,2012,4,high,102065,Presencial,1.78,7,Hombre,Portal Web,14,1616000,42.0,71,Casado,42,2015,11,low,-2.665,2,9,1365098,1300,0,23
101448,102152,1,Híbrida,2.96,3,Hombre,Portal Web,7,327880,82.0,77,Casado,33,2021,9,high,102089,Presencial,2.75,5,Hombre,Portal Web,7,1616000,15.0,68,Soltero,47,2019,8,low,-0.20999999999999996,2,0,1288120,-733,1,14
101958,102033,1,Híbrida,2.075,1,Mujer,Portal Web,2,333217,92.0,76,Soltero,25,2013,12,high,102172,Presencial,6.25,2,Mujer,Portal Web,16,1616000,90.0,79,Divorciado,39,2014,5,high,4.175,1,14,1282783,159,0,14
101385,102115,1,Híbrida,1.24,2,Hombre,Referidos,6,385398,97.0,73,Divorciado,34,2019,12,high,102116,Presencial,2.0,2,Mujer,Portal Web,4,1616000,94.0,76,Soltero,35,2018,12,high,0.76,0,-2,1230602,-358,1,1
101201,102074,1,Híbrida,4.09,5,Hombre,Portal Web,5,444837,94.0,73,Casado,34,2017,10,high,102028,Presencial,1.35,0,Hombre,Ferias & Networking,4,1616000,80.0,83,Viudo,43,2015,12,high,-2.7399999999999998,-5,-1,1171163,-651,1,9
100308,102171,1,Híbrida,6.04,1,Mujer,Linkedin,3,850829,90.0,74,Casado,41,2023,2,high,102088,Presencial,2.57,4,Hombre,Linkedin,8,1616000,80.0,69,Casado,43,2017,10,high,-3.47,3,5,765171,-1966,1,2
100265,102144,1,Híbrida,1.53,1,Hombre,Linkedin,8,411141,83.0,73,Divorciado,46,2021,6,high,102156,Presencial,2.13,8,Mujer,Portal Web,11,1616000,5.0,82,Viudo,58,2015,6,low,0.5999999999999999,7,3,1204859,-2188,1,12
101354,102172,1,Híbrida,4.42,4,Hombre,Portal Web,4,660407,82.0,71,Divorciado,51,2022,8,high,102020,Presencial,5.58,1,Hombre,Portal Web,7,1049000,57.0,70,Casado,29,2016,4,low,1.1600000000000001,-3,3,388593,-2317,1,-22
101997,102034,1,Híbrida,1.6,9,Hombre,Portal Web,10,834719,88.0,81,Viudo,45,2012,5,high,102113,Presencial,7.84,7,Hombre,Linkedin,5,1564490,90.0,70,Casado,35,2012,9,high,6.24,-2,-5,729771,117,0,-10
102111,102097,2,Híbrida,2.04,1,Mujer,Referidos,15,1616000,94.0,67,Soltero,50,2021,5,high,102024,Presencial,1.95,6,Hombre,Portal Web,4,1100900,57.0,77,Soltero,31,2016,10,low,-0.09000000000000008,5,-11,-515100,-1664,1,-19
101081,102097,1,Híbrida,1.16,3,Hombre,Portal Web,15,893169,85.0,71,Casado,50,2016,12,high,102024,Presencial,1.95,6,Hombre,Portal Web,4,1100900,57.0,77,Soltero,31,2016,10,low,0.79,3,-11,207731,-42,1,-19
102789,102070,1,Híbrida,3.52,1,Hombre,Ferias & Networking,3,347780,98.0,74,Casado,27,2015,5,high,102035,Presencial,1.7,1,Mujer,Referidos,4,1616000,77.0,73,Viudo,38,2013,3,low,-1.82,0,1,1268220,-783,1,11
102891,102068,1,Híbrida,1.73,1,Hombre,Portal Web,3,392561,98.0,80,Casado,29,2015,3,high,102043,Híbrida,2.17,3,Mujer,Referidos,4,896000,41.0,81,Soltero,23,2012,8,low,0.43999999999999995,2,1,503439,-932,1,-6
102671,102020,1,Híbrida,0.92,1,Mujer,Linkedin,4,444684,97.0,78,Soltero,31,2013,9,high,102134,Presencial,6.63,1,Mujer,Linkedin,11,1203920,90.0,78,Casado,35,2018,12,high,5.71,0,7,759236,1912,0,4
103376,102171,1,Híbrida,6.02,1,Mujer,Linkedin,3,844805,81.0,74,Casado,41,2023,2,high,102088,Presencial,2.57,4,Hombre,Linkedin,8,1616000,80.0,69,Casado,43,2017,10,high,-3.4499999999999997,3,5,771195,-1966,1,2
102971,102048,1,Híbrida,2.725,3,Hombre,Portal Web,5,270783,92.0,80,Casado,37,2014,9,high,102092,Presencial,3.99,0,Mujer,Portal Web,5,590000,59.0,76,Soltero,20,2015,8,low,1.2650000000000001,-3,0,319217,346,0,-17
103439,102109,1,Híbrida,5.14,2,Hombre,Portal Web,7,439139,92.0,88,Casado,45,2020,10,high,102123,Presencial,3.86,1,Mujer,Portal Web,5,998000,97.0,82,Casado,32,2019,9,high,-1.2799999999999998,-1,-2,558861,-396,1,-13
103580,102144,1,Híbrida,1.565,1,Hombre,Portal Web,8,406193,95.0,73,Divorciado,46,2021,6,high,102156,Presencial,2.13,8,Mujer,Portal Web,11,1616000,5.0,82,Viudo,58,2015,6,low,0.565,7,3,1209807,-2188,1,12
102320,102097,1,Híbrida,1.21,3,Hombre,Portal Web,15,893179,85.0,71,Casado,50,2016,12,high,102024,Presencial,1.95,6,Hombre,Portal Web,4,1100900,57.0,77,Soltero,31,2016,10,low,0.74,3,-11,207721,-44,1,-19
103834,102093,1,Híbrida,2.28,4,Mujer,Portal Web,24,916784,85.0,79,Viudo,58,2018,12,high,102139,Presencial,5.41,0,Mujer,Ferias & Networking,4,488000,89.0,62,Soltero,23,2021,6,high,3.1300000000000003,-4,-20,-428784,921,0,-35
101874,102054,1,Híbrida,4.435,2,Hombre,Linkedin,1,144710,89.0,83,Soltero,15,2014,2,high,102044,Presencial,2.91,1,Hombre,Linkedin,17,1616000,85.0,74,Divorciado,41,2012,11,high,-1.5249999999999995,-1,16,1471290,-475,1,26
101565,102097,1,Híbrida,2.09,2,Hombre,Referidos,4,333566,98.0,74,Casado,30,2018,10,high,102024,Presencial,1.95,6,Hombre,Portal Web,4,1100900,57.0,77,Soltero,31,2016,10,low,-0.1399999999999999,4,0,767334,-710,1,1
100270,102098,1,Híbrida,2.37,1,Mujer,Portal Web,7,526330,94.0,66,Casado,41,2020,5,high,102049,Presencial,1.8,1,Mujer,Portal Web,16,1616000,90.0,86,Casado,46,2021,1,high,-0.5700000000000001,0,9,1089670,264,0,5
100474,102109,1,Híbrida,5.145,1,Hombre,Portal Web,7,437552,91.0,88,Casado,45,2020,10,high,102123,Presencial,3.86,1,Mujer,Portal Web,5,998000,97.0,82,Casado,32,2019,9,high,-1.2849999999999997,0,-2,560448,-397,1,-13
100210,102011,1,Híbrida,5.33,0,Hombre,Linkedin,13,285285,85.0,66,Casado,37,2012,9,high,102048,Presencial,5.37,1,Hombre,Ferias & Networking,7,845000,52.0,74,Casado,22,2012,11,low,0.040000000000000036,1,-6,559715,80,0,-15
100278,102063,1,Híbrida,2.135,3,Hombre,Ferias & Networking,9,461495,91.0,73,Viudo,41,2016,4,high,102135,Presencial,2.73,0,Mujer,Linkedin,1,539000,26.0,75,Soltero,24,2021,4,low,0.5950000000000002,-3,-8,77505,1820,0,-17
100515,102153,1,Híbrida,3.445,1,Mujer,Ferias & Networking,5,310264,92.0,74,Soltero,49,2023,4,high,102143,Presencial,6.39,1,Mujer,Linkedin,5,1616000,90.0,68,Casado,41,2019,6,high,2.945,0,0,1305736,-1399,1,-8
103879,102032,1,Híbrida,4.435,5,Mujer,Portal Web,5,248635,83.0,74,Soltero,19,2012,4,high,102065,Presencial,1.78,7,Hombre,Portal Web,14,1616000,42.0,71,Casado,42,2015,11,low,-2.6549999999999994,2,9,1367365,1300,0,23
103010,102033,1,Híbrida,2.115,2,Mujer,Portal Web,2,327485,89.0,76,Soltero,25,2013,12,high,102172,Presencial,6.25,2,Mujer,Portal Web,16,1616000,90.0,79,Divorciado,39,2014,5,high,4.135,0,14,1288515,157,0,14
102390,102046,1,Híbrida,4.94,1,Mujer,Linkedin,8,350174,85.0,75,Casado,24,2012,9,high,102007,Presencial,1.68,0,Mujer,Portal Web,8,1616000,41.0,71,Soltero,50,2015,10,low,-3.2600000000000007,-1,0,1265826,1123,0,26
102786,102098,1,Híbrida,2.335,2,Mujer,Portal Web,7,530829,82.0,66,Casado,41,2020,5,high,102049,Presencial,1.8,1,Mujer,Portal Web,16,1616000,90.0,86,Casado,46,2021,1,high,-0.5349999999999999,-1,9,1085171,263,0,5
104029,102109,1,Híbrida,1.905,3,Hombre,Portal Web,9,658553,81.0,76,Soltero,49,2021,3,high,102123,Presencial,3.86,1,Mujer,Portal Web,5,998000,97.0,82,Casado,32,2019,9,high,1.9549999999999998,-2,-4,339447,-521,1,-17
101568,102023,1,Híbrida,3.15,0,Mujer,Ferias & Networking,2,78711,81.0,86,Soltero,9,2012,3,high,102105,Híbrida,4.9,1,Hombre,Portal Web,4,539000,80.0,65,Casado,23,2019,12,high,1.7500000000000004,1,2,460289,2830,0,14
101242,102095,1,Híbrida,1.73,2,Mujer,Referidos,1,141950,83.0,65,Soltero,19,2018,7,high,102171,Presencial,3.28,2,Mujer,Portal Web,3,1616000,80.0,75,Soltero,42,2023,10,high,1.5499999999999998,0,2,1474050,1910,0,23
101370,102141,1,Híbrida,6.64,1,Hombre,Portal Web,7,309009,87.0,77,Casado,33,2022,12,high,102134,Presencial,1.88,1,Mujer,Linkedin,3,1100900,64.0,69,Soltero,32,2018,5,low,-4.76,0,-4,791891,-1664,1,-1
102125,102096,2,Híbrida,4.0,2,Mujer,Referidos,5,692000,87.0,82,Casado,29,2022,7,high,102116,Presencial,5.11,8,Mujer,Linkedin,13,1461470,90.0,74,Soltero,42,2021,5,high,1.1100000000000003,6,8,769470,-439,1,13
100933,102096,1,Híbrida,2.045,1,Mujer,Referidos,3,349694,97.0,86,Soltero,29,2017,7,high,102116,Presencial,5.11,8,Mujer,Linkedin,13,1461470,90.0,74,Soltero,42,2021,5,high,3.0650000000000004,7,10,1111776,1406,0,13
100221,102043,1,Híbrida,3.39,2,Hombre,Portal Web,5,532714,80.0,74,Soltero,34,2013,6,high,102051,Presencial,1.03,0,Hombre,Portal Web,5,1616000,60.0,76,Casado,44,2019,5,low,-2.3600000000000003,-2,0,1083286,2165,0,10
101832,102141,1,Híbrida,2.185,2,Hombre,Portal Web,8,638209,89.0,76,Casado,47,2020,8,high,102134,Presencial,1.88,1,Mujer,Linkedin,3,1100900,64.0,69,Soltero,32,2018,5,low,-0.30500000000000016,-1,-5,462691,-811,1,-15
102430,102054,1,Híbrida,4.43,2,Hombre,Linkedin,1,146279,96.0,83,Soltero,15,2014,2,high,102044,Presencial,2.91,1,Hombre,Linkedin,17,1616000,85.0,74,Divorciado,41,2012,11,high,-1.5199999999999996,-1,16,1469721,-475,1,26
103322,102123,1,Híbrida,1.715,2,Mujer,Referidos,2,310183,90.0,72,Soltero,29,2019,6,high,102043,Presencial,5.5,1,Mujer,Linkedin,16,1616000,42.0,66,Soltero,51,2021,9,low,3.785,-1,14,1305817,831,0,22
103885,102120,1,Híbrida,2.14,0,Mujer,Portal Web,3,297287,97.0,73,Casado,46,2021,3,high,102171,Presencial,6.48,2,Hombre,Ferias & Networking,9,1616000,80.0,71,Casado,47,2023,8,high,4.34,2,6,1318713,875,0,1
102455,102011,1,Híbrida,5.37,0,Hombre,Linkedin,13,291614,93.0,66,Casado,36,2012,9,high,102048,Presencial,5.37,1,Hombre,Ferias & Networking,7,845000,52.0,74,Casado,22,2012,11,low,0.0,1,-6,553386,80,0,-14
102361,102133,1,Híbrida,4.705,4,Hombre,Portal Web,10,298751,98.0,77,Casado,46,2021,8,high,102151,Híbrida,2.61,2,Hombre,Linkedin,4,1255430,98.0,65,Soltero,35,2018,2,high,-2.095,-2,-6,956679,-1259,1,-11
103841,102101,1,Híbrida,3.485,10,Mujer,Linkedin,8,441593,93.0,70,Casado,46,2020,5,high,102089,Presencial,6.23,0,Hombre,Portal Web,26,1616000,92.0,68,Divorciado,55,2014,1,high,2.7450000000000006,-10,18,1174407,-2327,1,9
103817,102141,1,Híbrida,2.21,2,Hombre,Portal Web,8,635973,95.0,76,Casado,47,2020,8,high,102134,Presencial,1.88,1,Mujer,Linkedin,3,1100900,64.0,69,Soltero,32,2018,5,low,-0.33000000000000007,-1,-5,464927,-811,1,-15
101791,102122,1,Híbrida,2.08,1,Hombre,Portal Web,3,168591,86.0,67,Casado,23,2021,4,high,102075,Presencial,1.83,4,Hombre,Portal Web,6,1616000,90.0,66,Viudo,48,2019,3,high,-0.25,3,3,1447409,-742,1,25
101350,102151,1,Híbrida,4.42,1,Hombre,Linkedin,3,269439,96.0,67,Casado,30,2022,4,high,102105,Presencial,1.51,2,Hombre,Ferias & Networking,10,1616000,85.0,80,Divorciado,45,2021,11,high,-2.91,1,7,1346561,-144,1,15
100498,102126,1,Híbrida,3.465,2,Mujer,Ferias & Networking,3,405488,95.0,78,Soltero,37,2022,2,high,102141,Presencial,2.5,1,Mujer,Referidos,2,1049000,94.0,79,Casado,34,2021,1,high,-0.9649999999999999,-1,-1,643512,-402,1,-3
100216,102145,1,Híbrida,0.92,3,Hombre,Ferias & Networking,4,845837,88.0,74,Soltero,40,2021,10,high,102116,Presencial,1.43,1,Mujer,Portal Web,3,692000,89.0,73,Viudo,23,2016,12,high,0.5099999999999999,-2,-1,-153837,-1785,1,-17
101613,102116,1,Híbrida,1.22,3,Hombre,Portal Web,10,466536,93.0,79,Casado,37,2019,9,high,102021,Presencial,2.32,0,Mujer,Portal Web,22,1616000,94.0,76,Casado,59,2020,7,high,1.0999999999999999,-3,12,1149464,311,0,22
100760,102154,1,Híbrida,2.545,2,Hombre,Linkedin,12,376202,80.0,74,Soltero,46,2021,9,high,102172,Presencial,5.45,1,Hombre,Portal Web,7,1512980,93.0,69,Soltero,39,2017,10,high,2.9050000000000002,-1,-5,1136778,-1441,1,-7
101287,102133,1,Híbrida,4.68,4,Hombre,Portal Web,10,294642,98.0,77,Casado,46,2021,8,high,102151,Híbrida,2.61,2,Hombre,Linkedin,4,1255430,98.0,65,Soltero,35,2018,2,high,-2.07,-2,-6,960788,-1259,1,-11
100766,102143,1,Híbrida,3.765,2,Hombre,Portal Web,3,426959,98.0,73,Casado,46,2020,11,high,102142,Presencial,1.07,2,Hombre,Portal Web,2,590000,90.0,78,Casado,25,2022,2,high,-2.6950000000000003,0,-1,163041,454,0,-21
100758,102101,1,Híbrida,3.51,10,Mujer,Linkedin,8,441166,81.0,70,Casado,46,2020,5,high,102089,Presencial,6.23,0,Hombre,Portal Web,26,1616000,92.0,68,Divorciado,55,2014,1,high,2.7200000000000006,-10,18,1174834,-2327,1,9
101407,102133,1,Híbrida,3.645,2,Hombre,Referidos,3,714494,95.0,83,Viudo,53,2022,10,high,102151,Híbrida,2.61,2,Hombre,Linkedin,4,1255430,98.0,65,Soltero,35,2018,2,high,-1.0350000000000001,0,1,540936,-1699,1,-18
103482,102095,1,Híbrida,1.74,3,Mujer,Referidos,1,138657,91.0,65,Soltero,19,2018,7,high,102171,Presencial,3.28,2,Mujer,Portal Web,3,1616000,80.0,75,Soltero,42,2023,10,high,1.5399999999999998,-1,2,1477343,1911,0,23
102722,102151,1,Híbrida,4.39,2,Hombre,Linkedin,3,264985,87.0,67,Casado,30,2022,4,high,102105,Presencial,1.51,2,Hombre,Ferias & Networking,10,1616000,85.0,80,Divorciado,45,2021,11,high,-2.88,0,7,1351015,-145,1,15
102614,102137,1,Híbrida,1.845,2,Mujer,Referidos,5,268174,93.0,65,Viudo,30,2022,3,high,102046,Presencial,1.18,0,Mujer,Portal Web,2,845000,37.0,79,Casado,27,2017,12,low,-0.665,-2,-3,576826,-1546,1,-3
103265,102121,1,Híbrida,2.85,2,Mujer,Linkedin,5,292015,90.0,80,Casado,31,2021,12,high,102127,Híbrida,1.63,2,Hombre,Portal Web,4,1616000,90.0,77,Divorciado,44,2012,2,high,-1.2200000000000002,0,-1,1323985,-3581,1,13
103410,102077,1,Híbrida,5.535,2,Mujer,Linkedin,4,346511,97.0,82,Casado,30,2017,3,high,102146,Presencial,2.27,0,Hombre,Ferias & Networking,11,1306940,31.0,64,Soltero,39,2021,6,low,-3.265,-2,7,960429,1563,0,9
103188,102102,1,Híbrida,2.61,8,Hombre,Linkedin,6,366942,87.0,73,Soltero,33,2020,3,high,102018,Presencial,2.48,0,Hombre,Portal Web,5,1616000,92.0,63,Viudo,49,2019,4,high,-0.1299999999999999,-8,-1,1249058,-344,1,16
102853,102126,1,Híbrida,3.445,1,Mujer,Ferias & Networking,3,407539,90.0,78,Soltero,37,2022,2,high,102141,Presencial,2.5,1,Mujer,Referidos,2,1049000,94.0,79,Casado,34,2021,1,high,-0.9449999999999998,0,-1,641461,-401,1,-3
103455,102057,1,Híbrida,5.5,2,Mujer,Referidos,7,827504,84.0,67,Soltero,30,2014,2,high,102019,Presencial,1.97,4,Hombre,Portal Web,5,1616000,90.0,73,Viudo,59,2022,12,high,-3.5300000000000002,2,-2,788496,3237,0,29
103872,102145,1,Híbrida,0.895,2,Hombre,Ferias & Networking,4,845200,87.0,74,Soltero,40,2021,10,high,102116,Presencial,1.43,1,Mujer,Portal Web,3,692000,89.0,73,Viudo,23,2016,12,high,0.5349999999999999,-1,-1,-153200,-1786,1,-17
102916,102116,1,Híbrida,1.215,2,Hombre,Referidos,10,473086,96.0,79,Casado,37,2019,9,high,102021,Presencial,2.32,0,Mujer,Portal Web,22,1616000,94.0,76,Casado,59,2020,7,high,1.1049999999999998,-2,12,1142914,312,0,22
101711,102112,1,Híbrida,1.66,3,Hombre,Ferias & Networking,5,266059,95.0,69,Casado,29,2021,3,high,102031,Presencial,2.27,7,Hombre,Linkedin,1,692000,83.0,74,Soltero,26,2020,6,high,0.6100000000000001,4,-4,425941,-271,1,-3
101003,102098,1,Híbrida,1.93,2,Mujer,Referidos,2,367604,87.0,74,Soltero,30,2017,5,high,102049,Presencial,1.8,1,Mujer,Portal Web,16,1616000,90.0,86,Casado,46,2021,1,high,-0.1299999999999999,-1,14,1248396,1370,0,16
101716,102045,1,Híbrida,6.925,1,Hombre,Ferias & Networking,7,413062,86.0,79,Casado,29,2014,5,high,102171,Presencial,3.19,3,Hombre,Portal Web,11,1616000,97.0,65,Casado,53,2023,9,high,-3.735,2,4,1202938,3412,0,24
101118,102061,1,Híbrida,5.47,1,Mujer,Portal Web,7,269541,93.0,76,Soltero,39,2017,5,high,102115,Presencial,2.14,2,Hombre,Ferias & Networking,10,1203920,37.0,80,Casado,29,2012,11,low,-3.3299999999999996,1,3,934379,-1634,1,-10
102498,102122,1,Híbrida,2.1,1,Hombre,Portal Web,3,163767,92.0,67,Casado,23,2021,4,high,102075,Presencial,1.83,4,Hombre,Portal Web,6,1616000,90.0,66,Viudo,48,2019,3,high,-0.27,3,3,1452233,-745,1,25
103432,102159,1,Híbrida,2.19,0,Mujer,Portal Web,6,229565,80.0,73,Divorciado,29,2022,6,high,102120,Híbrida,0.98,2,Hombre,Referidos,14,808000,90.0,86,Soltero,44,2022,8,high,-1.21,2,8,578435,61,0,15
102609,102112,1,Híbrida,1.705,2,Hombre,Ferias & Networking,5,265508,82.0,69,Casado,29,2021,3,high,102031,Presencial,2.27,7,Hombre,Linkedin,1,692000,83.0,74,Soltero,26,2020,6,high,0.565,5,-4,426492,-270,1,-3
102266,102034,1,Híbrida,3.05,1,Hombre,Portal Web,4,302401,83.0,84,Casado,40,2015,2,high,102113,Presencial,7.84,7,Hombre,Linkedin,5,1564490,90.0,70,Casado,35,2012,9,high,4.79,6,1,1262089,-872,1,-5
102521,102065,1,Híbrida,3.355,2,Hombre,Linkedin,7,659453,95.0,73,Divorciado,44,2016,2,high,102026,Presencial,2.44,2,Hombre,Ferias & Networking,13,1616000,45.0,60,Divorciado,35,2014,10,low,-0.915,0,6,956547,-506,1,-9
100521,102109,1,Híbrida,1.97,2,Hombre,Portal Web,2,123199,97.0,64,Soltero,18,2018,7,high,102123,Presencial,3.86,1,Mujer,Portal Web,5,998000,97.0,82,Casado,32,2019,9,high,1.89,-1,3,874801,446,0,14
100748,102149,1,Híbrida,5.985,0,Hombre,Ferias & Networking,12,795452,93.0,81,Casado,49,2021,6,high,102141,Presencial,2.07,0,Mujer,Headhunter,3,1409960,90.0,86,Casado,37,2017,2,high,-3.9150000000000005,0,-9,614508,-1565,1,-12
104001,102106,1,Híbrida,1.44,3,Hombre,Portal Web,4,280861,83.0,73,Soltero,43,2019,10,high,102081,Presencial,1.39,1,Mujer,Ferias & Networking,5,1049000,86.0,86,Soltero,32,2019,6,high,-0.050000000000000044,-2,1,768139,-125,1,-11
103266,102082,1,Híbrida,3.555,2,Hombre,Linkedin,5,289296,97.0,80,Viudo,40,2015,12,high,102050,Presencial,5.5,2,Mujer,Linkedin,7,1616000,81.0,70,Casado,36,2018,8,high,1.9449999999999998,0,2,1326704,965,0,-4
101681,102037,1,Híbrida,1.68,2,Hombre,Portal Web,1,118639,97.0,67,Soltero,11,2012,7,high,102057,Presencial,1.12,1,Mujer,Linkedin,2,641000,50.0,76,Casado,21,2016,12,low,-0.5599999999999998,-1,1,522361,1613,0,10
103686,102037,1,Híbrida,1.7,2,Hombre,Portal Web,1,115638,98.0,67,Soltero,11,2012,7,high,102057,Presencial,1.12,1,Mujer,Linkedin,2,641000,50.0,76,Casado,21,2016,12,low,-0.5799999999999998,-1,1,525362,1613,0,10
100058,102113,1,Híbrida,2.79,1,Hombre,Linkedin,6,366459,89.0,73,Casado,32,2018,9,high,102041,Presencial,2.96,2,Hombre,Portal Web,6,1152410,46.0,75,Casado,27,2012,1,low,0.16999999999999993,1,0,785951,-2449,1,-5
101741,102063,1,Híbrida,2.64,10,Hombre,Linkedin,4,268991,89.0,77,Soltero,24,2015,6,high,102135,Presencial,2.73,0,Mujer,Linkedin,1,539000,26.0,75,Soltero,24,2021,4,low,0.08999999999999986,-10,-3,270009,2122,0,0
102105,102113,2,Híbrida,2.07,0,Hombre,Linkedin,8,1616000,85.0,71,Viudo,45,2017,3,high,102041,Presencial,2.96,2,Hombre,Portal Web,6,1152410,46.0,75,Casado,27,2012,1,low,0.8900000000000001,2,-2,-463590,-1896,1,-18
101005,102113,1,Híbrida,1.53,7,Mujer,Portal Web,15,921943,94.0,72,Viudo,57,2020,11,high,102041,Presencial,2.96,2,Hombre,Portal Web,6,1152410,46.0,75,Casado,27,2012,1,low,1.43,-5,-9,230467,-3227,1,-30
104168,102063,1,Híbrida,2.625,10,Hombre,Linkedin,4,272969,89.0,77,Soltero,24,2015,6,high,102135,Presencial,2.73,0,Mujer,Linkedin,1,539000,26.0,75,Soltero,24,2021,4,low,0.10499999999999998,-10,-3,266031,2123,0,0
103468,102044,1,Híbrida,1.32,2,Mujer,Referidos,6,325139,80.0,80,Soltero,25,2013,12,high,102155,Presencial,1.54,1,Hombre,Ferias & Networking,14,1616000,56.0,68,Soltero,47,2023,3,low,0.21999999999999997,-1,8,1290861,3384,0,22
103080,102049,1,Híbrida,2.14,2,Hombre,Portal Web,5,308042,81.0,73,Casado,40,2013,7,high,102029,Presencial,6.89,0,Mujer,Portal Web,9,1616000,19.0,77,Divorciado,49,2023,3,low,4.75,-2,4,1307958,3547,0,9
103764,102113,1,Híbrida,1.535,8,Mujer,Portal Web,15,913615,95.0,72,Viudo,56,2020,11,high,102041,Presencial,2.96,2,Hombre,Portal Web,6,1152410,46.0,75,Casado,27,2012,1,low,1.425,-6,-9,238795,-3229,1,-29
101383,102149,1,Híbrida,0.995,0,Mujer,Portal Web,3,190242,92.0,74,Soltero,27,2023,3,high,102141,Presencial,2.07,0,Mujer,Headhunter,3,1409960,90.0,86,Casado,37,2017,2,high,1.0749999999999997,0,0,1219718,-2216,1,10
102293,102052,1,Híbrida,6.6,3,Hombre,Linkedin,10,397132,84.0,78,Casado,35,2013,12,high,102093,Presencial,4.45,0,Hombre,Linkedin,5,641000,84.0,76,Divorciado,17,2012,4,high,-2.1499999999999995,-3,-5,243868,-609,1,-18
101313,102049,1,Híbrida,1.345,4,Mujer,Portal Web,2,326037,81.0,84,Casado,24,2013,3,high,102029,Presencial,6.89,0,Mujer,Portal Web,9,1616000,19.0,77,Divorciado,49,2023,3,low,5.545,-4,7,1289963,3657,0,25
101859,102052,1,Híbrida,6.61,3,Hombre,Ferias & Networking,10,393264,89.0,78,Casado,35,2013,11,high,102093,Presencial,4.45,0,Hombre,Linkedin,5,641000,84.0,76,Divorciado,17,2012,4,high,-2.16,-3,-5,247736,-608,1,-18
101361,102149,1,Híbrida,2.62,0,Mujer,Linkedin,7,713815,85.0,69,Casado,53,2022,3,high,102141,Presencial,2.07,0,Mujer,Headhunter,3,1409960,90.0,86,Casado,37,2017,2,high,-0.5500000000000003,0,-4,696145,-1839,1,-16
100051,102023,1,Híbrida,1.54,2,Hombre,Referidos,11,740808,84.0,69,Casado,45,2013,4,high,102105,Híbrida,4.9,1,Hombre,Portal Web,4,539000,80.0,65,Casado,23,2019,12,high,3.3600000000000003,-1,-7,-201808,2439,0,-22
102467,102064,1,Híbrida,3.575,1,Hombre,Portal Web,5,420760,81.0,75,Soltero,39,2016,10,high,102067,Presencial,1.34,0,Hombre,Portal Web,6,1616000,92.0,92,Casado,43,2018,2,high,-2.2350000000000003,-1,1,1195240,479,0,4
102690,102017,1,Híbrida,6.935,1,Hombre,Portal Web,4,300116,92.0,73,Viudo,38,2013,1,high,102035,Presencial,4.62,0,Mujer,Linkedin,2,641000,90.0,84,Casado,25,2019,11,high,-2.3149999999999995,-1,-2,340884,2486,0,-13
102547,102023,1,Híbrida,1.56,2,Hombre,Referidos,11,737424,85.0,69,Casado,46,2013,4,high,102105,Híbrida,4.9,1,Hombre,Portal Web,4,539000,80.0,65,Casado,23,2019,12,high,3.3400000000000003,-1,-7,-198424,2439,0,-23
100934,102111,1,Híbrida,4.535,11,Mujer,Portal Web,7,453282,81.0,74,Divorciado,37,2020,2,high,102097,Híbrida,2.04,1,Mujer,Referidos,15,1616000,94.0,67,Soltero,50,2021,5,high,-2.495,-10,8,1162718,444,0,13
101885,102113,1,Híbrida,2.635,8,Hombre,Portal Web,11,404235,97.0,84,Soltero,45,2019,2,high,102041,Presencial,2.96,2,Hombre,Portal Web,6,1152410,46.0,75,Casado,27,2012,1,low,0.3250000000000002,-6,-5,748175,-2594,1,-18
100162,102061,1,Híbrida,3.025,3,Hombre,Portal Web,7,695683,88.0,74,Viudo,46,2016,7,high,102115,Presencial,2.14,2,Hombre,Ferias & Networking,10,1203920,37.0,80,Casado,29,2012,11,low,-0.8849999999999998,-1,3,508237,-1358,1,-17
102198,102145,1,Híbrida,1.045,2,Mujer,Referidos,1,102858,96.0,74,Soltero,19,2021,8,high,102116,Presencial,1.43,1,Mujer,Portal Web,3,692000,89.0,73,Viudo,23,2016,12,high,0.385,-1,2,589142,-1730,1,4
102784,102111,1,Híbrida,4.575,12,Mujer,Portal Web,7,450734,95.0,74,Divorciado,36,2020,2,high,102097,Híbrida,2.04,1,Mujer,Referidos,15,1616000,94.0,67,Soltero,50,2021,5,high,-2.535,-11,8,1165266,444,0,14
104112,102024,1,Híbrida,1.55,8,Mujer,Portal Web,10,276193,87.0,80,Soltero,36,2013,7,high,102074,Presencial,2.28,0,Hombre,Headhunter,9,1616000,84.0,70,Casado,48,2018,3,high,0.7299999999999998,-8,-1,1339807,1706,0,12
103509,102113,1,Híbrida,2.645,8,Hombre,Portal Web,11,405691,87.0,84,Soltero,45,2019,2,high,102041,Presencial,2.96,2,Hombre,Portal Web,6,1152410,46.0,75,Casado,27,2012,1,low,0.31499999999999995,-6,-5,746719,-2594,1,-18
103792,102061,1,Híbrida,3.025,2,Hombre,Portal Web,7,701239,97.0,74,Viudo,47,2016,7,high,102115,Presencial,2.14,2,Hombre,Ferias & Networking,10,1203920,37.0,80,Casado,29,2012,11,low,-0.8849999999999998,0,3,502681,-1356,1,-18
103293,102031,1,Híbrida,3.08,1,Mujer,Linkedin,10,716224,86.0,86,Soltero,45,2014,3,high,102111,Presencial,2.95,2,Hombre,Portal Web,8,1610000,76.0,87,Casado,31,2017,7,low,-0.1299999999999999,1,-2,893776,1192,0,-14
102305,102101,1,Híbrida,1.075,2,Hombre,Referidos,12,916390,95.0,66,Viudo,57,2019,8,high,102089,Presencial,6.23,0,Hombre,Portal Web,26,1616000,92.0,68,Divorciado,55,2014,1,high,5.155,-2,14,699610,-2034,1,-2
100893,102061,1,Híbrida,5.935,1,Hombre,Referidos,2,83704,94.0,74,Soltero,11,2014,6,high,102115,Presencial,2.14,2,Hombre,Ferias & Networking,10,1203920,37.0,80,Casado,29,2012,11,low,-3.7949999999999995,1,8,1120216,-570,1,18
100900,102126,1,Híbrida,2.865,6,Hombre,Linkedin,4,449327,81.0,78,Casado,37,2020,9,high,102141,Presencial,2.5,1,Mujer,Referidos,2,1049000,94.0,79,Casado,34,2021,1,high,-0.3650000000000002,-5,-2,599673,107,0,-3
103511,102078,1,Híbrida,2.165,1,Mujer,Portal Web,6,271697,87.0,79,Soltero,24,2015,11,high,102143,Presencial,2.17,1,Hombre,Ferias & Networking,9,998000,83.0,76,Casado,29,2017,5,high,0.004999999999999893,0,3,726303,557,0,5
103271,102055,1,Híbrida,3.085,5,Hombre,Portal Web,9,326776,97.0,80,Soltero,25,2014,5,high,102129,Presencial,1.92,2,Hombre,Referidos,8,1616000,97.0,63,Casado,42,2013,2,high,-1.165,-3,-1,1289224,-437,1,17
103691,102126,1,Híbrida,2.895,6,Hombre,Linkedin,4,446047,82.0,78,Casado,37,2020,9,high,102141,Presencial,2.5,1,Mujer,Referidos,2,1049000,94.0,79,Casado,34,2021,1,high,-0.395,-5,-2,602953,107,0,-3
100376,102046,1,Híbrida,2.835,1,Mujer,Referidos,1,81686,93.0,75,Divorciado,13,2015,11,high,102007,Presencial,1.68,0,Mujer,Portal Web,8,1616000,41.0,71,Soltero,50,2015,10,low,-1.155,-1,7,1534314,-31,1,37
102669,102061,1,Híbrida,5.905,2,Hombre,Referidos,2,76694,84.0,74,Soltero,11,2014,6,high,102115,Presencial,2.14,2,Hombre,Ferias & Networking,10,1203920,37.0,80,Casado,29,2012,11,low,-3.765,0,8,1127226,-570,1,18
100181,102077,1,Híbrida,1.035,2,Mujer,Portal Web,1,160461,81.0,88,Soltero,20,2017,12,high,102146,Presencial,2.27,0,Hombre,Ferias & Networking,11,1306940,31.0,64,Soltero,39,2021,6,low,1.235,-2,10,1146479,1301,0,19
102484,102046,1,Híbrida,2.855,1,Mujer,Referidos,1,77082,87.0,75,Divorciado,13,2015,11,high,102007,Presencial,1.68,0,Mujer,Portal Web,8,1616000,41.0,71,Soltero,50,2015,10,low,-1.175,-1,7,1538918,-31,1,37
104166,102077,1,Híbrida,1.03,2,Mujer,Portal Web,1,162787,90.0,88,Soltero,20,2017,12,high,102146,Presencial,2.27,0,Hombre,Ferias & Networking,11,1306940,31.0,64,Soltero,39,2021,6,low,1.24,-2,10,1144153,1300,0,19
103990,102120,1,Híbrida,7.92,2,Mujer,Portal Web,8,290405,91.0,84,Soltero,30,2020,6,high,102171,Presencial,6.48,2,Hombre,Ferias & Networking,9,1616000,80.0,71,Casado,47,2023,8,high,-1.4399999999999995,0,1,1325595,1168,0,17
102466,102091,1,Híbrida,3.455,5,Mujer,Portal Web,10,384814,89.0,79,Soltero,31,2017,5,high,102149,Presencial,1.54,1,Mujer,Portal Web,4,1616000,73.0,77,Casado,39,2014,12,low,-1.915,-4,-6,1231186,-858,1,8
102578,102040,1,Híbrida,5.955,0,Mujer,Ferias & Networking,16,657156,85.0,73,Soltero,41,2013,2,high,102106,Presencial,3.21,1,Hombre,Linkedin,15,1616000,91.0,84,Soltero,45,2016,7,high,-2.745,1,-1,958844,1244,0,4
103702,102079,1,Híbrida,0.855,2,Hombre,Ferias & Networking,5,698070,80.0,66,Soltero,48,2018,3,high,102146,Presencial,2.63,1,Mujer,Portal Web,4,1358450,80.0,81,Soltero,35,2016,3,high,1.775,-1,-1,660380,-740,1,-13
103578,102021,1,Híbrida,2.215,17,Mujer,Portal Web,4,333545,83.0,81,Casado,25,2013,7,high,102069,Presencial,2.25,1,Hombre,Linkedin,8,1616000,47.0,80,Casado,52,2017,3,low,0.03500000000000014,-16,4,1282455,1345,0,27
100519,102115,1,Híbrida,2.84,2,Mujer,Portal Web,8,472675,86.0,73,Soltero,40,2021,12,high,102116,Presencial,2.0,2,Mujer,Portal Web,4,1616000,94.0,76,Soltero,35,2018,12,high,-0.8399999999999999,0,-4,1143325,-1070,1,-5
102706,102089,1,Híbrida,2.46,3,Hombre,Portal Web,1,389958,88.0,83,Divorciado,38,2017,1,high,102077,Presencial,2.75,1,Hombre,Ferias & Networking,6,1616000,96.0,69,Divorciado,60,2021,10,high,0.29000000000000004,-2,5,1226042,1739,0,22
101020,102114,1,Híbrida,1.29,2,Mujer,Portal Web,4,386323,85.0,77,Casado,36,2021,6,high,102050,Presencial,1.44,1,Mujer,Portal Web,5,1616000,91.0,69,Divorciado,47,2021,5,high,0.1499999999999999,-1,1,1229677,-29,1,11
101947,102089,1,Híbrida,2.455,3,Hombre,Portal Web,1,391073,88.0,83,Divorciado,38,2017,1,high,102077,Presencial,2.75,1,Hombre,Ferias & Networking,6,1616000,96.0,69,Divorciado,60,2021,10,high,0.29499999999999993,-2,5,1224927,1741,0,22
102882,102044,1,Híbrida,4.9,3,Hombre,Ferias & Networking,12,467977,90.0,65,Casado,34,2015,7,high,102155,Presencial,1.54,1,Hombre,Ferias & Networking,14,1616000,56.0,68,Soltero,47,2023,3,low,-3.3600000000000003,-2,2,1148023,2811,0,13
101934,102123,1,Híbrida,2.835,1,Mujer,Ferias & Networking,4,791071,87.0,79,Casado,35,2019,3,high,102043,Presencial,5.5,1,Mujer,Linkedin,16,1616000,42.0,66,Soltero,51,2021,9,low,2.665,0,12,824929,935,0,16
101910,102113,1,Híbrida,3.94,1,Mujer,Portal Web,6,838763,87.0,67,Viudo,50,2021,3,high,102041,Presencial,2.96,2,Hombre,Portal Web,6,1152410,46.0,75,Casado,27,2012,1,low,-0.98,1,0,313647,-3359,1,-23
103808,102113,1,Híbrida,3.965,1,Mujer,Portal Web,6,834959,81.0,67,Viudo,50,2021,3,high,102041,Presencial,2.96,2,Hombre,Portal Web,6,1152410,46.0,75,Casado,27,2012,1,low,-1.005,1,0,317451,-3356,1,-23
102710,102087,1,Híbrida,2.665,3,Mujer,Referidos,8,717061,81.0,62,Soltero,47,2016,4,high,102111,Presencial,7.16,9,Mujer,Linkedin,10,1616000,98.0,79,Casado,42,2012,5,high,4.495,6,2,898939,-1439,1,-5
100531,102159,1,Híbrida,4.475,0,Mujer,Referidos,3,186707,95.0,68,Casado,26,2023,3,high,102120,Híbrida,0.98,2,Hombre,Referidos,14,808000,90.0,86,Soltero,44,2022,8,high,-3.4949999999999997,2,11,621293,-195,1,18
100754,102023,1,Híbrida,4.735,2,Mujer,Ferias & Networking,7,289606,93.0,74,Casado,21,2012,2,high,102105,Híbrida,4.9,1,Hombre,Portal Web,4,539000,80.0,65,Casado,23,2019,12,high,0.16500000000000004,-1,-3,249394,2860,0,2
102860,102023,1,Híbrida,4.765,2,Mujer,Ferias & Networking,7,292423,80.0,74,Casado,21,2012,2,high,102105,Híbrida,4.9,1,Hombre,Portal Web,4,539000,80.0,65,Casado,23,2019,12,high,0.13500000000000068,-1,-3,246577,2860,0,2
101425,102065,1,Híbrida,3.645,2,Mujer,Referidos,2,124196,86.0,75,Soltero,16,2017,7,high,102026,Presencial,2.44,2,Hombre,Ferias & Networking,13,1616000,45.0,60,Divorciado,35,2014,10,low,-1.205,0,11,1491804,-1025,1,19
101586,102054,1,Híbrida,1.535,2,Mujer,Linkedin,2,161547,89.0,66,Soltero,15,2013,10,high,102044,Presencial,2.91,1,Hombre,Linkedin,17,1616000,85.0,74,Divorciado,41,2012,11,high,1.3750000000000002,-1,15,1454453,-352,1,26
101700,102140,1,Híbrida,2.835,1,Mujer,Linkedin,4,267576,82.0,77,Casado,32,2023,12,high,102040,Presencial,2.55,0,Mujer,Portal Web,16,1616000,46.0,69,Casado,39,2012,2,low,-0.28500000000000014,-1,12,1348424,-4332,1,7
101994,102159,1,Híbrida,1.06,2,Hombre,Linkedin,6,307576,93.0,68,Casado,34,2023,10,high,102120,Híbrida,0.98,2,Hombre,Referidos,14,808000,90.0,86,Soltero,44,2022,8,high,-0.08000000000000007,0,8,500424,-439,1,10
100968,102150,1,Híbrida,3.44,1,Hombre,Ferias & Networking,7,349639,89.0,84,Soltero,36,2023,8,high,102085,Presencial,3.9,8,Mujer,Portal Web,10,1358450,85.0,75,Casado,32,2012,12,high,0.45999999999999996,7,3,1008811,-3890,1,-4
100166,102145,1,Híbrida,1.155,2,Hombre,Portal Web,12,505195,88.0,78,Casado,44,2023,10,high,102116,Presencial,1.43,1,Mujer,Portal Web,3,692000,89.0,73,Viudo,23,2016,12,high,0.2749999999999999,-1,-9,186805,-2521,1,-21
100443,102172,1,Híbrida,5.055,3,Mujer,Referidos,11,251089,90.0,78,Soltero,44,2023,9,high,102020,Presencial,5.58,1,Hombre,Portal Web,7,1049000,57.0,70,Casado,29,2016,4,low,0.5250000000000004,-2,-4,797911,-2710,1,-15
101056,102171,1,Híbrida,1.155,2,Mujer,Portal Web,7,252126,90.0,71,Soltero,44,2023,8,high,102088,Presencial,2.57,4,Hombre,Linkedin,8,1616000,80.0,69,Casado,43,2017,10,high,1.4149999999999998,2,1,1363874,-2153,1,-1
100588,102172,1,Híbrida,4.375,0,Mujer,Linkedin,4,269039,97.0,61,Casado,45,2023,8,high,102020,Presencial,5.58,1,Hombre,Portal Web,7,1049000,57.0,70,Casado,29,2016,4,low,1.205,1,3,779961,-2665,1,-16
102076,102168,2,Híbrida,1.95,1,Hombre,Referidos,9,1616000,95.0,82,Soltero,53,2023,9,high,102172,Presencial,6.22,1,Hombre,Referidos,15,1616000,75.0,68,Viudo,42,2012,1,low,4.27,0,6,0,-4263,1,-11
104055,102168,1,Híbrida,1.68,3,Mujer,Portal Web,1,75575,86.0,82,Soltero,21,2023,10,high,102172,Presencial,6.22,1,Hombre,Referidos,15,1616000,75.0,68,Viudo,42,2012,1,low,4.54,-2,14,1540425,-4297,1,21
104033,102172,1,Híbrida,1.56,9,Mujer,Portal Web,2,95941,90.0,76,Soltero,21,2023,7,high,102020,Presencial,5.58,1,Hombre,Portal Web,7,1049000,57.0,70,Casado,29,2016,4,low,4.02,-8,5,953059,-2634,1,8
102855,102140,1,Híbrida,2.815,1,Mujer,Linkedin,4,266226,86.0,77,Soltero,32,2023,12,high,102040,Presencial,2.55,0,Mujer,Portal Web,16,1616000,46.0,69,Casado,39,2012,2,low,-0.2650000000000001,-1,12,1349774,-4332,1,7
103440,102172,1,Híbrida,2.91,3,Hombre,Referidos,9,346306,83.0,72,Casado,36,2023,9,high,102020,Presencial,5.58,1,Hombre,Portal Web,7,1049000,57.0,70,Casado,29,2016,4,low,2.67,-2,-2,702694,-2707,1,-7
103424,102150,1,Híbrida,3.43,2,Hombre,Ferias & Networking,7,345768,86.0,84,Soltero,36,2023,8,high,102085,Presencial,3.9,8,Mujer,Portal Web,10,1358450,85.0,75,Casado,32,2012,12,high,0.46999999999999975,6,3,1012682,-3890,1,-4
103689,102154,1,Híbrida,3.2,4,Mujer,Linkedin,2,406239,92.0,73,Soltero,38,2023,10,high,102172,Presencial,5.45,1,Hombre,Portal Web,7,1512980,93.0,69,Soltero,39,2017,10,high,2.25,-3,5,1106741,-2189,1,1
102893,102137,1,Híbrida,3.475,1,Mujer,Portal Web,8,788922,90.0,75,Soltero,38,2023,7,high,102046,Presencial,1.18,0,Mujer,Portal Web,2,845000,37.0,79,Casado,27,2017,12,low,-2.295,-1,-6,56078,-2033,1,-11
103956,102145,1,Híbrida,1.13,2,Hombre,Portal Web,12,504835,82.0,78,Divorciado,43,2023,10,high,102116,Presencial,1.43,1,Mujer,Portal Web,3,692000,89.0,73,Viudo,23,2016,12,high,0.30000000000000004,-1,-9,187165,-2519,1,-20
104012,102172,1,Híbrida,5.06,3,Mujer,Referidos,11,247302,97.0,78,Soltero,44,2023,9,high,102020,Presencial,5.58,1,Hombre,Portal Web,7,1049000,57.0,70,Casado,29,2016,4,low,0.5200000000000005,-2,-4,801698,-2711,1,-15
103924,102171,1,Híbrida,1.14,3,Mujer,Portal Web,7,251388,95.0,71,Soltero,44,2023,8,high,102088,Presencial,2.57,4,Hombre,Linkedin,8,1616000,80.0,69,Casado,43,2017,10,high,1.43,1,1,1364612,-2156,1,-1
102905,102171,1,Híbrida,1.39,0,Hombre,Ferias & Networking,4,320234,95.0,66,Casado,50,2023,7,high,102088,Presencial,2.57,4,Hombre,Linkedin,8,1616000,80.0,69,Casado,43,2017,10,high,1.18,4,4,1295766,-2107,1,-7
103793,102143,1,Híbrida,5.365,9,Mujer,Linkedin,5,701890,95.0,71,Viudo,54,2023,10,high,102142,Presencial,1.07,2,Hombre,Portal Web,2,590000,90.0,78,Casado,25,2022,2,high,-4.295,-7,-3,-111890,-633,1,-29
101901,102113,1,Presencial,7.575,9,Hombre,Linkedin,4,305190,98.0,63,Soltero,31,2020,8,high,102041,Presencial,2.96,2,Hombre,Portal Web,6,1152410,46.0,75,Casado,27,2012,1,low,-4.615,-7,2,847220,-3137,1,-4
101660,102038,1,Presencial,1.51,7,Hombre,Portal Web,4,365596,98.0,80,Soltero,25,2012,4,high,102125,Presencial,2.06,1,Hombre,Portal Web,12,1616000,81.0,82,Casado,44,2018,1,high,0.55,-6,8,1250404,2097,0,19
101018,102144,1,Presencial,2.34,1,Hombre,Linkedin,1,103239,97.0,83,Soltero,20,2021,10,high,102156,Presencial,2.13,8,Mujer,Portal Web,11,1616000,5.0,82,Viudo,58,2015,6,low,-0.20999999999999996,7,10,1512761,-2306,1,38
103254,102053,1,Presencial,1.92,0,Hombre,Portal Web,6,333504,97.0,83,Soltero,26,2015,3,high,102030,Presencial,1.29,0,Hombre,Portal Web,11,1616000,81.0,64,Soltero,36,2012,12,high,-0.6299999999999999,0,5,1282496,-819,1,10
102869,102038,1,Presencial,1.535,8,Hombre,Portal Web,4,364718,97.0,80,Soltero,25,2012,4,high,102125,Presencial,2.06,1,Hombre,Portal Web,12,1616000,81.0,82,Casado,44,2018,1,high,0.5250000000000001,-7,8,1251282,2095,0,19
100978,102082,1,Presencial,2.7,1,Hombre,Linkedin,4,142413,96.0,76,Soltero,19,2018,6,high,102050,Presencial,5.5,2,Mujer,Linkedin,7,1616000,81.0,70,Casado,36,2018,8,high,2.8,1,3,1473587,56,0,17
101746,102040,1,Presencial,5.6,3,Hombre,Referidos,6,347841,96.0,84,Casado,27,2015,9,high,102106,Presencial,3.21,1,Hombre,Linkedin,15,1616000,91.0,84,Soltero,45,2016,7,high,-2.3899999999999997,-2,9,1268159,314,0,18
100318,102053,1,Presencial,1.93,1,Hombre,Portal Web,6,328519,96.0,83,Soltero,26,2015,3,high,102030,Presencial,1.29,0,Hombre,Portal Web,11,1616000,81.0,64,Soltero,36,2012,12,high,-0.6399999999999999,-1,5,1287481,-820,1,10
101237,102029,1,Presencial,2.17,2,Hombre,Portal Web,8,369467,96.0,84,Soltero,27,2014,2,high,102132,Presencial,5.79,2,Hombre,Portal Web,16,1616000,80.0,84,Casado,49,2017,9,high,3.62,0,8,1246533,1320,0,22
100191,102045,1,Presencial,1.49,1,Mujer,Ferias & Networking,11,740305,96.0,79,Casado,48,2015,7,high,102171,Presencial,3.19,3,Hombre,Portal Web,11,1616000,97.0,65,Casado,53,2023,9,high,1.7,2,0,875695,3003,0,5
103667,102108,1,Presencial,2.29,3,Hombre,Portal Web,3,186538,96.0,86,Casado,22,2018,8,high,102040,Presencial,2.92,1,Mujer,Portal Web,5,1616000,46.0,75,Casado,50,2023,5,low,0.6299999999999999,-2,2,1429462,1739,0,28
102525,102029,1,Presencial,2.12,1,Hombre,Referidos,8,370294,96.0,84,Soltero,27,2014,2,high,102132,Presencial,5.79,2,Hombre,Portal Web,16,1616000,80.0,84,Casado,49,2017,9,high,3.67,1,8,1245706,1321,0,22
102899,102046,1,Presencial,3.845,0,Hombre,Portal Web,5,372499,96.0,60,Casado,25,2012,12,high,102007,Presencial,1.68,0,Mujer,Portal Web,8,1616000,41.0,71,Soltero,50,2015,10,low,-2.165,0,3,1243501,1043,0,25
103101,102074,1,Presencial,3.045,1,Mujer,Referidos,9,919132,96.0,60,Casado,48,2015,12,high,102028,Presencial,1.35,0,Hombre,Ferias & Networking,4,1616000,80.0,83,Viudo,43,2015,12,high,-1.6949999999999998,-1,-5,696868,19,0,-5
100721,102150,1,Presencial,1.88,2,Hombre,Ferias & Networking,2,118445,95.0,78,Soltero,22,2022,7,high,102085,Presencial,3.9,8,Mujer,Portal Web,10,1358450,85.0,75,Casado,32,2012,12,high,2.02,6,8,1240005,-3489,1,10
101730,102105,1,Presencial,6.365,0,Mujer,Portal Web,4,188838,95.0,69,Soltero,23,2019,4,high,102113,Híbrida,2.07,0,Hombre,Linkedin,8,1616000,85.0,71,Viudo,45,2017,3,high,-4.295,0,4,1427162,-750,1,22
101100,102046,1,Presencial,3.85,0,Hombre,Portal Web,5,369697,95.0,60,Casado,25,2012,12,high,102007,Presencial,1.68,0,Mujer,Portal Web,8,1616000,41.0,71,Soltero,50,2015,10,low,-2.17,0,3,1246303,1043,0,25
100156,102069,1,Presencial,1.42,2,Hombre,Ferias & Networking,10,406690,95.0,78,Casado,32,2017,7,high,102069,Presencial,4.64,1,Mujer,Ferias & Networking,19,1616000,47.0,74,Casado,60,2021,10,low,3.2199999999999998,-1,9,1209310,1552,0,28
100834,102126,1,Presencial,2.2,2,Mujer,Referidos,5,277679,95.0,79,Casado,43,2020,3,high,102141,Presencial,2.5,1,Mujer,Referidos,2,1049000,94.0,79,Casado,34,2021,1,high,0.2999999999999998,-1,-3,771321,308,0,-9
103767,102082,1,Presencial,2.685,0,Hombre,Linkedin,4,148029,95.0,76,Soltero,19,2018,6,high,102050,Presencial,5.5,2,Mujer,Linkedin,7,1616000,81.0,70,Casado,36,2018,8,high,2.815,2,3,1467971,56,0,17
102317,102112,1,Presencial,2.445,2,Hombre,Linkedin,5,447340,95.0,69,Casado,36,2018,12,high,102031,Presencial,2.27,7,Hombre,Linkedin,1,692000,83.0,74,Soltero,26,2020,6,high,-0.17499999999999982,5,-4,244660,562,0,-10
103890,102093,1,Presencial,1.505,2,Hombre,Linkedin,5,486851,95.0,75,Casado,38,2019,1,high,102139,Presencial,5.41,0,Mujer,Ferias & Networking,4,488000,89.0,62,Soltero,23,2021,6,high,3.9050000000000002,-2,-1,1149,874,0,-15
103923,102145,1,Presencial,4.675,3,Hombre,Ferias & Networking,11,441957,95.0,75,Soltero,44,2021,1,high,102116,Presencial,1.43,1,Mujer,Portal Web,3,692000,89.0,73,Viudo,23,2016,12,high,-3.245,-2,-8,250043,-1505,1,-21
100047,102107,1,Presencial,2.465,9,Hombre,Portal Web,7,390504,94.0,71,Casado,31,2017,10,high,102069,Presencial,2.4,1,Mujer,Linkedin,8,1616000,47.0,79,Casado,63,2023,6,low,-0.06499999999999995,-8,1,1225496,2086,0,32
101652,102093,1,Presencial,1.525,3,Hombre,Linkedin,5,486356,94.0,75,Casado,38,2019,1,high,102139,Presencial,5.41,0,Mujer,Ferias & Networking,4,488000,89.0,62,Soltero,23,2021,6,high,3.8850000000000002,-3,-1,1644,874,0,-15
100889,102089,1,Presencial,5.195,2,Mujer,Portal Web,11,491085,94.0,82,Soltero,35,2016,8,high,102077,Presencial,2.75,1,Hombre,Ferias & Networking,6,1616000,96.0,69,Divorciado,60,2021,10,high,-2.4450000000000003,-1,-5,1124915,1881,0,25
102115,102116,2,Presencial,2.0,2,Mujer,Portal Web,4,1616000,94.0,76,Soltero,35,2018,12,high,102021,Presencial,2.32,0,Mujer,Portal Web,22,1616000,94.0,76,Casado,59,2020,7,high,0.31999999999999984,-2,18,0,569,0,24
102959,102116,1,Presencial,1.99,0,Mujer,Portal Web,8,413318,94.0,77,Soltero,34,2018,11,high,102021,Presencial,2.32,0,Mujer,Portal Web,22,1616000,94.0,76,Casado,59,2020,7,high,0.32999999999999985,0,14,1202682,619,0,25
103470,102069,1,Presencial,1.42,2,Hombre,Ferias & Networking,10,406721,94.0,78,Casado,32,2017,7,high,102069,Presencial,4.64,1,Mujer,Ferias & Networking,19,1616000,47.0,74,Casado,60,2021,10,low,3.2199999999999998,-1,9,1209279,1552,0,28
103200,102100,1,Presencial,1.65,1,Hombre,Ferias & Networking,10,301343,94.0,71,Soltero,44,2019,8,high,102007,Presencial,3.3,1,Mujer,Portal Web,3,1255430,21.0,59,Casado,30,2013,2,low,1.65,0,-7,954087,-2363,1,-14
100245,102025,1,Presencial,4.75,2,Mujer,Ferias & Networking,16,741195,93.0,75,Casado,46,2013,11,high,102132,Presencial,1.6,0,Hombre,Portal Web,9,1616000,90.0,81,Viudo,56,2018,4,high,-3.15,-2,-7,874805,1593,0,10
103275,102103,1,Presencial,3.84,3,Mujer,Ferias & Networking,2,188490,93.0,76,Viudo,24,2020,10,high,102023,Presencial,1.69,6,Hombre,Portal Web,3,1616000,90.0,74,Casado,45,2013,5,high,-2.15,3,1,1427510,-2722,1,21
103902,102089,1,Presencial,5.18,3,Mujer,Portal Web,11,489516,93.0,82,Soltero,35,2016,8,high,102077,Presencial,2.75,1,Hombre,Ferias & Networking,6,1616000,96.0,69,Divorciado,60,2021,10,high,-2.4299999999999997,-2,-5,1126484,1880,0,25
100133,102172,1,Presencial,1.685,0,Mujer,Ferias & Networking,1,145872,92.0,68,Soltero,24,2023,6,high,102020,Presencial,5.58,1,Hombre,Portal Web,7,1049000,57.0,70,Casado,29,2016,4,low,3.895,1,6,903128,-2606,1,5
101323,102133,1,Presencial,2.53,1,Mujer,Referidos,4,186663,92.0,71,Casado,25,2021,4,high,102151,Híbrida,2.61,2,Hombre,Linkedin,4,1255430,98.0,65,Soltero,35,2018,2,high,0.08000000000000007,1,0,1068767,-1151,1,10
101263,102080,1,Presencial,1.735,1,Mujer,Referidos,3,325734,92.0,76,Soltero,27,2016,8,high,102035,Presencial,1.93,0,Mujer,Linkedin,18,1616000,94.0,75,Viudo,47,2016,8,high,0.19499999999999984,-1,15,1290266,-15,1,20
101715,102105,1,Presencial,1.835,2,Hombre,Ferias & Networking,14,697860,92.0,74,Viudo,47,2017,10,high,102113,Híbrida,2.07,0,Hombre,Linkedin,8,1616000,85.0,71,Viudo,45,2017,3,high,0.23499999999999988,-2,-6,918140,-218,1,-2
102996,102133,1,Presencial,2.55,1,Mujer,Referidos,4,186551,92.0,71,Casado,25,2021,4,high,102151,Híbrida,2.61,2,Hombre,Linkedin,4,1255430,98.0,65,Soltero,35,2018,2,high,0.06000000000000005,1,0,1068879,-1151,1,10
102560,102095,1,Presencial,3.15,5,Mujer,Linkedin,6,491616,92.0,66,Casado,39,2020,1,high,102171,Presencial,3.28,2,Mujer,Portal Web,3,1616000,80.0,75,Soltero,42,2023,10,high,0.1299999999999999,-3,-3,1124384,1374,0,3
100719,102031,1,Presencial,1.95,1,Hombre,Linkedin,1,77478,91.0,69,Soltero,11,2014,7,high,102111,Presencial,2.95,2,Hombre,Portal Web,8,1610000,76.0,87,Casado,31,2017,7,low,1.0000000000000002,1,7,1532522,1075,0,20
100135,102080,1,Presencial,3.25,2,Mujer,Portal Web,1,104382,91.0,72,Soltero,16,2018,6,high,102035,Presencial,1.93,0,Mujer,Linkedin,18,1616000,94.0,75,Viudo,47,2016,8,high,-1.32,-2,17,1511618,-682,1,31
100860,102116,1,Presencial,5.955,2,Mujer,Ferias & Networking,1,119561,91.0,67,Soltero,19,2020,5,high,102021,Presencial,2.32,0,Mujer,Portal Web,22,1616000,94.0,76,Casado,59,2020,7,high,-3.6350000000000002,-2,21,1496439,66,0,40
100236,102134,1,Presencial,2.38,1,Mujer,Linkedin,2,139283,91.0,75,Casado,22,2022,7,high,102135,Presencial,2.25,2,Hombre,Portal Web,5,1358450,90.0,69,Viudo,31,2012,7,high,-0.1299999999999999,1,3,1219167,-3641,1,9
100473,102084,1,Presencial,2.555,0,Mujer,Linkedin,2,137943,91.0,76,Soltero,19,2018,6,high,102171,Presencial,2.62,3,Mujer,Portal Web,14,1616000,89.0,76,Divorciado,50,2023,7,high,0.06499999999999995,3,12,1478057,1857,0,31
101834,102080,1,Presencial,1.56,0,Mujer,Portal Web,1,144399,91.0,78,Soltero,18,2017,11,high,102035,Presencial,1.93,0,Mujer,Linkedin,18,1616000,94.0,75,Viudo,47,2016,8,high,0.3699999999999999,0,17,1471601,-467,1,29
100547,102052,1,Presencial,1.43,0,Hombre,Referidos,3,136629,91.0,83,Soltero,14,2013,10,high,102093,Presencial,4.45,0,Hombre,Linkedin,5,641000,84.0,76,Divorciado,17,2012,4,high,3.0200000000000005,0,2,504371,-570,1,3
100703,102135,1,Presencial,5.17,2,Hombre,Ferias & Networking,3,145957,91.0,75,Casado,22,2021,6,high,102028,Presencial,2.04,1,Hombre,Portal Web,2,1616000,82.0,75,Divorciado,49,2017,10,high,-3.13,-1,-1,1470043,-1337,1,27
101915,102105,1,Presencial,1.51,1,Hombre,Portal Web,3,165327,91.0,71,Soltero,20,2018,5,high,102113,Híbrida,2.07,0,Hombre,Linkedin,8,1616000,85.0,71,Viudo,45,2017,3,high,0.5599999999999998,-1,5,1450673,-418,1,25
100826,102004,1,Presencial,4.59,0,Mujer,Ferias & Networking,4,167216,91.0,82,Soltero,14,2012,3,high,102026,Presencial,3.13,1,Hombre,Portal Web,15,1616000,87.0,85,Viudo,49,2023,1,high,-1.46,1,11,1448784,3939,0,35
100583,102056,1,Presencial,2.36,3,Mujer,Linkedin,5,206147,91.0,76,Soltero,19,2015,6,high,102014,Presencial,5.24,1,Hombre,Ferias & Networking,16,1616000,70.0,63,Viudo,65,2023,3,low,2.8800000000000003,-2,11,1409853,2813,0,46
100461,102028,1,Presencial,5.845,2,Hombre,Portal Web,1,204697,91.0,72,Casado,16,2012,5,high,102085,Presencial,1.39,2,Mujer,Linkedin,12,1358450,97.0,72,Soltero,35,2016,12,high,-4.455,0,11,1153753,1688,0,19
100336,102057,1,Presencial,3.715,3,Mujer,Portal Web,6,210282,91.0,78,Soltero,22,2016,10,high,102019,Presencial,1.97,4,Hombre,Portal Web,5,1616000,90.0,73,Viudo,59,2022,12,high,-1.7449999999999999,1,-1,1405718,2255,0,37
100691,102140,1,Presencial,1.69,1,Mujer,Headhunter,1,226118,91.0,70,Casado,29,2023,1,high,102040,Presencial,2.55,0,Mujer,Portal Web,16,1616000,46.0,69,Casado,39,2012,2,low,0.8599999999999999,-1,15,1389882,-3986,1,10
101559,102107,1,Presencial,3.695,4,Mujer,Portal Web,2,251781,91.0,84,Casado,27,2020,6,high,102069,Presencial,2.4,1,Mujer,Linkedin,8,1616000,47.0,79,Casado,63,2023,6,low,-1.295,-3,6,1364219,1110,0,36
100866,102063,1,Presencial,2.085,1,Hombre,Portal Web,8,249210,91.0,88,Casado,22,2014,2,high,102135,Presencial,2.73,0,Mujer,Linkedin,1,539000,26.0,75,Soltero,24,2021,4,low,0.645,-1,-7,289790,2621,0,2
101521,102107,1,Presencial,3.34,1,Hombre,Ferias & Networking,6,270398,91.0,78,Casado,27,2018,9,high,102069,Presencial,2.4,1,Mujer,Linkedin,8,1616000,47.0,79,Casado,63,2023,6,low,-0.94,0,2,1345602,1734,0,36
100657,102111,1,Presencial,1.125,2,Mujer,Portal Web,4,292238,91.0,67,Divorciado,27,2018,4,high,102097,Híbrida,2.04,1,Mujer,Referidos,15,1616000,94.0,67,Soltero,50,2021,5,high,0.915,-1,11,1323762,1137,0,23
101542,102033,1,Presencial,7.47,1,Mujer,Ferias & Networking,4,288188,91.0,76,Casado,22,2013,2,high,102172,Presencial,6.25,2,Mujer,Portal Web,16,1616000,90.0,79,Divorciado,39,2014,5,high,-1.2199999999999998,1,12,1327812,445,0,17
100410,102155,1,Presencial,3.61,0,Hombre,Ferias & Networking,6,330663,91.0,69,Casado,33,2022,10,high,102159,Presencial,1.78,1,Mujer,Ferias & Networking,1,590000,39.0,80,Soltero,20,2016,10,low,-1.8299999999999998,1,-5,259337,-2188,1,-13
100601,102106,1,Presencial,2.3,1,Mujer,Referidos,6,333503,91.0,79,Casado,30,2019,1,high,102081,Presencial,1.39,1,Mujer,Ferias & Networking,5,1049000,86.0,86,Soltero,32,2019,6,high,-0.9099999999999999,0,-1,715497,139,0,2
101510,102042,1,Presencial,2.325,9,Mujer,Linkedin,8,329309,91.0,74,Casado,23,2012,5,high,102107,Presencial,2.19,2,Hombre,Ferias & Networking,8,1616000,38.0,78,Divorciado,57,2018,6,low,-0.13500000000000023,-7,0,1286691,2237,0,34
100957,102091,1,Presencial,1.525,0,Hombre,Headhunter,8,364595,91.0,72,Soltero,32,2019,9,high,102149,Presencial,1.54,1,Mujer,Portal Web,4,1616000,73.0,77,Casado,39,2014,12,low,0.015000000000000124,1,-4,1251405,-1727,1,7
100843,102129,1,Presencial,2.26,7,Hombre,Portal Web,4,412815,91.0,78,Soltero,36,2021,12,high,102142,Presencial,2.1,2,Mujer,Linkedin,3,590000,41.0,74,Soltero,24,2020,1,low,-0.1599999999999997,-5,-1,177185,-715,1,-12
101843,102148,1,Presencial,2.125,2,Mujer,Referidos,3,767069,91.0,83,Casado,35,2021,6,high,102116,Presencial,1.49,2,Mujer,Portal Web,2,539000,80.0,67,Soltero,26,2022,12,high,-0.635,0,-1,-228069,529,0,-9
100822,102101,1,Presencial,1.63,3,Hombre,Linkedin,2,385116,91.0,67,Soltero,32,2017,5,high,102089,Presencial,6.23,0,Hombre,Portal Web,26,1616000,92.0,68,Divorciado,55,2014,1,high,4.6000000000000005,-3,24,1230884,-1231,1,23
101713,102058,1,Presencial,3.915,1,Hombre,Linkedin,6,410350,91.0,76,Soltero,29,2015,3,high,102172,Presencial,1.4,2,Hombre,Ferias & Networking,11,1616000,75.0,71,Casado,59,2021,2,low,-2.515,1,5,1205650,2181,0,30
101728,102106,1,Presencial,1.33,3,Hombre,Portal Web,11,432741,91.0,67,Soltero,36,2021,1,high,102081,Presencial,1.39,1,Mujer,Ferias & Networking,5,1049000,86.0,86,Soltero,32,2019,6,high,0.05999999999999983,-2,-6,616259,-569,1,-4
100543,102151,1,Presencial,4.115,1,Hombre,Referidos,5,432341,91.0,75,Casado,39,2023,1,high,102105,Presencial,1.51,2,Hombre,Ferias & Networking,10,1616000,85.0,80,Divorciado,45,2021,11,high,-2.6050000000000004,1,5,1183659,-419,1,6
101825,102023,1,Presencial,2.045,3,Hombre,Referidos,9,428510,91.0,70,Casado,28,2012,10,high,102105,Híbrida,4.9,1,Hombre,Portal Web,4,539000,80.0,65,Casado,23,2019,12,high,2.8550000000000004,-2,-5,110490,2643,0,-5
100953,102043,1,Presencial,2.895,2,Hombre,Referidos,7,429821,91.0,60,Casado,28,2012,6,high,102051,Presencial,1.03,0,Hombre,Portal Web,5,1616000,60.0,76,Casado,44,2019,5,low,-1.865,-2,-2,1186179,2538,0,16
100982,102125,1,Presencial,1.965,1,Mujer,Headhunter,8,470118,91.0,86,Viudo,39,2021,9,high,102096,Híbrida,4.0,2,Mujer,Referidos,5,692000,87.0,82,Casado,29,2022,7,high,2.035,1,-3,221882,316,0,-10
100374,102066,1,Presencial,2.525,3,Mujer,Ferias & Networking,11,449921,91.0,83,Soltero,33,2016,9,high,102171,Presencial,3.62,3,Hombre,Referidos,5,1616000,97.0,84,Casado,55,2023,12,high,1.0950000000000002,0,-6,1166079,2646,0,22
100904,102057,1,Presencial,1.92,0,Mujer,Linkedin,10,473299,91.0,80,Soltero,33,2015,3,high,102019,Presencial,1.97,4,Hombre,Portal Web,5,1616000,90.0,73,Viudo,59,2022,12,high,0.050000000000000044,4,-5,1142701,2856,0,26
100456,102052,1,Presencial,2.715,8,Hombre,Linkedin,10,466136,91.0,70,Casado,32,2013,11,high,102093,Presencial,4.45,0,Hombre,Linkedin,5,641000,84.0,76,Divorciado,17,2012,4,high,1.7350000000000003,-8,-5,174864,-600,1,-15
101447,102051,1,Presencial,1.985,2,Mujer,Referidos,9,828970,91.0,67,Casado,32,2013,10,high,102075,Híbrida,1.39,1,Hombre,Portal Web,11,1616000,83.0,76,Casado,46,2019,11,high,-0.5950000000000002,-1,2,787030,2206,0,14
101291,102095,1,Presencial,3.15,4,Mujer,Linkedin,6,489706,91.0,66,Casado,39,2020,1,high,102171,Presencial,3.28,2,Mujer,Portal Web,3,1616000,80.0,75,Soltero,42,2023,10,high,0.1299999999999999,-2,-3,1126294,1373,0,3
101179,102065,1,Presencial,3.815,0,Mujer,Portal Web,6,505935,91.0,77,Casado,35,2014,11,high,102026,Presencial,2.44,2,Hombre,Ferias & Networking,13,1616000,45.0,60,Divorciado,35,2014,10,low,-1.375,2,7,1110065,-44,1,0
101072,102078,1,Presencial,1.655,2,Hombre,Portal Web,9,377505,91.0,82,Soltero,40,2017,7,high,102143,Presencial,2.17,1,Hombre,Ferias & Networking,9,998000,83.0,76,Casado,29,2017,5,high,0.5149999999999999,-1,0,620495,-43,1,-11
101494,102065,1,Presencial,3.065,10,Mujer,Linkedin,11,271240,91.0,75,Casado,38,2016,3,high,102026,Presencial,2.44,2,Hombre,Ferias & Networking,13,1616000,45.0,60,Divorciado,35,2014,10,low,-0.625,-8,2,1344760,-524,1,-3
101877,102046,1,Presencial,2.25,0,Hombre,Portal Web,6,410749,91.0,79,Casado,36,2014,5,high,102007,Presencial,1.68,0,Mujer,Portal Web,8,1616000,41.0,71,Soltero,50,2015,10,low,-0.5700000000000001,0,2,1205251,540,0,14
101985,102044,1,Presencial,3.135,7,Mujer,Portal Web,7,455066,91.0,69,Divorciado,35,2013,3,high,102155,Presencial,1.54,1,Hombre,Ferias & Networking,14,1616000,56.0,68,Soltero,47,2023,3,low,-1.5949999999999998,-6,7,1160934,3653,0,12
100298,102124,1,Presencial,2.53,1,Hombre,Ferias & Networking,6,275496,91.0,72,Casado,45,2022,4,high,102099,Presencial,2.84,2,Mujer,Linkedin,4,947000,90.0,70,Soltero,24,2012,10,high,0.31000000000000005,1,-2,671504,-3461,1,-21
100627,102118,1,Presencial,6.255,0,Mujer,Portal Web,6,274133,91.0,72,Casado,45,2021,11,high,102171,Presencial,4.76,17,Mujer,Linkedin,4,1616000,86.0,74,Soltero,39,2023,8,high,-1.495,17,-2,1341867,635,0,-6
100271,102108,1,Presencial,5.09,2,Hombre,Portal Web,5,280288,91.0,75,Soltero,42,2019,2,high,102040,Presencial,2.92,1,Mujer,Portal Web,5,1616000,46.0,75,Casado,50,2023,5,low,-2.17,-1,0,1335712,1575,0,8
100453,102092,1,Presencial,5.52,8,Mujer,Linkedin,4,387132,91.0,75,Casado,42,2019,1,high,102120,Presencial,1.23,6,Mujer,Linkedin,13,1616000,98.0,95,Viudo,41,2013,6,high,-4.289999999999999,-2,9,1228868,-2032,1,-1
101948,102045,1,Presencial,3.0,1,Mujer,Portal Web,14,288347,91.0,69,Casado,38,2014,7,high,102171,Presencial,3.19,3,Hombre,Portal Web,11,1616000,97.0,65,Casado,53,2023,9,high,0.18999999999999995,2,-3,1327653,3347,0,15
101206,102154,1,Presencial,6.615,3,Mujer,Portal Web,11,284400,91.0,82,Soltero,47,2022,10,high,102172,Presencial,5.45,1,Hombre,Portal Web,7,1512980,93.0,69,Soltero,39,2017,10,high,-1.165,-2,-4,1228580,-1838,1,-8
101471,102026,1,Presencial,1.445,8,Mujer,Linkedin,5,453173,91.0,71,Soltero,38,2014,3,high,102101,Presencial,2.7,1,Mujer,Portal Web,15,1616000,97.0,79,Casado,58,2017,6,high,1.2550000000000001,-7,10,1162827,1202,0,20
101810,102074,1,Presencial,1.53,1,Mujer,Ferias & Networking,7,294484,91.0,62,Divorciado,41,2016,7,high,102028,Presencial,1.35,0,Hombre,Ferias & Networking,4,1616000,80.0,83,Viudo,43,2015,12,high,-0.17999999999999994,-1,-3,1321516,-186,1,2
101312,102153,1,Presencial,1.62,1,Hombre,Ferias & Networking,13,800257,91.0,75,Divorciado,49,2022,9,high,102143,Presencial,6.39,1,Mujer,Linkedin,5,1616000,90.0,68,Casado,41,2019,6,high,4.77,0,-8,815743,-1187,1,-8
100014,102086,1,Presencial,3.205,3,Hombre,Portal Web,11,396663,91.0,71,Viudo,44,2018,3,high,102085,Presencial,2.22,2,Mujer,Linkedin,7,1306940,87.0,68,Divorciado,39,2021,3,high,-0.9849999999999999,-1,-4,910277,1070,0,-5
101128,102082,1,Presencial,2.335,0,Hombre,Linkedin,5,308017,91.0,83,Casado,43,2016,9,high,102050,Presencial,5.5,2,Mujer,Linkedin,7,1616000,81.0,70,Casado,36,2018,8,high,3.165,2,2,1307983,690,0,-7
101455,102032,1,Presencial,2.88,3,Hombre,Portal Web,13,312183,91.0,69,Viudo,39,2012,10,high,102065,Presencial,1.78,7,Hombre,Portal Web,14,1616000,42.0,71,Casado,42,2015,11,low,-1.0999999999999999,4,1,1303817,1121,0,3
101614,102020,1,Presencial,1.87,0,Hombre,Portal Web,6,308408,91.0,68,Casado,38,2012,10,high,102134,Presencial,6.63,1,Mujer,Linkedin,11,1203920,90.0,78,Casado,35,2018,12,high,4.76,1,5,895512,2256,0,-3
100000,102085,1,Presencial,6.035,7,Mujer,Portal Web,13,815948,91.0,79,Casado,45,2018,7,high,102145,Presencial,6.59,4,Hombre,Portal Web,12,1616000,47.0,71,Casado,39,2015,8,low,0.5549999999999997,-3,-1,800052,-1064,1,-6
100345,102085,1,Presencial,1.16,1,Mujer,Portal Web,3,633952,91.0,83,Casado,45,2017,11,high,102145,Presencial,6.59,4,Hombre,Portal Web,12,1616000,47.0,71,Casado,39,2015,8,low,5.43,3,9,982048,-820,1,-6
100985,102035,1,Presencial,3.42,3,Hombre,Linkedin,13,637505,91.0,78,Divorciado,42,2015,3,high,102041,Presencial,2.86,1,Hombre,Portal Web,23,1900000,83.0,72,Casado,57,2013,8,high,-0.56,-2,10,1262495,-586,1,15
101905,102065,1,Presencial,3.98,1,Hombre,Portal Web,5,637519,91.0,69,Viudo,42,2015,2,high,102026,Presencial,2.44,2,Hombre,Ferias & Networking,13,1616000,45.0,60,Divorciado,35,2014,10,low,-1.54,1,8,978481,-128,1,-7
101381,102134,1,Presencial,2.47,3,Hombre,Portal Web,16,654393,91.0,85,Viudo,52,2023,3,high,102135,Presencial,2.25,2,Hombre,Portal Web,5,1358450,90.0,69,Viudo,31,2012,7,high,-0.2200000000000002,-1,-11,704057,-3902,1,-21
100380,102118,1,Presencial,1.56,2,Hombre,Linkedin,10,658648,91.0,78,Viudo,48,2020,10,high,102171,Presencial,4.76,17,Mujer,Linkedin,4,1616000,86.0,74,Soltero,39,2023,8,high,3.1999999999999997,15,-6,957352,1034,0,-9
100358,102063,1,Presencial,1.585,2,Mujer,Linkedin,8,874696,91.0,83,Casado,46,2017,7,high,102135,Presencial,2.73,0,Mujer,Linkedin,1,539000,26.0,75,Soltero,24,2021,4,low,1.145,-2,-7,-335696,1375,0,-22
101403,102016,1,Presencial,2.46,1,Hombre,Portal Web,16,662510,91.0,74,Casado,41,2013,5,high,102008,Híbrida,2.51,2,Mujer,Portal Web,6,1616000,40.0,80,Casado,44,2017,8,low,0.04999999999999982,1,-10,953490,1563,0,3
101579,102014,1,Presencial,3.46,8,Mujer,Linkedin,8,780585,91.0,74,Viudo,41,2012,7,high,102096,Presencial,1.78,1,Mujer,Portal Web,2,488000,98.0,78,Soltero,25,2023,1,high,-1.68,-7,-6,-292585,3834,0,-16
100776,102103,1,Presencial,4.68,2,Hombre,Portal Web,3,674558,91.0,74,Divorciado,49,2020,2,high,102023,Presencial,1.69,6,Hombre,Portal Web,3,1616000,90.0,74,Casado,45,2013,5,high,-2.9899999999999998,4,0,941442,-2454,1,-4
101427,102070,1,Presencial,2.905,2,Hombre,Portal Web,13,857862,91.0,75,Viudo,44,2015,4,high,102035,Presencial,1.7,1,Mujer,Referidos,4,1616000,77.0,73,Viudo,38,2013,3,low,-1.2049999999999998,-1,-9,758138,-776,1,-6
101074,102112,1,Presencial,2.135,3,Mujer,Linkedin,5,694744,91.0,91,Divorciado,48,2018,7,high,102031,Presencial,2.27,7,Hombre,Linkedin,1,692000,83.0,74,Soltero,26,2020,6,high,0.13500000000000023,4,-4,-2744,709,0,-22
101727,102162,1,Presencial,1.27,2,Mujer,Portal Web,9,733623,91.0,84,Casado,54,2022,12,high,102146,Presencial,1.12,0,Mujer,Referidos,9,1616000,31.0,74,Casado,41,2022,11,low,-0.1499999999999999,-2,0,882377,-12,1,-13
101423,102071,1,Presencial,2.865,10,Hombre,Portal Web,11,737903,91.0,77,Soltero,49,2017,6,high,102171,Presencial,0.87,1,Hombre,Portal Web,11,1616000,85.0,72,Viudo,51,2023,11,high,-1.995,-9,0,878097,2332,0,2
100523,102103,1,Presencial,5.54,3,Hombre,Linkedin,14,741382,91.0,84,Divorciado,52,2020,4,high,102023,Presencial,1.69,6,Hombre,Portal Web,3,1616000,90.0,74,Casado,45,2013,5,high,-3.85,3,-11,874618,-2519,1,-7
100541,102113,1,Presencial,3.33,2,Hombre,Ferias & Networking,4,794077,91.0,73,Viudo,52,2019,8,high,102041,Presencial,2.96,2,Hombre,Portal Web,6,1152410,46.0,75,Casado,27,2012,1,low,-0.3700000000000001,0,2,358333,-2754,1,-25
101413,102112,1,Presencial,1.3,1,Mujer,Portal Web,8,733583,91.0,82,Divorciado,51,2018,7,high,102031,Presencial,2.27,7,Hombre,Linkedin,1,692000,83.0,74,Soltero,26,2020,6,high,0.97,6,-7,-41583,700,0,-25
100563,102061,1,Presencial,5.37,1,Mujer,Referidos,19,735879,91.0,71,Divorciado,48,2016,8,high,102115,Presencial,2.14,2,Hombre,Ferias & Networking,10,1203920,37.0,80,Casado,29,2012,11,low,-3.23,1,-9,468041,-1370,1,-19
101508,102018,1,Presencial,4.995,3,Mujer,Portal Web,7,735398,91.0,76,Divorciado,45,2013,4,high,102160,Presencial,5.57,5,Hombre,Portal Web,3,692000,90.0,69,Divorciado,28,2022,2,high,0.5750000000000002,2,-4,-43398,3230,0,-17
100214,102003,1,Presencial,2.27,4,Hombre,Linkedin,19,737789,91.0,79,Casado,44,2012,3,high,102130,Presencial,4.05,12,Hombre,Portal Web,8,1616000,83.0,82,Divorciado,49,2023,2,high,1.7799999999999998,8,-11,878211,4004,0,5
100147,102145,1,Presencial,2.22,2,Hombre,Portal Web,9,860804,91.0,82,Casado,57,2022,11,high,102116,Presencial,1.43,1,Mujer,Portal Web,3,692000,89.0,73,Viudo,23,2016,12,high,-0.7900000000000003,-1,-6,-168804,-2164,1,-34
100554,102134,1,Presencial,3.81,0,Mujer,Referidos,18,894605,91.0,69,Casado,56,2022,2,high,102135,Presencial,2.25,2,Hombre,Portal Web,5,1358450,90.0,69,Viudo,31,2012,7,high,-1.56,2,-13,463845,-3493,1,-25
102448,102061,1,Presencial,1.775,3,Hombre,Ferias & Networking,1,96258,91.0,72,Soltero,12,2014,3,high,102115,Presencial,2.14,2,Hombre,Ferias & Networking,10,1203920,37.0,80,Casado,29,2012,11,low,0.3650000000000002,-1,9,1107662,-494,1,17
104142,102128,1,Presencial,4.15,5,Hombre,Portal Web,2,101612,91.0,81,Soltero,20,2022,2,high,102056,Presencial,4.11,10,Mujer,Portal Web,16,1616000,46.0,72,Soltero,55,2021,2,low,-0.040000000000000036,5,14,1514388,-375,1,35
103918,102134,1,Presencial,2.365,1,Mujer,Linkedin,2,143747,91.0,75,Soltero,22,2022,6,high,102135,Presencial,2.25,2,Hombre,Portal Web,5,1358450,90.0,69,Viudo,31,2012,7,high,-0.11500000000000021,1,3,1214703,-3639,1,9
103957,102126,1,Presencial,7.035,2,Hombre,Portal Web,3,143590,91.0,71,Soltero,21,2020,11,high,102141,Presencial,2.5,1,Mujer,Referidos,2,1049000,94.0,79,Casado,34,2021,1,high,-4.535,-1,-1,905410,61,0,13
103141,102094,1,Presencial,3.925,3,Mujer,Linkedin,2,140037,91.0,81,Casado,18,2017,9,high,102095,Presencial,1.32,1,Hombre,Portal Web,4,998000,90.0,85,Casado,28,2016,2,high,-2.6049999999999995,-2,2,857963,-595,1,10
102676,102017,1,Presencial,1.665,0,Mujer,Portal Web,1,147227,91.0,75,Soltero,13,2012,5,high,102035,Presencial,4.62,0,Mujer,Linkedin,2,641000,90.0,84,Casado,25,2019,11,high,2.955,0,1,493773,2727,0,12
102835,102080,1,Presencial,1.545,1,Mujer,Portal Web,1,143000,91.0,78,Soltero,18,2017,11,high,102035,Presencial,1.93,0,Mujer,Linkedin,18,1616000,94.0,75,Viudo,47,2016,8,high,0.385,-1,17,1473000,-469,1,29
102873,102047,1,Presencial,3.145,3,Hombre,Portal Web,1,162171,91.0,78,Soltero,17,2015,3,high,102089,Presencial,2.67,1,Hombre,Linkedin,4,743000,14.0,70,Casado,22,2015,11,low,-0.4750000000000001,-2,3,580829,255,0,5
104025,102035,1,Presencial,1.845,7,Hombre,Portal Web,4,160588,91.0,69,Soltero,15,2012,8,high,102041,Presencial,2.86,1,Hombre,Portal Web,23,1900000,83.0,72,Casado,57,2013,8,high,1.015,-6,19,1739412,368,0,42
102580,102130,1,Presencial,1.295,2,Hombre,Linkedin,5,207882,91.0,70,Soltero,27,2021,12,high,102068,Presencial,1.97,6,Hombre,Linkedin,5,1616000,84.0,73,Soltero,31,2014,4,high,0.675,4,0,1408118,-2781,1,4
104143,102127,1,Presencial,1.375,8,Hombre,Linkedin,1,210470,91.0,80,Casado,25,2019,10,high,102028,Presencial,4.03,2,Mujer,Linkedin,9,1306940,88.0,78,Divorciado,32,2014,5,high,2.6550000000000002,-6,8,1096470,-1961,1,7
102469,102147,1,Presencial,1.525,1,Hombre,Referidos,6,244964,91.0,67,Casado,28,2022,1,high,102057,Presencial,1.58,2,Hombre,Portal Web,4,1616000,90.0,80,Casado,49,2022,12,high,0.05500000000000016,1,-2,1371036,339,0,21
102406,102107,1,Presencial,3.69,5,Mujer,Portal Web,2,251636,91.0,84,Casado,27,2020,6,high,102069,Presencial,2.4,1,Mujer,Linkedin,8,1616000,47.0,79,Casado,63,2023,6,low,-1.29,-4,6,1364364,1109,0,36
102686,102069,1,Presencial,8.085,2,Mujer,Ferias & Networking,7,269545,91.0,63,Soltero,23,2015,1,high,102069,Presencial,4.64,1,Mujer,Ferias & Networking,19,1616000,47.0,74,Casado,60,2021,10,low,-3.445000000000001,-1,12,1346455,2459,0,37
102444,102111,1,Presencial,1.095,2,Mujer,Portal Web,4,290363,91.0,67,Divorciado,27,2018,4,high,102097,Híbrida,2.04,1,Mujer,Referidos,15,1616000,94.0,67,Soltero,50,2021,5,high,0.9450000000000001,-1,11,1325637,1136,0,23
102404,102080,1,Presencial,1.695,1,Mujer,Referidos,3,331314,91.0,76,Soltero,27,2016,8,high,102035,Presencial,1.93,0,Mujer,Linkedin,18,1616000,94.0,75,Viudo,47,2016,8,high,0.23499999999999988,-1,15,1284686,-14,1,20
103462,102042,1,Presencial,1.695,2,Mujer,Referidos,7,310291,91.0,91,Soltero,25,2015,8,high,102107,Presencial,2.19,2,Hombre,Ferias & Networking,8,1616000,38.0,78,Divorciado,57,2018,6,low,0.4949999999999999,0,1,1305709,1046,0,32
102557,102106,1,Presencial,2.33,1,Mujer,Referidos,6,328785,91.0,79,Casado,30,2019,1,high,102081,Presencial,1.39,1,Mujer,Ferias & Networking,5,1049000,86.0,86,Soltero,32,2019,6,high,-0.9400000000000002,0,-1,720215,139,0,2
102947,102038,1,Presencial,1.42,2,Mujer,Portal Web,2,346016,91.0,70,Casado,27,2015,6,high,102125,Presencial,2.06,1,Hombre,Portal Web,12,1616000,81.0,82,Casado,44,2018,1,high,0.6400000000000001,-1,10,1269984,953,0,17
103703,102171,1,Presencial,2.36,1,Mujer,Portal Web,6,368568,91.0,66,Soltero,36,2023,5,high,102088,Presencial,2.57,4,Hombre,Linkedin,8,1616000,80.0,69,Casado,43,2017,10,high,0.20999999999999996,3,2,1247432,-2053,1,7
102843,102050,1,Presencial,1.935,0,Hombre,Portal Web,2,373395,91.0,78,Soltero,27,2014,6,high,102069,Presencial,3.7,0,Mujer,Linkedin,11,1512980,90.0,88,Soltero,40,2017,10,high,1.7650000000000001,0,9,1139585,1216,0,13
103070,102060,1,Presencial,2.215,2,Mujer,Linkedin,9,370329,91.0,85,Casado,27,2014,4,high,102041,Presencial,4.42,3,Hombre,Referidos,16,1616000,82.0,62,Casado,45,2013,10,high,2.205,1,7,1245671,-158,1,18
103129,102148,1,Presencial,2.125,2,Mujer,Referidos,3,771946,91.0,83,Casado,35,2021,6,high,102116,Presencial,1.49,2,Mujer,Portal Web,2,539000,80.0,67,Soltero,26,2022,12,high,-0.635,0,-1,-232946,529,0,-9
103155,102110,1,Presencial,2.825,1,Hombre,Referidos,11,412002,91.0,71,Casado,33,2018,5,high,102045,Presencial,1.6,5,Mujer,Linkedin,2,998000,87.0,76,Soltero,29,2016,11,high,-1.225,4,-9,585998,-549,1,-4
102214,102058,1,Presencial,3.9,0,Hombre,Linkedin,6,412788,91.0,76,Soltero,30,2015,3,high,102172,Presencial,1.4,2,Hombre,Ferias & Networking,11,1616000,75.0,71,Casado,59,2021,2,low,-2.5,2,5,1203212,2183,0,29
103936,102090,1,Presencial,1.69,12,Mujer,Linkedin,5,429502,91.0,81,Soltero,33,2016,12,high,102171,Presencial,6.83,0,Hombre,Linkedin,4,488000,92.0,76,Soltero,19,2017,2,high,5.140000000000001,-12,-1,58498,66,0,-14
102760,102038,1,Presencial,1.71,0,Hombre,Headhunter,4,771040,91.0,81,Casado,31,2015,2,high,102125,Presencial,2.06,1,Hombre,Portal Web,12,1616000,81.0,82,Casado,44,2018,1,high,0.3500000000000001,1,8,844960,1062,0,13
103288,102149,1,Presencial,2.45,2,Hombre,Referidos,9,447709,91.0,72,Casado,38,2021,3,high,102141,Presencial,2.07,0,Mujer,Headhunter,3,1409960,90.0,86,Casado,37,2017,2,high,-0.38000000000000034,-2,-6,962251,-1491,1,-1
103427,102122,1,Presencial,1.62,11,Mujer,Portal Web,4,467720,91.0,80,Casado,39,2021,7,high,102075,Presencial,1.83,4,Hombre,Portal Web,6,1616000,90.0,66,Viudo,48,2019,3,high,0.20999999999999996,-7,2,1148280,-863,1,9
102494,102132,1,Presencial,5.52,2,Hombre,Portal Web,6,770028,91.0,68,Divorciado,39,2020,10,high,102138,Presencial,4.51,1,Hombre,Linkedin,16,1616000,25.0,80,Viudo,45,2014,3,low,-1.0099999999999998,-1,10,845972,-2412,1,6
104063,102124,1,Presencial,1.57,0,Hombre,Linkedin,7,767181,91.0,65,Soltero,37,2019,5,high,102099,Presencial,2.84,2,Mujer,Linkedin,4,947000,90.0,70,Soltero,24,2012,10,high,1.2699999999999998,2,-3,179819,-2391,1,-13
102271,102061,1,Presencial,1.875,0,Hombre,Referidos,2,472961,91.0,78,Casado,34,2016,11,high,102115,Presencial,2.14,2,Hombre,Ferias & Networking,10,1203920,37.0,80,Casado,29,2012,11,low,0.2650000000000001,2,8,730959,-1467,1,-5
102577,102091,1,Presencial,1.525,2,Mujer,Referidos,13,248472,91.0,72,Soltero,38,2018,10,high,102149,Presencial,1.54,1,Mujer,Portal Web,4,1616000,73.0,77,Casado,39,2014,12,low,0.015000000000000124,-1,-9,1367528,-1375,1,1
103441,102092,1,Presencial,2.855,2,Hombre,Ferias & Networking,12,256770,91.0,79,Soltero,40,2019,6,high,102120,Presencial,1.23,6,Mujer,Linkedin,13,1616000,98.0,95,Viudo,41,2013,6,high,-1.625,4,1,1359230,-2197,1,1
103128,102065,1,Presencial,3.78,1,Mujer,Portal Web,6,507514,91.0,77,Casado,35,2014,11,high,102026,Presencial,2.44,2,Hombre,Ferias & Networking,13,1616000,45.0,60,Divorciado,35,2014,10,low,-1.3399999999999999,1,7,1108486,-44,1,0
103413,102052,1,Presencial,4.57,7,Mujer,Portal Web,13,525106,91.0,78,Casado,34,2013,12,high,102093,Presencial,4.45,0,Hombre,Linkedin,5,641000,84.0,76,Divorciado,17,2012,4,high,-0.1200000000000001,-7,-8,115894,-637,1,-17
103661,102107,1,Presencial,1.775,9,Hombre,Portal Web,9,258249,91.0,70,Casado,40,2019,3,high,102069,Presencial,2.4,1,Mujer,Linkedin,8,1616000,47.0,79,Casado,63,2023,6,low,0.625,-8,-1,1357751,1554,0,23
102887,102040,1,Presencial,1.3,2,Mujer,Linkedin,5,258748,91.0,76,Casado,36,2014,5,high,102106,Presencial,3.21,1,Hombre,Linkedin,15,1616000,91.0,84,Soltero,45,2016,7,high,1.91,-1,10,1357252,811,0,9
102830,102092,1,Presencial,5.515,9,Mujer,Linkedin,4,388285,91.0,75,Casado,42,2019,1,high,102120,Presencial,1.23,6,Mujer,Linkedin,13,1616000,98.0,95,Viudo,41,2013,6,high,-4.285,-3,9,1227715,-2033,1,-1
103062,102024,1,Presencial,1.31,3,Hombre,Ferias & Networking,4,281451,91.0,74,Casado,37,2013,7,high,102074,Presencial,2.28,0,Hombre,Headhunter,9,1616000,84.0,70,Casado,48,2018,3,high,0.9699999999999998,-3,5,1334549,1691,0,11
104043,102154,1,Presencial,6.57,3,Mujer,Portal Web,11,285923,91.0,82,Soltero,47,2022,10,high,102172,Presencial,5.45,1,Hombre,Portal Web,7,1512980,93.0,69,Soltero,39,2017,10,high,-1.12,-2,-4,1227057,-1840,1,-8
102840,102152,1,Presencial,1.225,2,Hombre,Linkedin,4,408102,91.0,70,Casado,46,2021,10,high,102089,Presencial,2.75,5,Hombre,Portal Web,7,1616000,15.0,68,Soltero,47,2019,8,low,1.525,3,3,1207898,-768,1,1
104120,102127,1,Presencial,5.83,3,Hombre,Portal Web,9,285546,91.0,83,Casado,44,2019,7,high,102028,Presencial,4.03,2,Mujer,Linkedin,9,1306940,88.0,78,Divorciado,32,2014,5,high,-1.7999999999999998,-1,0,1021394,-1871,1,-12
103785,102026,1,Presencial,1.445,7,Mujer,Linkedin,5,453463,91.0,71,Soltero,38,2014,3,high,102101,Presencial,2.7,1,Mujer,Portal Web,15,1616000,97.0,79,Casado,58,2017,6,high,1.2550000000000001,-6,10,1162537,1202,0,20
102618,102160,1,Presencial,2.49,0,Hombre,Linkedin,3,300358,91.0,75,Divorciado,48,2022,3,high,102087,Presencial,2.21,0,Hombre,Portal Web,3,794000,83.0,78,Casado,28,2019,8,high,-0.28000000000000025,0,0,493642,-928,1,-20
102642,102137,1,Presencial,7.555,0,Mujer,Linkedin,6,453296,91.0,80,Casado,47,2021,5,high,102046,Presencial,1.18,0,Mujer,Portal Web,2,845000,37.0,79,Casado,27,2017,12,low,-6.375,0,-4,391704,-1244,1,-20
102475,102036,1,Presencial,2.63,1,Hombre,Portal Web,16,298518,91.0,79,Casado,37,2012,7,high,102054,Presencial,1.68,8,Hombre,Portal Web,5,1616000,92.0,76,Viudo,54,2022,1,high,-0.95,7,-11,1317482,3452,0,17
102735,102090,1,Presencial,1.98,0,Hombre,Referidos,13,460867,91.0,70,Viudo,46,2019,9,high,102171,Presencial,6.83,0,Hombre,Linkedin,4,488000,92.0,76,Soltero,19,2017,2,high,4.85,0,-9,27133,-943,1,-27
102322,102082,1,Presencial,2.415,2,Mujer,Ferias & Networking,16,415486,91.0,71,Divorciado,45,2018,9,high,102050,Presencial,5.5,2,Mujer,Linkedin,7,1616000,81.0,70,Casado,36,2018,8,high,3.085,0,-9,1200514,-43,1,-9
103488,102085,1,Presencial,6.045,6,Mujer,Portal Web,13,815205,91.0,79,Casado,45,2018,7,high,102145,Presencial,6.59,4,Hombre,Portal Web,12,1616000,47.0,71,Casado,39,2015,8,low,0.5449999999999999,-2,-1,800795,-1064,1,-6
102452,102053,1,Presencial,2.47,1,Hombre,Headhunter,11,306906,91.0,69,Soltero,40,2014,4,high,102030,Presencial,1.29,0,Hombre,Portal Web,11,1616000,81.0,64,Soltero,36,2012,12,high,-1.1800000000000002,-1,0,1309094,-472,1,-4
103240,102015,1,Presencial,14.005,1,Mujer,Portal Web,12,306377,91.0,72,Soltero,39,2013,1,high,102121,Presencial,6.18,1,Mujer,Referidos,10,1358450,74.0,82,Soltero,33,2014,6,low,-7.825000000000001,0,-2,1052073,520,0,-6
102250,102032,1,Presencial,2.905,2,Hombre,Portal Web,13,311924,91.0,69,Viudo,39,2012,10,high,102065,Presencial,1.78,7,Hombre,Portal Web,14,1616000,42.0,71,Casado,42,2015,11,low,-1.1249999999999998,5,1,1304076,1121,0,3
102460,102058,1,Presencial,5.84,3,Hombre,Ferias & Networking,10,835411,91.0,70,Casado,44,2017,2,high,102172,Presencial,1.4,2,Hombre,Ferias & Networking,11,1616000,75.0,71,Casado,59,2021,2,low,-4.4399999999999995,-1,1,780589,1456,0,15
103041,102069,1,Presencial,1.725,1,Hombre,Ferias & Networking,6,636952,91.0,80,Viudo,43,2015,11,high,102069,Presencial,4.64,1,Mujer,Ferias & Networking,19,1616000,47.0,74,Casado,60,2021,10,low,2.9149999999999996,0,13,979048,2182,0,17
102246,102048,1,Presencial,2.835,1,Mujer,Referidos,5,658614,91.0,75,Casado,41,2013,7,high,102092,Presencial,3.99,0,Mujer,Portal Web,5,590000,59.0,76,Soltero,20,2015,8,low,1.1550000000000002,-1,0,-68614,781,0,-21
102800,102016,1,Presencial,2.465,1,Hombre,Portal Web,16,662350,91.0,74,Casado,41,2013,5,high,102008,Híbrida,2.51,2,Mujer,Portal Web,6,1616000,40.0,80,Casado,44,2017,8,low,0.04499999999999993,1,-10,953650,1565,0,3
103004,102147,1,Presencial,1.555,6,Hombre,Portal Web,10,799675,91.0,80,Casado,53,2023,2,high,102057,Presencial,1.58,2,Hombre,Portal Web,4,1616000,90.0,80,Casado,49,2022,12,high,0.025000000000000133,-4,-6,816325,-52,1,-4
103162,102071,1,Presencial,2.85,9,Hombre,Portal Web,11,735305,91.0,77,Soltero,49,2017,6,high,102171,Presencial,0.87,1,Hombre,Portal Web,11,1616000,85.0,72,Viudo,51,2023,11,high,-1.98,-8,0,880695,2335,0,2
103214,102057,1,Presencial,3.315,11,Hombre,Portal Web,16,714645,91.0,72,Casado,46,2015,4,high,102019,Presencial,1.97,4,Hombre,Portal Web,5,1616000,90.0,73,Viudo,59,2022,12,high,-1.345,-7,-11,901355,2801,0,13
103428,102061,1,Presencial,1.955,2,Mujer,Linkedin,9,917286,91.0,81,Divorciado,45,2014,9,high,102115,Presencial,2.14,2,Hombre,Ferias & Networking,10,1203920,37.0,80,Casado,29,2012,11,low,0.18500000000000005,0,1,286634,-661,1,-16
102919,102164,1,Presencial,1.085,1,Hombre,Linkedin,5,734316,91.0,65,Soltero,56,2023,4,high,102109,Presencial,3.78,2,Hombre,Linkedin,7,1461470,83.0,77,Casado,40,2018,9,high,2.695,1,2,727154,-1650,1,-16
102622,102113,1,Presencial,3.285,1,Hombre,Ferias & Networking,4,797022,91.0,73,Viudo,52,2019,8,high,102041,Presencial,2.96,2,Hombre,Portal Web,6,1152410,46.0,75,Casado,27,2012,1,low,-0.3250000000000002,1,2,355388,-2755,1,-25
103586,102113,1,Presencial,2.215,0,Mujer,Portal Web,11,736297,91.0,75,Soltero,51,2018,12,high,102041,Presencial,2.96,2,Hombre,Portal Web,6,1152410,46.0,75,Casado,27,2012,1,low,0.7450000000000001,2,-5,416113,-2528,1,-24
103049,102064,1,Presencial,6.315,5,Hombre,Portal Web,3,736348,91.0,77,Viudo,48,2016,5,high,102067,Presencial,1.34,0,Hombre,Portal Web,6,1616000,92.0,92,Casado,43,2018,2,high,-4.9750000000000005,-5,3,879652,635,0,-5
103819,102044,1,Presencial,1.65,10,Mujer,Portal Web,8,738895,91.0,78,Viudo,45,2013,9,high,102155,Presencial,1.54,1,Hombre,Ferias & Networking,14,1616000,56.0,68,Soltero,47,2023,3,low,-0.10999999999999988,-9,6,877105,3468,0,2
103714,102133,1,Presencial,1.685,10,Mujer,Portal Web,9,820100,91.0,76,Divorciado,55,2022,12,high,102151,Híbrida,2.61,2,Hombre,Linkedin,4,1255430,98.0,65,Soltero,35,2018,2,high,0.9249999999999998,-8,-5,435330,-1751,1,-20
102319,102047,1,Presencial,6.445,1,Hombre,Linkedin,7,818221,91.0,63,Viudo,49,2015,4,high,102089,Presencial,2.67,1,Hombre,Linkedin,4,743000,14.0,70,Casado,22,2015,11,low,-3.7750000000000004,0,-3,-75221,220,0,-27
100015,102128,1,Presencial,4.145,6,Hombre,Portal Web,2,97471,90.0,81,Soltero,20,2022,2,high,102056,Presencial,4.11,10,Mujer,Portal Web,16,1616000,46.0,72,Soltero,55,2021,2,low,-0.034999999999999254,4,14,1518529,-376,1,35
101920,102146,1,Presencial,2.225,3,Mujer,Linkedin,1,99008,90.0,81,Soltero,19,2021,3,high,102035,Presencial,2.66,0,Mujer,Portal Web,15,1616000,77.0,78,Casado,39,2013,10,low,0.43500000000000005,-3,14,1516992,-2703,1,20
100226,102019,1,Presencial,2.865,1,Hombre,Referidos,2,97929,90.0,85,Soltero,12,2013,4,high,102129,Presencial,2.59,7,Mujer,Portal Web,4,488000,90.0,74,Soltero,24,2021,6,high,-0.27500000000000036,6,2,390071,2989,0,12
100770,102047,1,Presencial,2.145,0,Hombre,Portal Web,3,116598,90.0,77,Soltero,13,2013,9,high,102089,Presencial,2.67,1,Hombre,Linkedin,4,743000,14.0,70,Casado,22,2015,11,low,0.5249999999999999,1,1,626402,794,0,9
100995,102080,1,Presencial,5.225,3,Mujer,Referidos,3,143024,90.0,79,Soltero,18,2018,9,high,102035,Presencial,1.93,0,Mujer,Linkedin,18,1616000,94.0,75,Viudo,47,2016,8,high,-3.295,-3,15,1472976,-757,1,29
100785,102064,1,Presencial,1.825,0,Mujer,Linkedin,1,135834,90.0,81,Divorciado,15,2015,3,high,102067,Presencial,1.34,0,Hombre,Portal Web,6,1616000,92.0,92,Casado,43,2018,2,high,-0.4849999999999999,0,5,1480166,1047,0,28
100478,102078,1,Presencial,1.71,0,Mujer,Portal Web,4,161382,90.0,79,Soltero,17,2015,6,high,102143,Presencial,2.17,1,Hombre,Ferias & Networking,9,998000,83.0,76,Casado,29,2017,5,high,0.45999999999999996,1,5,836618,718,0,12
100371,102162,1,Presencial,4.615,0,Mujer,Portal Web,4,164522,90.0,76,Soltero,25,2023,4,high,102146,Presencial,1.12,0,Mujer,Referidos,9,1616000,31.0,74,Casado,41,2022,11,low,-3.495,0,5,1451478,-145,1,16
101768,102076,1,Presencial,1.535,0,Mujer,Linkedin,2,165463,90.0,76,Soltero,20,2017,7,high,102168,Híbrida,1.95,1,Hombre,Referidos,9,1616000,95.0,82,Soltero,53,2023,9,high,0.41500000000000004,1,7,1450537,2241,0,33
101734,102049,1,Presencial,2.21,2,Hombre,Referidos,2,161987,90.0,84,Soltero,18,2015,12,high,102029,Presencial,6.89,0,Mujer,Portal Web,9,1616000,19.0,77,Divorciado,49,2023,3,low,4.68,-2,7,1454013,2650,0,31
100116,102049,1,Presencial,3.645,3,Mujer,Portal Web,4,185575,90.0,83,Soltero,18,2015,4,high,102029,Presencial,6.89,0,Mujer,Portal Web,9,1616000,19.0,77,Divorciado,49,2023,3,low,3.2449999999999997,-3,5,1430425,2895,0,31
100356,102053,1,Presencial,6.505,1,Hombre,Ferias & Networking,2,188491,90.0,75,Divorciado,17,2014,6,high,102030,Presencial,1.29,0,Hombre,Portal Web,11,1616000,81.0,64,Soltero,36,2012,12,high,-5.215,-1,9,1427509,-544,1,19
100678,102130,1,Presencial,2.295,1,Mujer,Referidos,4,193012,90.0,72,Casado,27,2022,11,high,102068,Presencial,1.97,6,Hombre,Linkedin,5,1616000,84.0,73,Soltero,31,2014,4,high,-0.32499999999999996,5,1,1422988,-3116,1,4
101337,102031,1,Presencial,3.15,1,Hombre,Headhunter,1,190622,90.0,68,Soltero,17,2012,12,high,102111,Presencial,2.95,2,Hombre,Portal Web,8,1610000,76.0,87,Casado,31,2017,7,low,-0.19999999999999973,1,7,1419378,1654,0,14
101221,102052,1,Presencial,1.885,9,Mujer,Portal Web,5,212991,90.0,76,Casado,20,2014,11,high,102093,Presencial,4.45,0,Hombre,Linkedin,5,641000,84.0,76,Divorciado,17,2012,4,high,2.5650000000000004,-9,0,428009,-964,1,-3
101464,102022,1,Presencial,1.57,0,Mujer,Portal Web,1,212509,90.0,72,Casado,18,2013,8,high,102081,Presencial,2.07,0,Hombre,Portal Web,6,1616000,94.0,66,Viudo,47,2020,5,high,0.4999999999999998,0,5,1403491,2470,0,29
101108,102008,1,Presencial,4.17,6,Hombre,Linkedin,5,206756,90.0,75,Casado,17,2012,10,high,102107,Presencial,3.99,1,Mujer,Linkedin,7,405435,90.0,82,Soltero,39,2023,1,high,-0.17999999999999972,-5,2,198679,3755,0,22
101618,102114,1,Presencial,2.23,2,Hombre,Portal Web,2,229241,90.0,75,Soltero,28,2021,6,high,102050,Presencial,1.44,1,Mujer,Portal Web,5,1616000,91.0,69,Divorciado,47,2021,5,high,-0.79,-1,3,1386759,-20,1,19
101796,102147,1,Presencial,1.495,2,Hombre,Referidos,6,252626,90.0,67,Casado,29,2022,1,high,102057,Presencial,1.58,2,Hombre,Portal Web,4,1616000,90.0,80,Casado,49,2022,12,high,0.08499999999999996,0,-2,1363374,337,0,20
101996,102151,1,Presencial,2.12,1,Mujer,Linkedin,2,251588,90.0,75,Soltero,28,2021,11,high,102105,Presencial,1.51,2,Hombre,Ferias & Networking,10,1616000,85.0,80,Divorciado,45,2021,11,high,-0.6100000000000001,1,8,1364412,13,0,17
100460,102017,1,Presencial,1.74,0,Hombre,Portal Web,5,250793,90.0,82,Soltero,21,2013,9,high,102035,Presencial,4.62,0,Mujer,Linkedin,2,641000,90.0,84,Casado,25,2019,11,high,2.88,0,-3,390207,2251,0,4
102143,102142,2,Presencial,1.07,2,Hombre,Portal Web,2,590000,90.0,78,Casado,25,2022,2,high,102047,Presencial,2.48,2,Hombre,Portal Web,3,1255430,90.0,66,Soltero,36,2019,7,high,1.41,0,1,665430,-939,1,11
100606,102142,1,Presencial,5.675,2,Mujer,Referidos,6,269081,90.0,75,Divorciado,31,2022,12,high,102047,Presencial,2.48,2,Hombre,Portal Web,3,1255430,90.0,66,Soltero,36,2019,7,high,-3.195,0,-3,986349,-1259,1,5
102139,102154,2,Presencial,6.48,1,Hombre,Ferias & Networking,5,590000,90.0,67,Casado,25,2021,6,high,102172,Presencial,5.45,1,Hombre,Portal Web,7,1512980,93.0,69,Soltero,39,2017,10,high,-1.0300000000000002,0,2,922980,-1357,1,14
100528,102154,1,Presencial,3.51,1,Hombre,Referidos,4,308372,90.0,69,Soltero,33,2023,4,high,102172,Presencial,5.45,1,Hombre,Portal Web,7,1512980,93.0,69,Soltero,39,2017,10,high,1.9400000000000004,0,3,1204608,-2021,1,6
100196,102137,1,Presencial,2.34,1,Mujer,Linkedin,8,309845,90.0,78,Casado,34,2023,4,high,102046,Presencial,1.18,0,Mujer,Portal Web,2,845000,37.0,79,Casado,27,2017,12,low,-1.16,-1,-6,535155,-1943,1,-7
100875,102114,1,Presencial,4.52,1,Mujer,Linkedin,7,311976,90.0,78,Soltero,28,2018,7,high,102050,Presencial,1.44,1,Mujer,Portal Web,5,1616000,91.0,69,Divorciado,47,2021,5,high,-3.0799999999999996,0,-2,1304024,1053,0,19
100125,102083,1,Presencial,4.825,1,Mujer,Ferias & Networking,6,305521,90.0,77,Casado,27,2017,3,high,102147,Presencial,1.61,0,Mujer,Portal Web,5,1564490,83.0,71,Soltero,44,2021,2,high,-3.215,-1,-1,1258969,1429,0,17
100552,102057,1,Presencial,2.505,2,Hombre,Linkedin,2,307001,90.0,74,Casado,27,2016,12,high,102019,Presencial,1.97,4,Hombre,Portal Web,5,1616000,90.0,73,Viudo,59,2022,12,high,-0.5349999999999999,2,3,1308999,2211,0,32
100778,102042,1,Presencial,1.675,2,Mujer,Referidos,7,308184,90.0,91,Soltero,26,2015,8,high,102107,Presencial,2.19,2,Hombre,Ferias & Networking,8,1616000,38.0,78,Divorciado,57,2018,6,low,0.5149999999999999,0,1,1307816,1047,0,31
100435,102043,1,Presencial,2.325,1,Hombre,Linkedin,5,308845,90.0,81,Soltero,23,2013,1,high,102051,Presencial,1.03,0,Hombre,Portal Web,5,1616000,60.0,76,Casado,44,2019,5,low,-1.2950000000000002,-1,0,1307155,2323,0,21
101429,102094,1,Presencial,1.48,3,Mujer,Referidos,2,330227,90.0,69,Soltero,30,2018,7,high,102095,Presencial,1.32,1,Hombre,Portal Web,4,998000,90.0,85,Casado,28,2016,2,high,-0.15999999999999992,-2,2,667773,-881,1,-2
101596,102038,1,Presencial,1.42,1,Mujer,Portal Web,2,347243,90.0,70,Casado,27,2015,6,high,102125,Presencial,2.06,1,Hombre,Portal Web,12,1616000,81.0,82,Casado,44,2018,1,high,0.6400000000000001,0,10,1268757,955,0,17
101619,102047,1,Presencial,4.375,2,Hombre,Referidos,2,332154,90.0,76,Casado,26,2014,12,high,102089,Presencial,2.67,1,Hombre,Linkedin,4,743000,14.0,70,Casado,22,2015,11,low,-1.705,-1,2,410846,351,0,-4
100020,102043,1,Presencial,0.34,5,Hombre,Portal Web,2,327286,90.0,82,Casado,23,2012,7,high,102051,Presencial,1.03,0,Hombre,Portal Web,5,1616000,60.0,76,Casado,44,2019,5,low,0.69,-5,3,1288714,2509,0,21
100871,102118,1,Presencial,4.265,7,Mujer,Portal Web,3,352267,90.0,83,Soltero,32,2020,3,high,102171,Presencial,4.76,17,Mujer,Linkedin,4,1616000,86.0,74,Soltero,39,2023,8,high,0.4950000000000001,10,1,1263733,1254,0,7
100339,102022,1,Presencial,1.975,2,Hombre,Ferias & Networking,9,351517,90.0,64,Casado,25,2013,3,high,102081,Presencial,2.07,0,Hombre,Portal Web,6,1616000,94.0,66,Viudo,47,2020,5,high,0.09499999999999975,-2,-3,1264483,2623,0,22
100211,102108,1,Presencial,2.585,2,Mujer,Portal Web,7,364626,90.0,80,Casado,32,2018,11,high,102040,Presencial,2.92,1,Mujer,Portal Web,5,1616000,46.0,75,Casado,50,2023,5,low,0.33499999999999996,-1,-2,1251374,1665,0,18
101303,102099,1,Presencial,5.595,2,Hombre,Linkedin,8,788970,90.0,72,Casado,31,2017,1,high,102080,Presencial,1.71,0,Hombre,Portal Web,11,1616000,76.0,80,Viudo,51,2021,10,low,-3.885,-2,3,827030,1731,0,20
100886,102050,1,Presencial,1.94,0,Hombre,Portal Web,2,372813,90.0,78,Soltero,27,2014,6,high,102069,Presencial,3.7,0,Mujer,Linkedin,11,1512980,90.0,88,Soltero,40,2017,10,high,1.7600000000000002,0,9,1140167,1217,0,13
100202,102060,1,Presencial,2.18,3,Mujer,Linkedin,9,366272,90.0,85,Casado,27,2014,4,high,102041,Presencial,4.42,3,Hombre,Referidos,16,1616000,82.0,62,Casado,45,2013,10,high,2.2399999999999998,0,7,1249728,-158,1,18
100972,102156,1,Presencial,1.89,2,Mujer,Portal Web,7,389435,90.0,79,Soltero,37,2023,3,high,102154,Presencial,4.23,2,Hombre,Portal Web,22,1616000,92.0,76,Soltero,63,2023,12,high,2.3400000000000007,0,15,1226565,265,0,26
101438,102148,1,Presencial,1.965,0,Hombre,Portal Web,7,410790,90.0,75,Casado,38,2022,10,high,102116,Presencial,1.49,2,Mujer,Portal Web,2,539000,80.0,67,Soltero,26,2022,12,high,-0.4750000000000001,2,-5,128210,53,0,-12
101190,102144,1,Presencial,3.015,1,Mujer,Ferias & Networking,7,428421,90.0,69,Casado,38,2022,1,high,102156,Presencial,2.13,8,Mujer,Portal Web,11,1616000,5.0,82,Viudo,58,2015,6,low,-0.8850000000000002,7,4,1187579,-2385,1,20
101963,102124,1,Presencial,4.725,4,Mujer,Linkedin,10,445992,90.0,76,Divorciado,38,2021,5,high,102099,Presencial,2.84,2,Mujer,Linkedin,4,947000,90.0,70,Soltero,24,2012,10,high,-1.8849999999999998,-2,-6,501008,-3107,1,-14
101833,102038,1,Presencial,1.715,0,Hombre,Headhunter,4,764500,90.0,81,Casado,31,2015,2,high,102125,Presencial,2.06,1,Hombre,Portal Web,12,1616000,81.0,82,Casado,44,2018,1,high,0.345,1,8,851500,1060,0,13
102094,102095,2,Presencial,1.32,1,Hombre,Portal Web,4,998000,90.0,85,Casado,28,2016,2,high,102171,Presencial,3.28,2,Mujer,Portal Web,3,1616000,80.0,75,Soltero,42,2023,10,high,1.9599999999999997,1,-1,618000,2805,0,14
100095,102095,1,Presencial,1.475,2,Hombre,Portal Web,6,452213,90.0,77,Casado,35,2018,11,high,102171,Presencial,3.28,2,Mujer,Portal Web,3,1616000,80.0,75,Soltero,42,2023,10,high,1.8049999999999997,0,-3,1163787,1793,0,7
100813,102079,1,Presencial,5.375,1,Mujer,Portal Web,4,469946,90.0,78,Soltero,37,2018,10,high,102146,Presencial,2.63,1,Mujer,Portal Web,4,1358450,80.0,81,Soltero,35,2016,3,high,-2.745,0,0,888504,-947,1,-2
100104,102058,1,Presencial,1.735,8,Hombre,Portal Web,5,845102,90.0,71,Casado,33,2014,5,high,102172,Presencial,1.4,2,Hombre,Ferias & Networking,11,1616000,75.0,71,Casado,59,2021,2,low,-0.3350000000000002,-6,6,770898,2483,0,26
102012,102122,2,Presencial,2.09,1,Mujer,Portal Web,7,1100000,90.0,80,Casado,34,2019,7,high,102075,Presencial,1.83,4,Hombre,Portal Web,6,1616000,90.0,66,Viudo,48,2019,3,high,-0.2599999999999998,3,-1,516000,-111,1,14
100987,102122,1,Presencial,5.045,0,Mujer,Ferias & Networking,13,766009,90.0,83,Divorciado,40,2020,6,high,102075,Presencial,1.83,4,Hombre,Portal Web,6,1616000,90.0,66,Viudo,48,2019,3,high,-3.215,4,-7,849991,-464,1,8
100692,102077,1,Presencial,2.87,1,Mujer,Portal Web,11,373245,90.0,77,Soltero,37,2017,2,high,102146,Presencial,2.27,0,Hombre,Ferias & Networking,11,1306940,31.0,64,Soltero,39,2021,6,low,-0.6000000000000001,-1,0,933695,1597,0,2
101256,102092,1,Presencial,2.825,1,Hombre,Ferias & Networking,12,254553,90.0,79,Soltero,40,2019,6,high,102120,Presencial,1.23,6,Mujer,Linkedin,13,1616000,98.0,95,Viudo,41,2013,6,high,-1.5950000000000002,5,1,1361447,-2198,1,1
102020,102134,2,Presencial,6.63,1,Mujer,Linkedin,11,1203920,90.0,78,Casado,35,2018,12,high,102135,Presencial,2.25,2,Hombre,Portal Web,5,1358450,90.0,69,Viudo,31,2012,7,high,-4.38,1,-6,154530,-2342,1,-4
100768,102134,1,Presencial,2.43,2,Hombre,Linkedin,8,254490,90.0,74,Divorciado,44,2022,8,high,102135,Presencial,2.25,2,Hombre,Portal Web,5,1358450,90.0,69,Viudo,31,2012,7,high,-0.18000000000000016,0,-3,1103960,-3697,1,-13
101580,102040,1,Presencial,1.31,2,Mujer,Linkedin,5,259882,90.0,76,Casado,35,2014,5,high,102106,Presencial,3.21,1,Hombre,Linkedin,15,1616000,91.0,84,Soltero,45,2016,7,high,1.9,-1,10,1356118,812,0,10
101433,102046,1,Presencial,5.625,1,Mujer,Ferias & Networking,11,427941,90.0,68,Casado,35,2014,3,high,102007,Presencial,1.68,0,Mujer,Portal Web,8,1616000,41.0,71,Soltero,50,2015,10,low,-3.9450000000000003,-1,-3,1188059,577,0,15
102075,102047,2,Presencial,2.7,1,Hombre,Referidos,11,1255430,90.0,76,Casado,30,2013,3,high,102089,Presencial,2.67,1,Hombre,Linkedin,4,743000,14.0,70,Casado,22,2015,11,low,-0.03000000000000025,0,-7,-512430,970,0,-8
102142,102047,2,Presencial,2.48,2,Hombre,Portal Web,3,1255430,90.0,66,Soltero,36,2019,7,high,102089,Presencial,2.67,1,Hombre,Linkedin,4,743000,14.0,70,Casado,22,2015,11,low,0.18999999999999995,-1,1,-512430,-1324,1,-14
101296,102047,1,Presencial,2.81,3,Hombre,Portal Web,12,271423,90.0,85,Casado,36,2013,10,high,102089,Presencial,2.67,1,Hombre,Linkedin,4,743000,14.0,70,Casado,22,2015,11,low,-0.14000000000000012,-2,-8,471577,767,0,-14
100347,102017,1,Presencial,1.32,3,Hombre,Linkedin,10,265853,90.0,75,Soltero,35,2013,2,high,102035,Presencial,4.62,0,Mujer,Linkedin,2,641000,90.0,84,Casado,25,2019,11,high,3.3,-3,-8,375147,2450,0,-10
101340,102009,1,Presencial,2.095,1,Mujer,Portal Web,7,459130,90.0,82,Casado,35,2012,11,high,102116,Presencial,2.06,2,Hombre,Referidos,9,1461470,90.0,73,Casado,44,2022,8,high,-0.03500000000000014,1,2,1002340,3541,0,9
101398,102111,1,Presencial,1.92,1,Hombre,Linkedin,14,273703,90.0,76,Casado,42,2018,5,high,102097,Híbrida,2.04,1,Mujer,Referidos,15,1616000,94.0,67,Soltero,50,2021,5,high,0.1200000000000001,0,1,1342297,1090,0,8
101141,102085,1,Presencial,5.185,4,Hombre,Portal Web,13,284634,90.0,81,Divorciado,41,2017,5,high,102145,Presencial,6.59,4,Hombre,Portal Web,12,1616000,47.0,71,Casado,39,2015,8,low,1.4050000000000002,0,-1,1331366,-657,1,-2
101364,102039,1,Presencial,4.94,20,Mujer,Portal Web,15,415036,90.0,81,Soltero,38,2013,12,high,102054,Presencial,3.66,0,Hombre,Referidos,5,1616000,93.0,75,Viudo,49,2018,6,high,-1.2800000000000002,-20,-10,1200964,1646,0,11
102149,102141,2,Presencial,2.07,0,Mujer,Headhunter,3,1409960,90.0,86,Casado,37,2017,2,high,102134,Presencial,1.88,1,Mujer,Linkedin,3,1100900,64.0,69,Soltero,32,2018,5,low,-0.18999999999999995,1,0,-309060,456,0,-5
101233,102141,1,Presencial,6.745,11,Hombre,Portal Web,4,301020,90.0,63,Divorciado,47,2022,4,high,102134,Presencial,1.88,1,Mujer,Linkedin,3,1100900,64.0,69,Soltero,32,2018,5,low,-4.865,-10,-1,799880,-1410,1,-15
100828,102160,1,Presencial,2.5,1,Hombre,Linkedin,3,301026,90.0,75,Divorciado,47,2022,3,high,102087,Presencial,2.21,0,Hombre,Portal Web,3,794000,83.0,78,Casado,28,2019,8,high,-0.29000000000000004,-1,0,492974,-926,1,-19
100919,102137,1,Presencial,7.555,0,Mujer,Linkedin,6,454794,90.0,80,Casado,47,2021,5,high,102046,Presencial,1.18,0,Mujer,Portal Web,2,845000,37.0,79,Casado,27,2017,12,low,-6.375,0,-4,390206,-1244,1,-20
101115,102075,1,Presencial,3.76,2,Hombre,Portal Web,11,299403,90.0,81,Casado,43,2018,2,high,102047,Presencial,2.7,1,Hombre,Referidos,11,1255430,90.0,76,Casado,30,2013,3,high,-1.0599999999999996,-1,0,956027,-1797,1,-13
100920,102068,1,Presencial,5.1,0,Mujer,Portal Web,5,302430,90.0,81,Casado,42,2016,9,high,102043,Híbrida,2.17,3,Mujer,Referidos,4,896000,41.0,81,Soltero,23,2012,8,low,-2.9299999999999997,3,-1,593570,-1477,1,-19
101887,102049,1,Presencial,4.7,2,Mujer,Portal Web,7,390558,90.0,74,Viudo,39,2013,6,high,102029,Presencial,6.89,0,Mujer,Portal Web,9,1616000,19.0,77,Divorciado,49,2023,3,low,2.1899999999999995,-2,2,1225442,3559,0,10
100421,102036,1,Presencial,2.62,1,Hombre,Portal Web,16,298101,90.0,79,Casado,37,2012,7,high,102054,Presencial,1.68,8,Hombre,Portal Web,5,1616000,92.0,76,Viudo,54,2022,1,high,-0.9400000000000002,7,-11,1317899,3452,0,17
100249,102129,1,Presencial,1.78,2,Hombre,Ferias & Networking,13,639801,90.0,69,Soltero,48,2021,8,high,102142,Presencial,2.1,2,Mujer,Linkedin,3,590000,41.0,74,Soltero,24,2020,1,low,0.32000000000000006,0,-10,-49801,-587,1,-24
101841,102098,1,Presencial,3.945,3,Hombre,Portal Web,13,303543,90.0,80,Viudo,46,2020,2,high,102049,Presencial,1.8,1,Mujer,Portal Web,16,1616000,90.0,86,Casado,46,2021,1,high,-2.1449999999999996,-2,3,1312457,342,0,0
101851,102082,1,Presencial,2.39,2,Mujer,Ferias & Networking,16,414399,90.0,71,Divorciado,45,2018,9,high,102050,Presencial,5.5,2,Mujer,Linkedin,7,1616000,81.0,70,Casado,36,2018,8,high,3.11,0,-9,1201601,-42,1,-9
100704,102015,1,Presencial,14.045,2,Mujer,Portal Web,12,309140,90.0,72,Soltero,39,2013,1,high,102121,Presencial,6.18,1,Mujer,Referidos,10,1358450,74.0,82,Soltero,33,2014,6,low,-7.865,-1,-2,1049310,520,0,-6
102153,102143,2,Presencial,6.39,1,Mujer,Linkedin,5,1616000,90.0,68,Casado,41,2019,6,high,102142,Presencial,1.07,2,Hombre,Portal Web,2,590000,90.0,78,Casado,25,2022,2,high,-5.319999999999999,1,-3,-1026000,965,0,-16
101288,102143,1,Presencial,1.535,7,Hombre,Portal Web,11,639015,90.0,75,Viudo,50,2023,4,high,102142,Presencial,1.07,2,Hombre,Portal Web,2,590000,90.0,78,Casado,25,2022,2,high,-0.46499999999999986,-5,-9,-49015,-423,1,-25
100073,102148,1,Presencial,7.44,0,Mujer,Linkedin,13,837423,90.0,81,Divorciado,49,2022,11,high,102116,Presencial,1.49,2,Mujer,Portal Web,2,539000,80.0,67,Soltero,26,2022,12,high,-5.95,2,-11,-298423,34,0,-23
101369,102062,1,Presencial,1.845,2,Mujer,Referidos,15,635119,90.0,78,Soltero,45,2017,5,high,102149,Presencial,0.92,2,Mujer,Referidos,6,692000,38.0,72,Soltero,21,2014,10,low,-0.9249999999999999,0,-9,56881,-973,1,-24
101748,102058,1,Presencial,5.81,2,Hombre,Ferias & Networking,10,840198,90.0,70,Casado,44,2017,2,high,102172,Presencial,1.4,2,Hombre,Ferias & Networking,11,1616000,75.0,71,Casado,59,2021,2,low,-4.41,0,1,775802,1455,0,15
100739,102140,1,Presencial,4.35,3,Mujer,Linkedin,14,674316,90.0,84,Soltero,50,2021,3,high,102040,Presencial,2.55,0,Mujer,Portal Web,16,1616000,46.0,69,Casado,39,2012,2,low,-1.7999999999999998,-3,2,941684,-3329,1,-11
101592,102084,1,Presencial,2.96,8,Mujer,Portal Web,9,682212,90.0,69,Casado,45,2016,4,high,102171,Presencial,2.62,3,Mujer,Portal Web,14,1616000,89.0,76,Divorciado,50,2023,7,high,-0.33999999999999986,-5,5,933788,2649,0,5
101135,102048,1,Presencial,2.84,2,Mujer,Referidos,5,658749,90.0,75,Casado,41,2013,7,high,102092,Presencial,3.99,0,Mujer,Portal Web,5,590000,59.0,76,Soltero,20,2015,8,low,1.1500000000000004,-2,0,-68749,781,0,-21
102098,102049,2,Presencial,1.8,1,Mujer,Portal Web,16,1616000,90.0,86,Casado,46,2021,1,high,102029,Presencial,6.89,0,Mujer,Portal Web,9,1616000,19.0,77,Divorciado,49,2023,3,low,5.09,-1,-7,0,776,0,3
101662,102049,1,Presencial,3.11,3,Mujer,Linkedin,12,698953,90.0,83,Viudo,45,2015,9,high,102029,Presencial,6.89,0,Mujer,Portal Web,9,1616000,19.0,77,Divorciado,49,2023,3,low,3.78,-3,-3,917047,2736,0,4
101972,102030,1,Presencial,3.76,2,Mujer,Portal Web,15,696329,90.0,64,Casado,42,2012,6,high,102058,Presencial,6.34,0,Mujer,Referidos,14,1616000,90.0,76,Viudo,41,2015,4,high,2.58,-2,-1,919671,1028,0,-1
102147,102057,2,Presencial,1.58,2,Hombre,Portal Web,4,1616000,90.0,80,Casado,49,2022,12,high,102019,Presencial,1.97,4,Hombre,Portal Web,5,1616000,90.0,73,Viudo,59,2022,12,high,0.3899999999999999,2,1,0,1,0,10
101341,102057,1,Presencial,3.335,11,Hombre,Portal Web,16,721054,90.0,72,Casado,46,2015,4,high,102019,Presencial,1.97,4,Hombre,Portal Web,5,1616000,90.0,73,Viudo,59,2022,12,high,-1.365,-7,-11,894946,2800,0,13
100310,102061,1,Presencial,1.93,3,Mujer,Linkedin,9,913790,90.0,81,Casado,46,2014,9,high,102115,Presencial,2.14,2,Hombre,Ferias & Networking,10,1203920,37.0,80,Casado,29,2012,11,low,0.2100000000000002,-1,1,290130,-661,1,-17
100455,102015,1,Presencial,3.08,1,Mujer,Portal Web,9,722517,90.0,83,Casado,44,2013,6,high,102121,Presencial,6.18,1,Mujer,Referidos,10,1358450,74.0,82,Soltero,33,2014,6,low,3.0999999999999996,0,1,635933,363,0,-11
101704,102024,1,Presencial,3.4,1,Mujer,Ferias & Networking,12,716900,90.0,79,Casado,45,2013,3,high,102074,Presencial,2.28,0,Hombre,Headhunter,9,1616000,84.0,70,Casado,48,2018,3,high,-1.12,-1,-3,899100,1814,0,3
102117,102154,2,Presencial,4.05,1,Mujer,Linkedin,10,1616000,90.0,80,Divorciado,48,2021,1,high,102172,Presencial,5.45,1,Hombre,Portal Web,7,1512980,93.0,69,Soltero,39,2017,10,high,1.4000000000000004,0,-3,-103020,-1213,1,-9
100938,102154,1,Presencial,3.495,2,Hombre,Portal Web,7,742198,90.0,74,Soltero,54,2022,3,high,102172,Presencial,5.45,1,Hombre,Portal Web,7,1512980,93.0,69,Soltero,39,2017,10,high,1.955,-1,0,770782,-1626,1,-15
100317,102113,1,Presencial,2.21,1,Mujer,Portal Web,11,733757,90.0,75,Soltero,51,2018,12,high,102041,Presencial,2.96,2,Hombre,Portal Web,6,1152410,46.0,75,Casado,27,2012,1,low,0.75,1,-5,418653,-2526,1,-24
101918,102046,1,Presencial,2.925,0,Mujer,Ferias & Networking,3,861334,90.0,77,Casado,47,2015,3,high,102007,Presencial,1.68,0,Mujer,Portal Web,8,1616000,41.0,71,Soltero,50,2015,10,low,-1.2449999999999999,0,5,754666,235,0,3
101684,102160,1,Presencial,1.03,7,Hombre,Portal Web,12,853835,90.0,68,Viudo,56,2023,1,high,102087,Presencial,2.21,0,Hombre,Portal Web,3,794000,83.0,78,Casado,28,2019,8,high,1.18,-7,-9,-59835,-1240,1,-28
100818,102089,1,Presencial,4.55,2,Mujer,Linkedin,19,860501,90.0,73,Casado,51,2018,6,high,102077,Presencial,2.75,1,Hombre,Ferias & Networking,6,1616000,96.0,69,Divorciado,60,2021,10,high,-1.7999999999999998,-1,-13,755499,1231,0,9
101240,102053,1,Presencial,4.635,2,Mujer,Ferias & Networking,11,875171,90.0,75,Casado,51,2014,5,high,102030,Presencial,1.29,0,Hombre,Portal Web,11,1616000,81.0,64,Soltero,36,2012,12,high,-3.3449999999999998,-2,0,740829,-505,1,-15
100632,102025,1,Presencial,1.39,0,Mujer,Ferias & Networking,6,917214,90.0,71,Divorciado,48,2012,7,high,102132,Presencial,1.6,0,Hombre,Portal Web,9,1616000,90.0,81,Viudo,56,2018,4,high,0.2100000000000002,0,3,698786,2086,0,8
102057,102019,2,Presencial,1.97,4,Hombre,Portal Web,5,1616000,90.0,73,Viudo,59,2022,12,high,102129,Presencial,2.59,7,Mujer,Portal Web,4,488000,90.0,74,Soltero,24,2021,6,high,0.6199999999999999,3,-1,-1128000,-558,1,-35
102574,102019,1,Presencial,2.855,2,Hombre,Referidos,2,103524,90.0,85,Soltero,11,2013,4,high,102129,Presencial,2.59,7,Mujer,Portal Web,4,488000,90.0,74,Soltero,24,2021,6,high,-0.2650000000000001,5,2,384476,2990,0,13
104124,102105,1,Presencial,2.275,2,Mujer,Ferias & Networking,1,122861,90.0,69,Soltero,17,2018,2,high,102113,Híbrida,2.07,0,Hombre,Linkedin,8,1616000,85.0,71,Viudo,45,2017,3,high,-0.20500000000000007,-2,7,1493139,-321,1,28
103068,102070,1,Presencial,7.325,2,Mujer,Portal Web,1,123646,90.0,81,Soltero,16,2017,4,high,102035,Presencial,1.7,1,Mujer,Referidos,4,1616000,77.0,73,Viudo,38,2013,3,low,-5.625,-1,3,1492354,-1490,1,22
103327,102047,1,Presencial,2.165,1,Hombre,Portal Web,3,120555,90.0,77,Soltero,13,2013,9,high,102089,Presencial,2.67,1,Hombre,Linkedin,4,743000,14.0,70,Casado,22,2015,11,low,0.5049999999999999,0,1,622445,791,0,9
102806,102040,1,Presencial,1.735,1,Hombre,Linkedin,1,142043,90.0,86,Soltero,15,2014,10,high,102106,Presencial,3.21,1,Hombre,Linkedin,15,1616000,91.0,84,Soltero,45,2016,7,high,1.4749999999999999,0,14,1473957,642,0,30
103643,102000,1,Presencial,4.99,2,Hombre,Portal Web,1,145466,90.0,76,Soltero,13,2012,2,high,102075,Presencial,1.9,0,Hombre,Ferias & Networking,7,1616000,90.0,70,Soltero,53,2023,2,high,-3.0900000000000003,-2,6,1470534,4022,0,40
102617,102162,1,Presencial,4.61,0,Mujer,Portal Web,4,168870,90.0,76,Soltero,25,2023,4,high,102146,Presencial,1.12,0,Mujer,Referidos,9,1616000,31.0,74,Casado,41,2022,11,low,-3.49,0,5,1447130,-144,1,16
103386,102140,1,Presencial,2.52,1,Mujer,Referidos,3,167277,90.0,88,Soltero,23,2021,4,high,102040,Presencial,2.55,0,Mujer,Portal Web,16,1616000,46.0,69,Casado,39,2012,2,low,0.029999999999999805,-1,13,1448723,-3357,1,16
103519,102049,1,Presencial,2.25,1,Hombre,Referidos,3,162811,90.0,84,Soltero,17,2015,12,high,102029,Presencial,6.89,0,Mujer,Portal Web,9,1616000,19.0,77,Divorciado,49,2023,3,low,4.64,-1,6,1453189,2650,0,32
102649,102004,1,Presencial,4.565,1,Mujer,Ferias & Networking,4,166581,90.0,82,Soltero,14,2012,3,high,102026,Presencial,3.13,1,Hombre,Portal Web,15,1616000,87.0,85,Viudo,49,2023,1,high,-1.4350000000000005,0,11,1449419,3941,0,35
102766,102049,1,Presencial,3.66,3,Mujer,Portal Web,4,183119,90.0,83,Soltero,18,2015,4,high,102029,Presencial,6.89,0,Mujer,Portal Web,9,1616000,19.0,77,Divorciado,49,2023,3,low,3.2299999999999995,-3,5,1432881,2895,0,31
102529,102053,1,Presencial,6.465,2,Hombre,Ferias & Networking,2,186463,90.0,75,Divorciado,18,2014,6,high,102030,Presencial,1.29,0,Hombre,Portal Web,11,1616000,81.0,64,Soltero,36,2012,12,high,-5.175,-2,9,1429537,-545,1,18
104006,102133,1,Presencial,1.235,2,Hombre,Portal Web,1,187771,90.0,75,Soltero,25,2021,3,high,102151,Híbrida,2.61,2,Hombre,Linkedin,4,1255430,98.0,65,Soltero,35,2018,2,high,1.3749999999999998,0,3,1067659,-1114,1,10
103051,102008,1,Presencial,4.18,6,Hombre,Linkedin,5,211970,90.0,75,Casado,17,2012,10,high,102107,Presencial,3.99,1,Mujer,Linkedin,7,405435,90.0,82,Soltero,39,2023,1,high,-0.1899999999999995,-5,2,193465,3755,0,22
103508,102137,1,Presencial,2.515,0,Hombre,Ferias & Networking,1,247055,90.0,75,Casado,29,2022,5,high,102046,Presencial,1.18,0,Mujer,Portal Web,2,845000,37.0,79,Casado,27,2017,12,low,-1.3350000000000002,0,1,597945,-1597,1,-2
102495,102119,1,Presencial,7.555,5,Hombre,Linkedin,2,227271,90.0,66,Casado,28,2022,3,high,102107,Presencial,2.22,2,Hombre,Portal Web,12,1616000,38.0,70,Divorciado,52,2021,1,low,-5.334999999999999,-3,10,1388729,-427,1,24
103762,102114,1,Presencial,2.23,2,Hombre,Portal Web,2,225798,90.0,75,Soltero,27,2021,6,high,102050,Presencial,1.44,1,Mujer,Portal Web,5,1616000,91.0,69,Divorciado,47,2021,5,high,-0.79,-1,3,1390202,-21,1,20
102997,102129,1,Presencial,1.555,2,Hombre,Ferias & Networking,8,247338,90.0,70,Casado,29,2021,12,high,102142,Presencial,2.1,2,Mujer,Linkedin,3,590000,41.0,74,Soltero,24,2020,1,low,0.5450000000000002,0,-5,342662,-721,1,-5
103657,102151,1,Presencial,2.16,1,Mujer,Linkedin,2,248372,90.0,75,Soltero,29,2021,11,high,102105,Presencial,1.51,2,Hombre,Ferias & Networking,10,1616000,85.0,80,Divorciado,45,2021,11,high,-0.6500000000000001,1,8,1367628,12,0,16
102604,102154,1,Presencial,3.5,1,Hombre,Referidos,4,305084,90.0,69,Soltero,33,2023,4,high,102172,Presencial,5.45,1,Hombre,Portal Web,7,1512980,93.0,69,Soltero,39,2017,10,high,1.9500000000000002,0,3,1207896,-2023,1,6
102193,102124,1,Presencial,3.175,0,Mujer,Ferias & Networking,6,287345,90.0,74,Casado,29,2020,6,high,102099,Presencial,2.84,2,Mujer,Linkedin,4,947000,90.0,70,Soltero,24,2012,10,high,-0.33499999999999996,2,-2,659655,-2771,1,-5
102204,102052,1,Presencial,2.41,1,Hombre,Portal Web,5,287972,90.0,79,Casado,23,2014,1,high,102093,Presencial,4.45,0,Hombre,Linkedin,5,641000,84.0,76,Divorciado,17,2012,4,high,2.04,-1,0,353028,-670,1,-6
103225,102137,1,Presencial,2.29,1,Mujer,Linkedin,8,307579,90.0,78,Casado,34,2023,4,high,102046,Presencial,1.18,0,Mujer,Portal Web,2,845000,37.0,79,Casado,27,2017,12,low,-1.11,-1,-6,537421,-1942,1,-7
102616,102043,1,Presencial,0.305,4,Hombre,Portal Web,2,332390,90.0,82,Casado,23,2012,7,high,102051,Presencial,1.03,0,Hombre,Portal Web,5,1616000,60.0,76,Casado,44,2019,5,low,0.7250000000000001,-4,3,1283610,2507,0,21
103412,102105,1,Presencial,1.24,1,Mujer,Referidos,5,348516,90.0,72,Casado,30,2018,4,high,102113,Híbrida,2.07,0,Hombre,Linkedin,8,1616000,85.0,71,Viudo,45,2017,3,high,0.8299999999999998,-1,3,1267484,-393,1,15
102371,102111,1,Presencial,6.81,0,Mujer,Ferias & Networking,6,366986,90.0,80,Casado,33,2019,10,high,102097,Híbrida,2.04,1,Mujer,Referidos,15,1616000,94.0,67,Soltero,50,2021,5,high,-4.77,1,9,1249014,578,0,17
102454,102108,1,Presencial,2.62,2,Mujer,Portal Web,7,370270,90.0,80,Casado,32,2018,11,high,102040,Presencial,2.92,1,Mujer,Portal Web,5,1616000,46.0,75,Casado,50,2023,5,low,0.2999999999999998,-1,-2,1245730,1666,0,18
103430,102130,1,Presencial,1.255,2,Mujer,Portal Web,5,389757,90.0,75,Casado,37,2022,6,high,102068,Presencial,1.97,6,Hombre,Linkedin,5,1616000,84.0,73,Soltero,31,2014,4,high,0.7150000000000001,4,0,1226243,-2963,1,-6
103401,102113,1,Presencial,1.28,3,Mujer,Portal Web,5,768607,90.0,72,Casado,35,2021,3,high,102041,Presencial,2.96,2,Hombre,Portal Web,6,1152410,46.0,75,Casado,27,2012,1,low,1.68,-1,1,383803,-3359,1,-8
103735,102112,1,Presencial,2.9,1,Mujer,Linkedin,6,407540,90.0,75,Soltero,33,2018,6,high,102031,Presencial,2.27,7,Hombre,Linkedin,1,692000,83.0,74,Soltero,26,2020,6,high,-0.6299999999999999,6,-5,284460,751,0,-7
104066,102026,1,Presencial,4.795,4,Hombre,Portal Web,7,410173,90.0,75,Soltero,28,2013,7,high,102101,Presencial,2.7,1,Mujer,Portal Web,15,1616000,97.0,79,Casado,58,2017,6,high,-2.0949999999999998,-3,8,1205827,1453,0,30
103700,102139,1,Presencial,4.825,1,Mujer,Portal Web,7,411768,90.0,71,Casado,38,2023,6,high,102154,Presencial,6.48,1,Hombre,Ferias & Networking,5,590000,90.0,67,Casado,25,2021,6,high,1.6550000000000002,0,-2,178232,-723,1,-13
103150,102147,1,Presencial,5.44,2,Mujer,Ferias & Networking,7,407029,90.0,77,Soltero,38,2022,12,high,102057,Presencial,1.58,2,Hombre,Portal Web,4,1616000,90.0,80,Casado,49,2022,12,high,-3.8600000000000003,0,-3,1208971,3,0,11
103453,102092,1,Presencial,1.975,2,Hombre,Portal Web,7,407654,90.0,66,Divorciado,32,2017,7,high,102120,Presencial,1.23,6,Mujer,Linkedin,13,1616000,98.0,95,Viudo,41,2013,6,high,-0.7450000000000001,4,6,1208346,-1491,1,9
102409,102080,1,Presencial,1.855,1,Mujer,Referidos,9,771871,90.0,79,Soltero,32,2017,2,high,102035,Presencial,1.93,0,Mujer,Linkedin,18,1616000,94.0,75,Viudo,47,2016,8,high,0.07499999999999996,-1,9,844129,-189,1,15
103536,102069,1,Presencial,1.98,5,Mujer,Portal Web,11,412670,90.0,83,Casado,30,2014,12,high,102069,Presencial,4.64,1,Mujer,Ferias & Networking,19,1616000,47.0,74,Casado,60,2021,10,low,2.6599999999999997,-4,8,1203330,2495,0,30
102938,102151,1,Presencial,4.11,2,Hombre,Referidos,5,431500,90.0,75,Casado,39,2023,1,high,102105,Presencial,1.51,2,Hombre,Ferias & Networking,10,1616000,85.0,80,Divorciado,45,2021,11,high,-2.6000000000000005,0,5,1184500,-419,1,6
102416,102043,1,Presencial,2.905,2,Hombre,Referidos,7,425226,90.0,60,Casado,28,2012,6,high,102051,Presencial,1.03,0,Hombre,Portal Web,5,1616000,60.0,76,Casado,44,2019,5,low,-1.8749999999999998,-2,-2,1190774,2536,0,16
103061,102171,1,Presencial,5.06,3,Hombre,Portal Web,6,449662,90.0,72,Casado,40,2023,4,high,102088,Presencial,2.57,4,Hombre,Linkedin,8,1616000,80.0,69,Casado,43,2017,10,high,-2.4899999999999998,1,2,1166338,-2028,1,3
102713,102124,1,Presencial,4.705,5,Mujer,Linkedin,10,450558,90.0,76,Divorciado,38,2021,5,high,102099,Presencial,2.84,2,Mujer,Linkedin,4,947000,90.0,70,Soltero,24,2012,10,high,-1.8650000000000002,-3,-6,496442,-3106,1,-14
103934,102066,1,Presencial,2.5,3,Mujer,Ferias & Networking,11,445264,90.0,83,Soltero,33,2016,9,high,102171,Presencial,3.62,3,Hombre,Referidos,5,1616000,97.0,84,Casado,55,2023,12,high,1.12,0,-6,1170736,2646,0,22
103658,102057,1,Presencial,1.96,0,Mujer,Linkedin,10,466417,90.0,80,Soltero,33,2015,3,high,102019,Presencial,1.97,4,Hombre,Portal Web,5,1616000,90.0,73,Viudo,59,2022,12,high,0.010000000000000009,4,-5,1149583,2855,0,26
102538,102052,1,Presencial,2.735,8,Hombre,Linkedin,10,469254,90.0,70,Divorciado,32,2013,11,high,102093,Presencial,4.45,0,Hombre,Linkedin,5,641000,84.0,76,Divorciado,17,2012,4,high,1.7150000000000003,-8,-5,171746,-602,1,-15
103079,102098,1,Presencial,2.845,1,Mujer,Portal Web,5,488414,90.0,82,Soltero,38,2019,3,high,102049,Presencial,1.8,1,Mujer,Portal Web,16,1616000,90.0,86,Casado,46,2021,1,high,-1.0450000000000002,0,11,1127586,693,0,8
103335,102133,1,Presencial,2.71,0,Hombre,Portal Web,11,259076,90.0,71,Soltero,43,2022,4,high,102151,Híbrida,2.61,2,Hombre,Linkedin,4,1255430,98.0,65,Soltero,35,2018,2,high,-0.10000000000000009,2,-7,996354,-1501,1,-8
103224,102110,1,Presencial,5.52,1,Mujer,Portal Web,4,258007,90.0,70,Divorciado,41,2020,9,high,102045,Presencial,1.6,5,Mujer,Linkedin,2,998000,87.0,76,Soltero,29,2016,11,high,-3.9199999999999995,4,-2,739993,-1404,1,-12
102257,102132,1,Presencial,5.575,1,Hombre,Referidos,6,265354,90.0,78,Soltero,43,2020,12,high,102138,Presencial,4.51,1,Hombre,Linkedin,16,1616000,25.0,80,Viudo,45,2014,3,low,-1.0650000000000004,0,10,1350646,-2450,1,2
102857,102078,1,Presencial,1.63,3,Hombre,Portal Web,9,377685,90.0,82,Soltero,40,2017,7,high,102143,Presencial,2.17,1,Hombre,Ferias & Networking,9,998000,83.0,76,Casado,29,2017,5,high,0.54,-2,0,620315,-41,1,-11
103181,102047,1,Presencial,2.83,2,Hombre,Portal Web,12,265614,90.0,85,Casado,36,2013,10,high,102089,Presencial,2.67,1,Hombre,Linkedin,4,743000,14.0,70,Casado,22,2015,11,low,-0.16000000000000014,-1,-8,477386,767,0,-14
102935,102135,1,Presencial,0.11,2,Mujer,Portal Web,10,443095,90.0,71,Casado,46,2022,6,high,102028,Presencial,2.04,1,Hombre,Portal Web,2,1616000,82.0,75,Divorciado,49,2017,10,high,1.93,-1,-8,1172905,-1711,1,3
103930,102108,1,Presencial,5.095,2,Hombre,Portal Web,5,280910,90.0,75,Soltero,42,2019,2,high,102040,Presencial,2.92,1,Mujer,Portal Web,5,1616000,46.0,75,Casado,50,2023,5,low,-2.175,-1,0,1335090,1574,0,8
104038,102075,1,Presencial,3.505,7,Mujer,Linkedin,11,279479,90.0,77,Divorciado,40,2016,4,high,102047,Presencial,2.7,1,Hombre,Referidos,11,1255430,90.0,76,Casado,30,2013,3,high,-0.8049999999999997,-6,0,975951,-1104,1,-10
102216,102074,1,Presencial,2.0,1,Hombre,Ferias & Networking,9,290122,90.0,77,Divorciado,39,2015,8,high,102028,Presencial,1.35,0,Hombre,Ferias & Networking,4,1616000,80.0,83,Viudo,43,2015,12,high,-0.6499999999999999,-1,-5,1325878,149,0,4
104034,102141,1,Presencial,6.735,11,Hombre,Portal Web,4,300989,90.0,63,Divorciado,47,2022,4,high,102134,Presencial,1.88,1,Mujer,Linkedin,3,1100900,64.0,69,Soltero,32,2018,5,low,-4.855,-10,-1,799911,-1410,1,-15
104129,102081,1,Presencial,2.855,2,Mujer,Portal Web,7,299364,90.0,85,Viudo,42,2017,6,high,102135,Presencial,2.5,2,Hombre,Portal Web,4,488000,26.0,64,Soltero,18,2015,8,low,-0.355,0,-3,188636,-670,1,-24
102633,102068,1,Presencial,5.1,1,Mujer,Portal Web,5,294010,90.0,81,Casado,42,2016,9,high,102043,Híbrida,2.17,3,Mujer,Referidos,4,896000,41.0,81,Soltero,23,2012,8,low,-2.9299999999999997,2,-1,601990,-1478,1,-19
102940,102074,1,Presencial,1.55,1,Mujer,Ferias & Networking,7,301942,90.0,62,Divorciado,41,2016,7,high,102028,Presencial,1.35,0,Hombre,Ferias & Networking,4,1616000,80.0,83,Viudo,43,2015,12,high,-0.19999999999999996,-1,-3,1314058,-188,1,2
103027,102025,1,Presencial,2.545,0,Mujer,Portal Web,5,298639,90.0,81,Divorciado,39,2013,8,high,102132,Presencial,1.6,0,Hombre,Portal Web,9,1616000,90.0,81,Viudo,56,2018,4,high,-0.9449999999999998,0,4,1317361,1685,0,17
103490,102021,1,Presencial,2.455,1,Mujer,Portal Web,3,299955,90.0,59,Soltero,39,2013,7,high,102069,Presencial,2.25,1,Hombre,Linkedin,8,1616000,47.0,80,Casado,52,2017,3,low,-0.20500000000000007,0,5,1316045,1348,0,13
102273,102049,1,Presencial,4.68,3,Mujer,Portal Web,7,391291,90.0,74,Viudo,39,2013,6,high,102029,Presencial,6.89,0,Mujer,Portal Web,9,1616000,19.0,77,Divorciado,49,2023,3,low,2.21,-3,2,1224709,3558,0,10
103581,102098,1,Presencial,3.95,3,Hombre,Portal Web,13,309003,90.0,80,Viudo,46,2020,2,high,102049,Presencial,1.8,1,Mujer,Portal Web,16,1616000,90.0,86,Casado,46,2021,1,high,-2.1500000000000004,-2,3,1306997,345,0,0
102960,102082,1,Presencial,2.31,1,Hombre,Linkedin,5,307093,90.0,83,Casado,43,2016,9,high,102050,Presencial,5.5,2,Mujer,Linkedin,7,1616000,81.0,70,Casado,36,2018,8,high,3.19,1,2,1308907,688,0,-7
102264,102148,1,Presencial,7.455,0,Mujer,Linkedin,13,838325,90.0,81,Divorciado,50,2022,11,high,102116,Presencial,1.49,2,Mujer,Portal Web,2,539000,80.0,67,Soltero,26,2022,12,high,-5.965,2,-11,-299325,35,0,-24
103631,102085,1,Presencial,1.165,2,Mujer,Portal Web,3,640130,90.0,83,Casado,45,2017,11,high,102145,Presencial,6.59,4,Hombre,Portal Web,12,1616000,47.0,71,Casado,39,2015,8,low,5.425,2,9,975870,-822,1,-6
102380,102035,1,Presencial,3.41,3,Hombre,Linkedin,13,637070,90.0,78,Divorciado,42,2015,3,high,102041,Presencial,2.86,1,Hombre,Portal Web,23,1900000,83.0,72,Casado,57,2013,8,high,-0.5500000000000003,-2,10,1262930,-583,1,15
102333,102065,1,Presencial,3.955,2,Hombre,Portal Web,5,636387,90.0,69,Viudo,42,2015,2,high,102026,Presencial,2.44,2,Hombre,Ferias & Networking,13,1616000,45.0,60,Divorciado,35,2014,10,low,-1.5150000000000001,0,8,979613,-127,1,-7
102269,102025,1,Presencial,4.61,3,Hombre,Portal Web,5,658857,90.0,70,Casado,41,2013,7,high,102132,Presencial,1.6,0,Hombre,Portal Web,9,1616000,90.0,81,Viudo,56,2018,4,high,-3.0100000000000002,-3,4,957143,1729,0,15
103652,102113,1,Presencial,4.56,3,Hombre,Ferias & Networking,12,878061,90.0,80,Soltero,50,2021,4,high,102041,Presencial,2.96,2,Hombre,Portal Web,6,1152410,46.0,75,Casado,27,2012,1,low,-1.5999999999999996,-1,-6,274349,-3389,1,-23
102961,102065,1,Presencial,1.67,0,Mujer,Ferias & Networking,9,655946,90.0,80,Soltero,43,2014,6,high,102026,Presencial,2.44,2,Hombre,Ferias & Networking,13,1616000,45.0,60,Divorciado,35,2014,10,low,0.77,2,4,960054,118,0,-8
103368,102064,1,Presencial,3.165,2,Mujer,Portal Web,17,676679,90.0,73,Soltero,45,2016,4,high,102067,Presencial,1.34,0,Hombre,Portal Web,6,1616000,92.0,92,Casado,43,2018,2,high,-1.825,-2,-11,939321,669,0,-2
103024,102070,1,Presencial,2.94,2,Hombre,Portal Web,13,861623,90.0,75,Viudo,44,2015,4,high,102035,Presencial,1.7,1,Mujer,Referidos,4,1616000,77.0,73,Viudo,38,2013,3,low,-1.24,-1,-9,754377,-777,1,-6
104105,102043,1,Presencial,1.535,6,Hombre,Portal Web,4,675828,90.0,67,Casado,43,2014,7,high,102051,Presencial,1.03,0,Hombre,Portal Web,5,1616000,60.0,76,Casado,44,2019,5,low,-0.5049999999999999,-6,1,940172,1780,0,1
102462,102017,1,Presencial,3.4,3,Mujer,Ferias & Networking,7,680151,90.0,73,Casado,41,2012,3,high,102035,Presencial,4.62,0,Mujer,Linkedin,2,641000,90.0,84,Casado,25,2019,11,high,1.2200000000000002,-3,-5,-39151,2808,0,-16
103940,102051,1,Presencial,1.725,6,Hombre,Portal Web,18,696033,90.0,79,Soltero,44,2014,3,high,102075,Híbrida,1.39,1,Hombre,Portal Web,11,1616000,83.0,76,Casado,46,2019,11,high,-0.3350000000000002,-5,-7,919967,2078,0,2
102277,102028,1,Presencial,6.485,2,Mujer,Portal Web,8,694888,90.0,77,Viudo,42,2012,1,high,102085,Presencial,1.39,2,Mujer,Linkedin,12,1358450,97.0,72,Soltero,35,2016,12,high,-5.095000000000001,0,4,663562,1803,0,-7
102738,102024,1,Presencial,3.365,1,Mujer,Ferias & Networking,12,714554,90.0,79,Casado,44,2013,3,high,102074,Presencial,2.28,0,Hombre,Headhunter,9,1616000,84.0,70,Casado,48,2018,3,high,-1.0850000000000004,-1,-3,901446,1815,0,4
103345,102135,1,Presencial,2.81,2,Hombre,Portal Web,3,796016,90.0,83,Viudo,55,2023,1,high,102028,Presencial,2.04,1,Hombre,Portal Web,2,1616000,82.0,75,Divorciado,49,2017,10,high,-0.77,-1,-1,819984,-1931,1,-6
103518,102154,1,Presencial,3.5,2,Hombre,Portal Web,7,734692,90.0,74,Soltero,54,2022,3,high,102172,Presencial,5.45,1,Hombre,Portal Web,7,1512980,93.0,69,Soltero,39,2017,10,high,1.9500000000000002,-1,0,778288,-1625,1,-15
103766,102112,1,Presencial,1.295,0,Mujer,Portal Web,8,742294,90.0,82,Divorciado,50,2018,7,high,102031,Presencial,2.27,7,Hombre,Linkedin,1,692000,83.0,74,Soltero,26,2020,6,high,0.9750000000000001,7,-7,-50294,701,0,-24
103571,102097,1,Presencial,1.72,1,Mujer,Linkedin,5,740664,90.0,82,Divorciado,50,2017,9,high,102024,Presencial,1.95,6,Hombre,Portal Web,4,1100900,57.0,77,Soltero,31,2016,10,low,0.22999999999999998,5,-1,360236,-312,1,-19
103541,102061,1,Presencial,5.385,2,Mujer,Referidos,19,734458,90.0,71,Divorciado,48,2016,8,high,102115,Presencial,2.14,2,Hombre,Ferias & Networking,10,1203920,37.0,80,Casado,29,2012,11,low,-3.2449999999999997,0,-9,469462,-1370,1,-19
103238,102160,1,Presencial,1.02,7,Hombre,Portal Web,12,861797,90.0,68,Viudo,56,2023,1,high,102087,Presencial,2.21,0,Hombre,Portal Web,3,794000,83.0,78,Casado,28,2019,8,high,1.19,-7,-9,-67797,-1238,1,-28
102797,102137,1,Presencial,4.57,1,Mujer,Portal Web,13,839610,90.0,75,Soltero,54,2021,4,high,102046,Presencial,1.18,0,Mujer,Portal Web,2,845000,37.0,79,Casado,27,2017,12,low,-3.3900000000000006,-1,-11,5390,-1195,1,-27
103802,102145,1,Presencial,2.19,1,Hombre,Portal Web,9,855287,90.0,82,Divorciado,57,2022,11,high,102116,Presencial,1.43,1,Mujer,Portal Web,3,692000,89.0,73,Viudo,23,2016,12,high,-0.76,0,-6,-163287,-2166,1,-34
102600,102025,1,Presencial,1.39,0,Mujer,Ferias & Networking,6,916653,90.0,71,Divorciado,48,2012,7,high,102132,Presencial,1.6,0,Hombre,Portal Web,9,1616000,90.0,81,Viudo,56,2018,4,high,0.2100000000000002,0,3,699347,2086,0,8
103710,102107,1,Presencial,4.97,1,Mujer,Portal Web,7,895339,90.0,77,Soltero,57,2019,12,high,102069,Presencial,2.4,1,Mujer,Linkedin,8,1616000,47.0,79,Casado,63,2023,6,low,-2.57,0,1,720661,1272,0,6
100445,102142,1,Presencial,5.085,2,Hombre,Linkedin,3,182324,89.0,68,Casado,24,2021,9,high,102047,Presencial,2.48,2,Hombre,Portal Web,3,1255430,90.0,66,Soltero,36,2019,7,high,-2.605,0,0,1073106,-789,1,12
101590,102093,1,Presencial,0.6,1,Hombre,Headhunter,4,678886,89.0,94,Viudo,46,2016,12,high,102139,Presencial,5.41,0,Mujer,Ferias & Networking,4,488000,89.0,62,Soltero,23,2021,6,high,4.8100000000000005,-1,0,-190886,1634,0,-23
101787,102075,1,Presencial,6.205,0,Mujer,Portal Web,3,718167,89.0,83,Divorciado,47,2016,4,high,102047,Presencial,2.7,1,Hombre,Referidos,11,1255430,90.0,76,Casado,30,2013,3,high,-3.505,1,8,537263,-1126,1,-17
100064,102137,1,Presencial,4.6,0,Mujer,Portal Web,13,835454,89.0,75,Soltero,54,2021,4,high,102046,Presencial,1.18,0,Mujer,Portal Web,2,845000,37.0,79,Casado,27,2017,12,low,-3.42,0,-11,9546,-1196,1,-27
102719,102064,1,Presencial,1.855,1,Mujer,Linkedin,1,138848,89.0,81,Divorciado,15,2015,3,high,102067,Presencial,1.34,0,Hombre,Portal Web,6,1616000,92.0,92,Casado,43,2018,2,high,-0.5149999999999999,-1,5,1477152,1049,0,28
102242,102106,1,Presencial,1.785,1,Mujer,Ferias & Networking,3,142866,89.0,71,Soltero,18,2018,4,high,102081,Presencial,1.39,1,Mujer,Ferias & Networking,5,1049000,86.0,86,Soltero,32,2019,6,high,-0.395,0,2,906134,438,0,14
102721,102155,1,Presencial,6.39,10,Mujer,Portal Web,1,160509,89.0,74,Soltero,25,2023,1,high,102159,Presencial,1.78,1,Mujer,Ferias & Networking,1,590000,39.0,80,Soltero,20,2016,10,low,-4.609999999999999,-9,0,429491,-2273,1,-5
102977,102087,1,Presencial,3.715,1,Hombre,Referidos,4,162926,89.0,82,Soltero,18,2016,5,high,102111,Presencial,7.16,9,Mujer,Linkedin,10,1616000,98.0,79,Casado,42,2012,5,high,3.4450000000000003,8,6,1453074,-1484,1,24
103112,102047,1,Presencial,4.38,2,Hombre,Referidos,2,328410,89.0,76,Casado,26,2014,12,high,102089,Presencial,2.67,1,Hombre,Linkedin,4,743000,14.0,70,Casado,22,2015,11,low,-1.71,-1,2,414590,354,0,-4
102527,102075,1,Presencial,1.475,1,Hombre,Ferias & Networking,2,368234,89.0,68,Casado,31,2017,10,high,102047,Presencial,2.7,1,Hombre,Referidos,11,1255430,90.0,76,Casado,30,2013,3,high,1.225,0,9,887196,-1669,1,-1
103948,102158,1,Presencial,1.56,5,Mujer,Ferias & Networking,7,288260,89.0,75,Casado,47,2022,11,high,102093,Presencial,1.79,1,Mujer,Referidos,27,1900000,87.0,74,Viudo,54,2013,9,high,0.22999999999999998,-4,20,1611740,-3357,1,7
103377,102140,1,Presencial,2.35,1,Mujer,Linkedin,3,813300,89.0,76,Viudo,50,2023,3,high,102040,Presencial,2.55,0,Mujer,Portal Web,16,1616000,46.0,69,Casado,39,2012,2,low,0.19999999999999973,-1,13,802700,-4058,1,-11
102907,102093,1,Presencial,0.65,0,Hombre,Headhunter,4,680838,89.0,94,Viudo,45,2016,12,high,102139,Presencial,5.41,0,Mujer,Ferias & Networking,4,488000,89.0,62,Soltero,23,2021,6,high,4.76,0,0,-192838,1636,0,-22
102215,102050,1,Presencial,1.535,2,Mujer,Referidos,16,655366,89.0,79,Divorciado,44,2015,12,high,102069,Presencial,3.7,0,Mujer,Linkedin,11,1512980,90.0,88,Soltero,40,2017,10,high,2.165,-2,-5,857614,652,0,-4
100277,102111,1,Presencial,5.04,2,Hombre,Portal Web,1,83315,88.0,81,Soltero,18,2020,9,high,102097,Híbrida,2.04,1,Mujer,Referidos,15,1616000,94.0,67,Soltero,50,2021,5,high,-3.0,-1,14,1532685,232,0,32
100796,102123,1,Presencial,2.18,3,Mujer,Ferias & Networking,1,80323,88.0,77,Soltero,17,2020,1,high,102043,Presencial,5.5,1,Mujer,Linkedin,16,1616000,42.0,66,Soltero,51,2021,9,low,3.32,-2,15,1535677,619,0,34
100775,102127,1,Presencial,5.465,1,Hombre,Linkedin,15,311008,88.0,88,Soltero,47,2021,7,high,102028,Presencial,4.03,2,Mujer,Linkedin,9,1306940,88.0,78,Divorciado,32,2014,5,high,-1.4349999999999996,1,-6,995932,-2602,1,-15
100789,102050,1,Presencial,1.54,2,Mujer,Referidos,16,656734,88.0,79,Divorciado,44,2015,12,high,102069,Presencial,3.7,0,Mujer,Linkedin,11,1512980,90.0,88,Soltero,40,2017,10,high,2.16,-2,-5,856246,653,0,-4
102571,102123,1,Presencial,2.195,2,Mujer,Ferias & Networking,1,82740,88.0,77,Soltero,17,2020,1,high,102043,Presencial,5.5,1,Mujer,Linkedin,16,1616000,42.0,66,Soltero,51,2021,9,low,3.305,-1,15,1533260,622,0,34
102311,102056,1,Presencial,5.845,8,Hombre,Portal Web,7,270023,88.0,70,Soltero,24,2016,4,high,102014,Presencial,5.24,1,Hombre,Ferias & Networking,16,1616000,70.0,63,Viudo,65,2023,3,low,-0.6049999999999995,-7,9,1345977,2531,0,41
102433,102116,1,Presencial,2.225,3,Mujer,Referidos,6,351958,88.0,72,Casado,31,2018,10,high,102021,Presencial,2.32,0,Mujer,Portal Web,22,1616000,94.0,76,Casado,59,2020,7,high,0.09499999999999975,-3,16,1264042,634,0,28
103633,102040,1,Presencial,1.08,2,Hombre,Portal Web,5,675664,88.0,71,Soltero,44,2015,6,high,102106,Presencial,3.21,1,Hombre,Linkedin,15,1616000,91.0,84,Soltero,45,2016,7,high,2.13,-1,10,940336,408,0,1
100319,102102,1,Presencial,2.145,0,Hombre,Headhunter,1,75669,87.0,69,Soltero,17,2020,7,high,102018,Presencial,2.48,0,Hombre,Portal Web,5,1616000,92.0,63,Viudo,49,2019,4,high,0.33499999999999996,0,4,1540331,-468,1,32
101879,102084,1,Presencial,2.185,3,Mujer,Referidos,2,145459,87.0,82,Soltero,18,2017,9,high,102171,Presencial,2.62,3,Mujer,Portal Web,14,1616000,89.0,76,Divorciado,50,2023,7,high,0.43500000000000005,0,12,1470541,2143,0,32
100635,102064,1,Presencial,6.29,1,Mujer,Headhunter,3,286475,87.0,79,Soltero,24,2014,8,high,102067,Presencial,1.34,0,Hombre,Portal Web,6,1616000,92.0,92,Casado,43,2018,2,high,-4.95,-1,3,1329525,1251,0,19
102004,102026,2,Presencial,3.13,1,Hombre,Portal Web,15,1616000,87.0,85,Viudo,49,2023,1,high,102101,Presencial,2.7,1,Mujer,Portal Web,15,1616000,97.0,79,Casado,58,2017,6,high,-0.4299999999999997,0,0,0,-2022,1,9
101861,102026,1,Presencial,3.405,0,Hombre,Portal Web,10,913231,87.0,71,Casado,46,2013,1,high,102101,Presencial,2.7,1,Mujer,Portal Web,15,1616000,97.0,79,Casado,58,2017,6,high,-0.7049999999999996,1,5,702769,1611,0,12
102376,102102,1,Presencial,2.135,0,Hombre,Headhunter,1,78906,87.0,69,Soltero,17,2020,7,high,102018,Presencial,2.48,0,Hombre,Portal Web,5,1616000,92.0,63,Viudo,49,2019,4,high,0.3450000000000002,0,4,1537094,-470,1,32
102866,102064,1,Presencial,6.32,0,Mujer,Headhunter,3,287023,87.0,79,Soltero,24,2014,8,high,102067,Presencial,1.34,0,Hombre,Portal Web,6,1616000,92.0,92,Casado,43,2018,2,high,-4.98,0,3,1328977,1252,0,19
102516,102107,1,Presencial,1.41,3,Mujer,Linkedin,9,470910,87.0,80,Casado,37,2019,1,high,102069,Presencial,2.4,1,Mujer,Linkedin,8,1616000,47.0,79,Casado,63,2023,6,low,0.99,-2,-1,1145090,1622,0,26
103306,102081,1,Presencial,4.96,0,Mujer,Ferias & Networking,5,255156,87.0,67,Casado,39,2017,8,high,102135,Presencial,2.5,2,Hombre,Portal Web,4,488000,26.0,64,Soltero,18,2015,8,low,-2.46,2,-1,232844,-712,1,-21
104072,102172,1,Presencial,2.87,2,Mujer,Referidos,9,659407,87.0,74,Casado,51,2023,1,high,102020,Presencial,5.58,1,Hombre,Portal Web,7,1049000,57.0,70,Casado,29,2016,4,low,2.71,-1,-2,389593,-2456,1,-22
103073,102051,1,Presencial,0.875,2,Mujer,Portal Web,18,819746,87.0,76,Viudo,45,2016,1,high,102075,Híbrida,1.39,1,Hombre,Portal Web,11,1616000,83.0,76,Casado,46,2019,11,high,0.5149999999999999,-1,-7,796254,1398,0,1
102930,102026,1,Presencial,3.39,1,Hombre,Portal Web,10,915820,87.0,71,Divorciado,46,2013,1,high,102101,Presencial,2.7,1,Mujer,Portal Web,15,1616000,97.0,79,Casado,58,2017,6,high,-0.69,0,5,700180,1610,0,12
100817,102128,1,Presencial,4.955,2,Hombre,Linkedin,2,96971,86.0,68,Soltero,21,2022,11,high,102056,Presencial,4.11,10,Mujer,Portal Web,16,1616000,46.0,72,Soltero,55,2021,2,low,-0.8449999999999998,8,14,1519029,-650,1,34
100370,102100,1,Presencial,6.855,2,Hombre,Portal Web,1,231664,86.0,77,Casado,24,2018,4,high,102007,Presencial,3.3,1,Mujer,Portal Web,3,1255430,21.0,59,Casado,30,2013,2,low,-3.5550000000000006,-1,2,1023766,-1897,1,6
100282,102107,1,Presencial,2.03,2,Mujer,Referidos,11,870480,86.0,77,Soltero,38,2018,11,high,102069,Presencial,2.4,1,Mujer,Linkedin,8,1616000,47.0,79,Casado,63,2023,6,low,0.3700000000000001,-1,-3,745520,1679,0,25
101838,102122,1,Presencial,3.195,0,Mujer,Linkedin,3,391788,86.0,77,Divorciado,45,2022,1,high,102075,Presencial,1.83,4,Hombre,Portal Web,6,1616000,90.0,66,Viudo,48,2019,3,high,-1.3649999999999998,4,3,1224212,-1023,1,3
100765,102149,1,Presencial,1.83,3,Hombre,Portal Web,13,450123,86.0,88,Viudo,46,2022,8,high,102141,Presencial,2.07,0,Mujer,Headhunter,3,1409960,90.0,86,Casado,37,2017,2,high,0.23999999999999977,-3,-10,959837,-2009,1,-9
100984,102016,1,Presencial,2.305,2,Hombre,Portal Web,15,288178,86.0,82,Divorciado,36,2012,1,high,102008,Híbrida,2.51,2,Mujer,Portal Web,6,1616000,40.0,80,Casado,44,2017,8,low,0.20499999999999963,0,-9,1327822,2048,0,8
103249,102053,1,Presencial,1.56,2,Hombre,Portal Web,5,369153,86.0,82,Casado,27,2014,11,high,102030,Presencial,1.29,0,Hombre,Portal Web,11,1616000,81.0,64,Soltero,36,2012,12,high,-0.27,-2,6,1246847,-684,1,9
103230,102004,1,Presencial,5.655,3,Hombre,Ferias & Networking,10,763722,86.0,67,Soltero,26,2012,3,high,102026,Presencial,3.13,1,Hombre,Portal Web,15,1616000,87.0,85,Viudo,49,2023,1,high,-2.5250000000000004,-2,5,852278,3936,0,23
103972,102149,1,Presencial,1.865,3,Hombre,Portal Web,13,443723,86.0,88,Viudo,46,2022,8,high,102141,Presencial,2.07,0,Mujer,Headhunter,3,1409960,90.0,86,Casado,37,2017,2,high,0.20499999999999985,-3,-10,966237,-2010,1,-9
103269,102149,1,Presencial,2.535,2,Hombre,Linkedin,6,300171,86.0,66,Soltero,48,2022,11,high,102141,Presencial,2.07,0,Mujer,Headhunter,3,1409960,90.0,86,Casado,37,2017,2,high,-0.4650000000000003,-2,-3,1109789,-2084,1,-11
101999,102081,1,Presencial,6.245,2,Mujer,Ferias & Networking,3,347254,85.0,78,Soltero,31,2018,10,high,102135,Presencial,2.5,2,Hombre,Portal Web,4,488000,26.0,64,Soltero,18,2015,8,low,-3.745,0,1,140746,-1163,1,-13
100208,102149,1,Presencial,2.52,2,Hombre,Linkedin,6,297579,85.0,66,Soltero,48,2022,11,high,102141,Presencial,2.07,0,Mujer,Headhunter,3,1409960,90.0,86,Casado,37,2017,2,high,-0.4500000000000002,-2,-3,1112381,-2082,1,-11
100155,102092,1,Presencial,3.625,1,Mujer,Referidos,15,817823,85.0,67,Soltero,52,2017,11,high,102120,Presencial,1.23,6,Mujer,Linkedin,13,1616000,98.0,95,Viudo,41,2013,6,high,-2.395,5,-2,798177,-1610,1,-11
100712,102095,1,Presencial,1.79,2,Mujer,Linkedin,11,860870,85.0,80,Casado,56,2019,10,high,102171,Presencial,3.28,2,Mujer,Portal Web,3,1616000,80.0,75,Soltero,42,2023,10,high,1.4899999999999998,0,-8,755130,1459,0,-14
102465,102145,1,Presencial,2.485,10,Mujer,Portal Web,5,266625,85.0,70,Casado,29,2021,5,high,102116,Presencial,1.43,1,Mujer,Portal Web,3,692000,89.0,73,Viudo,23,2016,12,high,-1.055,-9,-2,425375,-1634,1,-6
103892,102122,1,Presencial,3.23,0,Mujer,Linkedin,3,390786,85.0,77,Divorciado,45,2022,1,high,102075,Presencial,1.83,4,Hombre,Portal Web,6,1616000,90.0,66,Viudo,48,2019,3,high,-1.4,4,3,1225214,-1021,1,3
102270,102114,1,Presencial,1.955,2,Mujer,Ferias & Networking,4,681462,85.0,67,Casado,49,2020,6,high,102050,Presencial,1.44,1,Mujer,Portal Web,5,1616000,91.0,69,Divorciado,47,2021,5,high,-0.5150000000000001,-1,1,934538,326,0,-2
104172,102137,1,Presencial,3.665,3,Hombre,Linkedin,8,702381,85.0,73,Soltero,53,2023,1,high,102046,Presencial,1.18,0,Mujer,Portal Web,2,845000,37.0,79,Casado,27,2017,12,low,-2.4850000000000003,-3,-6,142619,-1840,1,-26
103654,102080,1,Presencial,4.825,3,Hombre,Ferias & Networking,8,720453,85.0,70,Divorciado,46,2015,12,high,102035,Presencial,1.93,0,Mujer,Linkedin,18,1616000,94.0,75,Viudo,47,2016,8,high,-2.8950000000000005,-3,10,895547,252,0,1
103354,102092,1,Presencial,3.625,1,Mujer,Referidos,15,813478,85.0,67,Soltero,52,2017,11,high,102120,Presencial,1.23,6,Mujer,Linkedin,13,1616000,98.0,95,Viudo,41,2013,6,high,-2.395,5,-2,802522,-1613,1,-11
102451,102095,1,Presencial,1.82,2,Mujer,Portal Web,11,856692,85.0,80,Casado,56,2019,10,high,102171,Presencial,3.28,2,Mujer,Portal Web,3,1616000,80.0,75,Soltero,42,2023,10,high,1.4599999999999997,0,-8,759308,1457,0,-14
101976,102038,1,Presencial,6.74,0,Hombre,Linkedin,2,185711,84.0,76,Casado,17,2012,10,high,102125,Presencial,2.06,1,Hombre,Portal Web,12,1616000,81.0,82,Casado,44,2018,1,high,-4.68,1,10,1430289,1922,0,27
101651,102145,1,Presencial,2.45,10,Mujer,Portal Web,5,266889,84.0,70,Casado,29,2021,5,high,102116,Presencial,1.43,1,Mujer,Portal Web,3,692000,89.0,73,Viudo,23,2016,12,high,-1.0200000000000002,-9,-2,425111,-1636,1,-6
100509,102026,1,Presencial,1.42,0,Mujer,Linkedin,6,310863,84.0,71,Soltero,24,2014,3,high,102101,Presencial,2.7,1,Mujer,Portal Web,15,1616000,97.0,79,Casado,58,2017,6,high,1.2800000000000002,1,9,1305137,1182,0,34
100801,102137,1,Presencial,6.43,10,Hombre,Portal Web,12,491939,84.0,75,Casado,42,2022,9,high,102046,Presencial,1.18,0,Mujer,Portal Web,2,845000,37.0,79,Casado,27,2017,12,low,-5.25,-10,-10,353061,-1727,1,-15
100264,102012,1,Presencial,2.495,3,Hombre,Referidos,3,439798,84.0,77,Divorciado,38,2013,5,high,102122,Presencial,2.09,1,Mujer,Portal Web,7,1100000,90.0,80,Casado,34,2019,7,high,-0.40500000000000025,-2,4,660202,2260,0,-4
101086,102118,1,Presencial,1.01,0,Mujer,Linkedin,7,441732,84.0,87,Casado,47,2020,8,high,102171,Presencial,4.76,17,Mujer,Linkedin,4,1616000,86.0,74,Soltero,39,2023,8,high,3.75,17,-3,1174268,1096,0,-8
100389,102051,1,Presencial,1.26,3,Mujer,Referidos,4,678715,84.0,80,Casado,44,2015,5,high,102075,Híbrida,1.39,1,Hombre,Portal Web,11,1616000,83.0,76,Casado,46,2019,11,high,0.1299999999999999,-2,7,937285,1633,0,2
100802,102059,1,Presencial,2.45,0,Hombre,Portal Web,7,681852,84.0,77,Viudo,43,2013,11,high,102021,Presencial,2.55,2,Hombre,Portal Web,16,1616000,27.0,76,Viudo,50,2019,6,low,0.09999999999999964,2,9,934148,2046,0,7
101463,102045,1,Presencial,3.755,1,Hombre,Referidos,8,917225,84.0,62,Divorciado,45,2013,10,high,102171,Presencial,3.19,3,Hombre,Portal Web,11,1616000,97.0,65,Casado,53,2023,9,high,-0.565,2,3,698775,3618,0,8
103127,102124,1,Presencial,7.025,2,Hombre,Referidos,6,248045,84.0,75,Soltero,28,2021,5,high,102099,Presencial,2.84,2,Mujer,Linkedin,4,947000,90.0,70,Soltero,24,2012,10,high,-4.1850000000000005,0,-2,698955,-3129,1,-4
103237,102072,1,Presencial,3.785,0,Mujer,Portal Web,5,432426,84.0,71,Casado,34,2017,9,high,102046,Presencial,2.61,2,Hombre,Ferias & Networking,3,947000,41.0,71,Soltero,30,2018,11,low,-1.1750000000000003,2,-2,514574,425,0,-4
103447,102098,1,Presencial,3.075,2,Hombre,Ferias & Networking,13,696278,84.0,69,Viudo,48,2018,2,high,102049,Presencial,1.8,1,Mujer,Portal Web,16,1616000,90.0,86,Casado,46,2021,1,high,-1.2750000000000001,-1,3,919722,1088,0,-2
103370,102083,1,Presencial,6.19,5,Mujer,Referidos,18,835033,84.0,83,Viudo,46,2015,12,high,102147,Presencial,1.61,0,Mujer,Portal Web,5,1564490,83.0,71,Soltero,44,2021,2,high,-4.58,-5,-13,729457,1902,0,-2
100786,102115,1,Presencial,1.385,1,Mujer,Referidos,7,250380,83.0,77,Soltero,27,2020,4,high,102116,Presencial,2.0,2,Mujer,Portal Web,4,1616000,94.0,76,Soltero,35,2018,12,high,0.615,1,-3,1365620,-487,1,8
101723,102128,1,Presencial,4.21,8,Hombre,Linkedin,2,287452,83.0,71,Soltero,29,2020,3,high,102056,Presencial,4.11,10,Mujer,Portal Web,16,1616000,46.0,72,Soltero,55,2021,2,low,-0.09999999999999964,2,14,1328548,323,0,26
101075,102106,1,Presencial,4.965,2,Hombre,Linkedin,6,421013,83.0,72,Soltero,39,2018,5,high,102081,Presencial,1.39,1,Mujer,Ferias & Networking,5,1049000,86.0,86,Soltero,32,2019,6,high,-3.575,-1,-1,627987,394,0,-7
100815,102127,1,Presencial,1.24,12,Mujer,Portal Web,18,699457,83.0,76,Soltero,52,2022,4,high,102028,Presencial,4.03,2,Mujer,Linkedin,9,1306940,88.0,78,Divorciado,32,2014,5,high,2.79,-10,-9,607483,-2896,1,-20
101911,102098,1,Presencial,3.03,1,Hombre,Ferias & Networking,13,696171,83.0,69,Viudo,48,2018,2,high,102049,Presencial,1.8,1,Mujer,Portal Web,16,1616000,90.0,86,Casado,46,2021,1,high,-1.2299999999999998,0,3,919829,1085,0,-2
100663,102052,1,Presencial,1.575,1,Hombre,Referidos,19,916163,83.0,81,Casado,49,2015,5,high,102093,Presencial,4.45,0,Hombre,Linkedin,5,641000,84.0,76,Divorciado,17,2012,4,high,2.875,-1,-14,-275163,-1154,1,-32
104009,102171,1,Presencial,1.915,2,Mujer,Portal Web,1,119881,83.0,84,Casado,22,2023,6,high,102088,Presencial,2.57,4,Hombre,Linkedin,8,1616000,80.0,69,Casado,43,2017,10,high,0.6549999999999998,2,7,1496119,-2071,1,21
103731,102057,1,Presencial,1.405,6,Mujer,Portal Web,2,188077,83.0,80,Divorciado,21,2016,12,high,102019,Presencial,1.97,4,Hombre,Portal Web,5,1616000,90.0,73,Viudo,59,2022,12,high,0.565,-2,3,1427923,2207,0,38
102176,102038,1,Presencial,6.765,0,Hombre,Linkedin,2,189783,83.0,76,Casado,17,2012,10,high,102125,Presencial,2.06,1,Hombre,Portal Web,12,1616000,81.0,82,Casado,44,2018,1,high,-4.705,1,10,1426217,1923,0,27
103697,102128,1,Presencial,4.2,8,Hombre,Linkedin,3,287431,83.0,71,Soltero,29,2020,3,high,102056,Presencial,4.11,10,Mujer,Portal Web,16,1616000,46.0,72,Soltero,55,2021,2,low,-0.08999999999999986,2,13,1328569,326,0,26
102335,102045,1,Presencial,3.75,1,Hombre,Referidos,8,914643,83.0,62,Divorciado,45,2013,11,high,102171,Presencial,3.19,3,Hombre,Portal Web,11,1616000,97.0,65,Casado,53,2023,9,high,-0.56,2,3,701357,3616,0,8
102729,102143,1,Presencial,2.13,2,Hombre,Portal Web,12,762120,83.0,74,Divorciado,55,2022,4,high,102142,Presencial,1.07,2,Hombre,Portal Web,2,590000,90.0,78,Casado,25,2022,2,high,-1.0599999999999998,0,-10,-172120,-71,1,-30
100105,102094,1,Presencial,2.21,0,Mujer,Referidos,4,311745,82.0,61,Casado,28,2017,10,high,102095,Presencial,1.32,1,Hombre,Portal Web,4,998000,90.0,85,Casado,28,2016,2,high,-0.8899999999999999,1,0,686255,-633,1,0
102763,102021,1,Presencial,5.94,0,Hombre,Portal Web,10,693750,82.0,77,Casado,43,2012,4,high,102069,Presencial,2.25,1,Hombre,Linkedin,8,1616000,47.0,80,Casado,52,2017,3,low,-3.6900000000000004,1,-2,922250,1790,0,9
103044,102067,1,Presencial,1.75,1,Mujer,Portal Web,11,895127,82.0,70,Viudo,52,2017,6,high,102058,Presencial,0.92,1,Mujer,Portal Web,5,1616000,90.0,70,Divorciado,46,2020,8,high,-0.83,0,-6,720873,1178,0,-6
100524,102140,1,Presencial,2.3,2,Hombre,Portal Web,3,160749,81.0,61,Soltero,23,2022,8,high,102040,Presencial,2.55,0,Mujer,Portal Web,16,1616000,46.0,69,Casado,39,2012,2,low,0.25,-2,13,1455251,-3836,1,16
101543,102033,1,Presencial,2.725,1,Hombre,Portal Web,9,385097,81.0,81,Casado,26,2012,7,high,102172,Presencial,6.25,2,Mujer,Portal Web,16,1616000,90.0,79,Divorciado,39,2014,5,high,3.525,1,7,1230903,669,0,13
100574,102124,1,Presencial,5.495,0,Hombre,Linkedin,9,388691,81.0,76,Soltero,34,2020,4,high,102099,Presencial,2.84,2,Mujer,Linkedin,4,947000,90.0,70,Soltero,24,2012,10,high,-2.6550000000000002,2,-5,558309,-2734,1,-10
100090,102139,1,Presencial,1.73,1,Mujer,Referidos,10,427089,81.0,85,Casado,38,2021,7,high,102154,Presencial,6.48,1,Hombre,Ferias & Networking,5,590000,90.0,67,Casado,25,2021,6,high,4.75,0,-5,162911,-29,1,-13
101412,102106,1,Presencial,5.715,1,Hombre,Linkedin,5,465748,81.0,83,Soltero,37,2019,11,high,102081,Presencial,1.39,1,Mujer,Ferias & Networking,5,1049000,86.0,86,Soltero,32,2019,6,high,-4.325,0,0,583252,-170,1,-5
101600,102094,1,Presencial,5.19,1,Mujer,Referidos,5,282212,81.0,82,Soltero,41,2018,8,high,102095,Presencial,1.32,1,Hombre,Portal Web,4,998000,90.0,85,Casado,28,2016,2,high,-3.87,0,-1,715788,-934,1,-13
101186,102102,1,Presencial,3.315,12,Hombre,Linkedin,8,800990,81.0,85,Viudo,48,2018,1,high,102018,Presencial,2.48,0,Hombre,Portal Web,5,1616000,92.0,63,Viudo,49,2019,4,high,-0.835,-12,-3,815010,456,0,1
104159,102140,1,Presencial,2.285,1,Hombre,Portal Web,3,155403,81.0,61,Soltero,23,2022,8,high,102040,Presencial,2.55,0,Mujer,Portal Web,16,1616000,46.0,69,Casado,39,2012,2,low,0.2649999999999997,-1,13,1460597,-3837,1,16
104132,102054,1,Presencial,0.92,2,Mujer,Portal Web,2,137738,81.0,72,Soltero,13,2013,5,high,102044,Presencial,2.91,1,Hombre,Linkedin,17,1616000,85.0,74,Divorciado,41,2012,11,high,1.9900000000000002,-1,15,1478262,-201,1,28
102696,102094,1,Presencial,2.18,0,Mujer,Referidos,4,306773,81.0,61,Casado,28,2017,10,high,102095,Presencial,1.32,1,Hombre,Portal Web,4,998000,90.0,85,Casado,28,2016,2,high,-0.8600000000000001,1,0,691227,-636,1,0
103970,102141,1,Presencial,6.465,2,Hombre,Portal Web,2,367417,81.0,72,Soltero,36,2023,6,high,102134,Presencial,1.88,1,Mujer,Linkedin,3,1100900,64.0,69,Soltero,32,2018,5,low,-4.585,-1,1,733483,-1860,1,-4
102562,102156,1,Presencial,2.195,1,Hombre,Portal Web,6,370732,81.0,79,Soltero,35,2022,5,high,102154,Presencial,4.23,2,Hombre,Portal Web,22,1616000,92.0,76,Soltero,63,2023,12,high,2.0350000000000006,1,16,1245268,584,0,28
103259,102124,1,Presencial,5.52,0,Hombre,Linkedin,9,392004,81.0,76,Soltero,34,2020,4,high,102099,Presencial,2.84,2,Mujer,Linkedin,4,947000,90.0,70,Soltero,24,2012,10,high,-2.6799999999999997,2,-5,554996,-2736,1,-10
103117,102139,1,Presencial,1.76,0,Mujer,Referidos,10,424599,81.0,85,Soltero,38,2021,7,high,102154,Presencial,6.48,1,Hombre,Ferias & Networking,5,590000,90.0,67,Casado,25,2021,6,high,4.720000000000001,1,-5,165401,-31,1,-13
103123,102133,1,Presencial,1.775,2,Hombre,Portal Web,5,489949,81.0,75,Casado,42,2022,12,high,102151,Híbrida,2.61,2,Hombre,Linkedin,4,1255430,98.0,65,Soltero,35,2018,2,high,0.835,0,-1,765481,-1757,1,-7
103290,102171,1,Presencial,2.23,2,Mujer,Linkedin,3,641550,81.0,70,Divorciado,50,2022,11,high,102088,Presencial,2.57,4,Hombre,Linkedin,8,1616000,80.0,69,Casado,43,2017,10,high,0.33999999999999986,2,5,974450,-1875,1,-7
101685,102041,1,Presencial,5.125,2,Mujer,Referidos,3,117886,90.0,64,Soltero,14,2015,5,high,102147,Presencial,1.29,0,Mujer,Portal Web,8,1616000,44.0,73,Casado,51,2014,5,low,-3.835,-2,5,1498114,-352,1,37
101329,102054,1,Presencial,0.915,3,Mujer,Portal Web,1,137879,92.0,72,Soltero,13,2013,5,high,102044,Presencial,2.91,1,Hombre,Linkedin,17,1616000,85.0,74,Divorciado,41,2012,11,high,1.995,-2,16,1478121,-201,1,28
101644,102109,1,Presencial,1.78,2,Mujer,Ferias & Networking,3,188343,84.0,80,Soltero,23,2020,8,high,102123,Presencial,3.86,1,Mujer,Portal Web,5,998000,97.0,82,Casado,32,2019,9,high,2.08,-1,2,809657,-315,1,9
102017,102035,2,Presencial,4.62,0,Mujer,Linkedin,2,641000,90.0,84,Casado,25,2019,11,high,102041,Presencial,2.86,1,Hombre,Portal Web,23,1900000,83.0,72,Casado,57,2013,8,high,-1.7600000000000002,1,21,1259000,-2288,1,32
101326,102035,1,Presencial,2.58,2,Hombre,Portal Web,7,346035,83.0,77,Casado,27,2014,9,high,102041,Presencial,2.86,1,Hombre,Portal Web,23,1900000,83.0,72,Casado,57,2013,8,high,0.2799999999999998,-1,16,1553965,-408,1,30
100517,102133,1,Presencial,1.765,3,Hombre,Portal Web,5,486540,81.0,75,Casado,42,2022,12,high,102151,Híbrida,2.61,2,Hombre,Linkedin,4,1255430,98.0,65,Soltero,35,2018,2,high,0.845,-1,-1,768890,-1757,1,-7
100097,102080,1,Presencial,1.42,7,Hombre,Linkedin,3,490389,96.0,80,Casado,37,2018,3,high,102035,Presencial,1.93,0,Mujer,Linkedin,18,1616000,94.0,75,Viudo,47,2016,8,high,0.51,-7,15,1125611,-582,1,10
100395,102151,1,Presencial,3.21,1,Mujer,Referidos,7,278306,98.0,70,Divorciado,46,2022,6,high,102105,Presencial,1.51,2,Hombre,Ferias & Networking,10,1616000,85.0,80,Divorciado,45,2021,11,high,-1.7,1,3,1337694,-204,1,-1
101816,102103,1,Presencial,1.78,2,Hombre,Referidos,7,634817,93.0,74,Soltero,46,2018,12,high,102023,Presencial,1.69,6,Hombre,Portal Web,3,1616000,90.0,74,Casado,45,2013,5,high,-0.09000000000000008,4,-4,981183,-2029,1,-1
101311,102048,1,Presencial,2.805,1,Hombre,Referidos,17,661756,89.0,69,Viudo,42,2014,6,high,102092,Presencial,3.99,0,Mujer,Portal Web,5,590000,59.0,76,Soltero,20,2015,8,low,1.185,-1,-12,-71756,448,0,-22
102055,102129,2,Presencial,1.92,2,Hombre,Referidos,8,1616000,97.0,63,Casado,42,2013,2,high,102142,Presencial,2.1,2,Mujer,Linkedin,3,590000,41.0,74,Soltero,24,2020,1,low,0.18000000000000016,0,-5,-1026000,2507,0,-18
102948,102129,1,Presencial,6.6,1,Mujer,Ferias & Networking,9,424742,82.0,67,Casado,39,2023,1,high,102142,Presencial,2.1,2,Mujer,Linkedin,3,590000,41.0,74,Soltero,24,2020,1,low,-4.5,1,-6,165258,-1092,1,-15
103875,102080,1,Presencial,1.44,8,Hombre,Linkedin,3,485403,96.0,80,Casado,37,2018,3,high,102035,Presencial,1.93,0,Mujer,Linkedin,18,1616000,94.0,75,Viudo,47,2016,8,high,0.49,-8,15,1130597,-583,1,10
102613,102041,1,Presencial,2.17,0,Mujer,Linkedin,3,269208,94.0,78,Casado,34,2012,4,high,102147,Presencial,1.29,0,Mujer,Portal Web,8,1616000,44.0,73,Casado,51,2014,5,low,-0.8799999999999999,0,5,1346792,767,0,17
103109,102065,1,Presencial,1.355,2,Hombre,Portal Web,7,437030,89.0,69,Casado,40,2016,12,high,102026,Presencial,2.44,2,Hombre,Ferias & Networking,13,1616000,45.0,60,Divorciado,35,2014,10,low,1.085,0,6,1178970,-816,1,-5
103191,102048,1,Presencial,2.795,2,Hombre,Referidos,17,654623,93.0,69,Viudo,42,2014,6,high,102092,Presencial,3.99,0,Mujer,Portal Web,5,590000,59.0,76,Soltero,20,2015,8,low,1.1950000000000003,-2,-12,-64623,447,0,-22
103047,102141,1,Presencial,1.83,1,Mujer,Referidos,17,835673,83.0,70,Soltero,52,2022,10,high,102134,Presencial,1.88,1,Mujer,Linkedin,3,1100900,64.0,69,Soltero,32,2018,5,low,0.04999999999999982,0,-14,265227,-1598,1,-20
103773,102074,1,Presencial,0.21,2,Mujer,Linkedin,5,720121,81.0,74,Casado,49,2017,9,high,102028,Presencial,1.35,0,Hombre,Ferias & Networking,4,1616000,80.0,83,Viudo,43,2015,12,high,1.1400000000000001,-2,-1,895879,-640,1,-6
102488,102169,1,Presencial,1.75,1,Mujer,Referidos,13,735658,97.0,75,Divorciado,55,2023,3,high,102115,Presencial,2.24,7,Mujer,Linkedin,11,1616000,93.0,74,Soltero,55,2021,4,high,0.4900000000000002,6,-2,880342,-705,1,0
100489,102049,1,Presencial,6.02,2,Hombre,Ferias & Networking,1,122376,92.0,78,Soltero,12,2013,6,high,102029,Presencial,6.89,0,Mujer,Portal Web,9,1616000,19.0,77,Divorciado,49,2023,3,low,0.8700000000000001,-2,8,1493624,3550,0,37
100061,102088,1,Presencial,1.95,2,Hombre,Ferias & Networking,2,138088,84.0,73,Soltero,19,2019,3,high,102139,Presencial,4.96,1,Mujer,Portal Web,3,488000,82.0,65,Soltero,20,2018,4,high,3.01,-1,1,349912,-340,1,1
101830,102016,1,Presencial,1.955,2,Mujer,Portal Web,6,272802,84.0,83,Soltero,21,2012,11,high,102008,Híbrida,2.51,2,Mujer,Portal Web,6,1616000,40.0,80,Casado,44,2017,8,low,0.5549999999999997,0,0,1343198,1759,0,23
101229,102064,1,Presencial,2.19,1,Hombre,Portal Web,5,371029,92.0,72,Soltero,28,2015,3,high,102067,Presencial,1.34,0,Hombre,Portal Web,6,1616000,92.0,92,Casado,43,2018,2,high,-0.8499999999999999,-1,1,1244971,1051,0,15
102126,102141,2,Presencial,2.5,1,Mujer,Referidos,2,1049000,94.0,79,Casado,34,2021,1,high,102134,Presencial,1.88,1,Mujer,Linkedin,3,1100900,64.0,69,Soltero,32,2018,5,low,-0.6200000000000001,0,1,51900,-961,1,-2
100727,102141,1,Presencial,3.335,2,Hombre,Linkedin,11,487532,81.0,62,Soltero,41,2021,11,high,102134,Presencial,1.88,1,Mujer,Linkedin,3,1100900,64.0,69,Soltero,32,2018,5,low,-1.455,-1,-8,613368,-1281,1,-9
101487,102053,1,Presencial,1.355,0,Mujer,Ferias & Networking,13,266769,80.0,77,Casado,35,2013,4,high,102030,Presencial,1.29,0,Hombre,Portal Web,11,1616000,81.0,64,Soltero,36,2012,12,high,-0.06499999999999995,0,-2,1349231,-102,1,1
101649,102039,1,Presencial,3.805,2,Hombre,Referidos,10,302137,96.0,83,Casado,39,2013,7,high,102054,Presencial,3.66,0,Hombre,Referidos,5,1616000,93.0,75,Viudo,49,2018,6,high,-0.14500000000000002,-2,-5,1313863,1789,0,10
100036,102048,1,Presencial,3.4,2,Mujer,Portal Web,9,444574,90.0,81,Viudo,39,2013,4,high,102092,Presencial,3.99,0,Mujer,Portal Web,5,590000,59.0,76,Soltero,20,2015,8,low,0.5900000000000003,-2,-4,145426,846,0,-19
100811,102116,1,Presencial,5.99,2,Hombre,Linkedin,11,636725,85.0,80,Casado,46,2018,12,high,102021,Presencial,2.32,0,Mujer,Portal Web,22,1616000,94.0,76,Casado,59,2020,7,high,-3.6700000000000004,-2,11,979275,567,0,13
100039,102141,1,Presencial,1.825,1,Mujer,Referidos,17,834568,82.0,70,Soltero,52,2022,10,high,102134,Presencial,1.88,1,Mujer,Linkedin,3,1100900,64.0,69,Soltero,32,2018,5,low,0.05499999999999994,0,-14,266332,-1596,1,-20
101663,102122,1,Presencial,7.0,2,Mujer,Ferias & Networking,8,675433,92.0,81,Soltero,51,2021,9,high,102075,Presencial,1.83,4,Hombre,Portal Web,6,1616000,90.0,66,Viudo,48,2019,3,high,-5.17,2,-2,940567,-919,1,-3
101811,102074,1,Presencial,0.215,2,Mujer,Linkedin,5,713597,82.0,74,Casado,49,2017,9,high,102028,Presencial,1.35,0,Hombre,Ferias & Networking,4,1616000,80.0,83,Viudo,43,2015,12,high,1.135,-2,-1,902403,-640,1,-6
102040,102106,2,Presencial,3.21,1,Hombre,Linkedin,15,1616000,91.0,84,Soltero,45,2016,7,high,102081,Presencial,1.39,1,Mujer,Ferias & Networking,5,1049000,86.0,86,Soltero,32,2019,6,high,-1.82,0,-10,-567000,1057,0,-13
101164,102106,1,Presencial,2.035,3,Hombre,Referidos,6,799744,91.0,70,Viudo,53,2019,10,high,102081,Presencial,1.39,1,Mujer,Ferias & Networking,5,1049000,86.0,86,Soltero,32,2019,6,high,-0.6450000000000002,-2,-1,249256,-129,1,-21
101253,102096,1,Presencial,4.955,2,Hombre,Ferias & Networking,11,918287,94.0,80,Soltero,53,2019,4,high,102116,Presencial,5.11,8,Mujer,Linkedin,13,1461470,90.0,74,Soltero,42,2021,5,high,0.15500000000000025,6,2,543183,749,0,-11
104068,102123,1,Presencial,2.49,9,Hombre,Linkedin,6,309963,92.0,69,Soltero,30,2019,11,high,102043,Presencial,5.5,1,Mujer,Linkedin,16,1616000,42.0,66,Soltero,51,2021,9,low,3.01,-8,10,1306037,686,0,21
103239,102036,1,Presencial,1.02,1,Mujer,Portal Web,4,364884,95.0,79,Casado,25,2012,6,high,102054,Presencial,1.68,8,Hombre,Portal Web,5,1616000,92.0,76,Viudo,54,2022,1,high,0.6599999999999999,7,1,1251116,3487,0,29
103554,102073,1,Presencial,2.98,5,Mujer,Portal Web,5,448709,97.0,75,Casado,33,2016,10,high,102139,Presencial,1.98,2,Hombre,Portal Web,11,1306940,95.0,86,Soltero,37,2019,7,high,-1.0,-3,6,858231,1009,0,4
102377,102053,1,Presencial,1.35,1,Mujer,Ferias & Networking,13,264732,90.0,77,Casado,35,2013,4,high,102030,Presencial,1.29,0,Hombre,Portal Web,11,1616000,81.0,64,Soltero,36,2012,12,high,-0.06000000000000005,-1,-2,1351268,-101,1,1
103527,102151,1,Presencial,3.19,0,Mujer,Referidos,7,280210,84.0,70,Divorciado,46,2022,6,high,102105,Presencial,1.51,2,Hombre,Ferias & Networking,10,1616000,85.0,80,Divorciado,45,2021,11,high,-1.68,2,3,1335790,-202,1,-1
102230,102039,1,Presencial,3.81,1,Hombre,Referidos,11,296620,81.0,83,Casado,39,2013,7,high,102054,Presencial,3.66,0,Hombre,Referidos,5,1616000,93.0,75,Viudo,49,2018,6,high,-0.1499999999999999,-1,-6,1319380,1787,0,10
103298,102122,1,Presencial,6.99,2,Mujer,Ferias & Networking,8,676796,89.0,81,Soltero,51,2021,9,high,102075,Presencial,1.83,4,Hombre,Portal Web,6,1616000,90.0,66,Viudo,48,2019,3,high,-5.16,2,-2,939204,-920,1,-3
102810,102108,1,Presencial,4.57,1,Hombre,Linkedin,14,917727,94.0,80,Divorciado,55,2018,4,high,102040,Presencial,2.92,1,Mujer,Portal Web,5,1616000,46.0,75,Casado,50,2023,5,low,-1.6500000000000004,0,-9,698273,1865,0,-5
100772,102055,1,Presencial,1.28,0,Hombre,Portal Web,1,95554,93.0,84,Soltero,15,2016,5,high,102129,Presencial,1.92,2,Hombre,Referidos,8,1616000,97.0,63,Casado,42,2013,2,high,0.6399999999999999,2,7,1520446,-1172,1,27
101802,102115,1,Presencial,2.22,9,Mujer,Portal Web,2,183038,89.0,74,Casado,23,2020,8,high,102116,Presencial,2.0,2,Mujer,Portal Web,4,1616000,94.0,76,Soltero,35,2018,12,high,-0.2200000000000002,-7,2,1432962,-598,1,12
101283,102035,1,Presencial,3.845,5,Hombre,Portal Web,3,250604,80.0,85,Casado,21,2014,10,high,102041,Presencial,2.86,1,Hombre,Portal Web,23,1900000,83.0,72,Casado,57,2013,8,high,-0.9850000000000003,-4,20,1649396,-431,1,36
101942,102040,1,Presencial,2.38,3,Hombre,Linkedin,4,369235,85.0,75,Casado,25,2012,3,high,102106,Presencial,3.21,1,Hombre,Linkedin,15,1616000,91.0,84,Soltero,45,2016,7,high,0.8300000000000001,-2,11,1246765,1578,0,20
101763,102168,1,Presencial,4.385,0,Hombre,Portal Web,5,388388,94.0,74,Soltero,37,2023,3,high,102172,Presencial,6.22,1,Hombre,Referidos,15,1616000,75.0,68,Viudo,42,2012,1,low,1.835,1,10,1227612,-4094,1,5
100396,102073,1,Presencial,2.97,4,Mujer,Portal Web,5,452748,94.0,75,Casado,33,2016,10,high,102139,Presencial,1.98,2,Hombre,Portal Web,11,1306940,95.0,86,Soltero,37,2019,7,high,-0.9900000000000002,-2,6,854192,1010,0,4
101042,102107,1,Presencial,1.74,8,Hombre,Linkedin,5,491043,92.0,74,Casado,39,2020,5,high,102069,Presencial,2.4,1,Mujer,Linkedin,8,1616000,47.0,79,Casado,63,2023,6,low,0.6599999999999999,-7,3,1124957,1142,0,24
100083,102104,1,Presencial,1.535,0,Mujer,Referidos,9,375428,96.0,82,Soltero,45,2020,7,high,102129,Híbrida,6.72,1,Mujer,Portal Web,6,743000,91.0,61,Soltero,30,2023,4,high,5.185,1,-3,367572,985,0,-15
101519,102075,1,Presencial,1.74,0,Hombre,Portal Web,13,300186,98.0,81,Viudo,43,2018,4,high,102047,Presencial,2.7,1,Hombre,Referidos,11,1255430,90.0,76,Casado,30,2013,3,high,0.9600000000000002,1,-2,955244,-1831,1,-13
101462,102100,1,Presencial,1.89,3,Mujer,Portal Web,7,633919,88.0,72,Divorciado,44,2017,12,high,102007,Presencial,3.3,1,Mujer,Portal Web,3,1255430,21.0,59,Casado,30,2013,2,low,1.41,-2,-4,621511,-1776,1,-14
100418,102069,1,Presencial,1.915,1,Mujer,Linkedin,13,305163,93.0,74,Divorciado,40,2014,7,high,102069,Presencial,4.64,1,Mujer,Ferias & Networking,19,1616000,47.0,74,Casado,60,2021,10,low,2.7249999999999996,0,6,1310837,2645,0,20
100566,102031,1,Presencial,1.915,0,Hombre,Linkedin,7,680810,95.0,82,Divorciado,43,2014,7,high,102111,Presencial,2.95,2,Hombre,Portal Web,8,1610000,76.0,87,Casado,31,2017,7,low,1.0350000000000001,2,1,929190,1085,0,-12
100536,102080,1,Presencial,3.765,1,Mujer,Linkedin,7,699307,87.0,70,Divorciado,49,2018,10,high,102035,Presencial,1.93,0,Mujer,Linkedin,18,1616000,94.0,75,Viudo,47,2016,8,high,-1.8350000000000002,-1,11,916693,-788,1,-2
100558,102031,1,Presencial,5.45,1,Hombre,Ferias & Networking,5,695178,90.0,79,Soltero,43,2013,1,high,102111,Presencial,2.95,2,Hombre,Portal Web,8,1610000,76.0,87,Casado,31,2017,7,low,-2.5,1,3,914822,1615,0,-12
104046,102132,1,Presencial,2.805,14,Mujer,Linkedin,2,136423,87.0,72,Soltero,22,2022,1,high,102138,Presencial,4.51,1,Hombre,Linkedin,16,1616000,25.0,80,Viudo,45,2014,3,low,1.7049999999999996,-13,14,1479577,-2848,1,23
104065,102088,1,Presencial,1.97,2,Hombre,Ferias & Networking,2,138150,84.0,73,Soltero,19,2019,3,high,102139,Presencial,4.96,1,Mujer,Portal Web,3,488000,82.0,65,Soltero,20,2018,4,high,2.99,-1,1,349850,-337,1,1
102362,102124,1,Presencial,3.47,2,Mujer,Portal Web,1,167169,82.0,61,Soltero,23,2021,4,high,102099,Presencial,2.84,2,Mujer,Linkedin,4,947000,90.0,70,Soltero,24,2012,10,high,-0.6300000000000003,0,3,779831,-3100,1,1
103742,102127,1,Presencial,1.5,1,Hombre,Linkedin,1,227910,83.0,71,Soltero,26,2020,4,high,102028,Presencial,4.03,2,Mujer,Linkedin,9,1306940,88.0,78,Divorciado,32,2014,5,high,2.5300000000000002,1,8,1079030,-2163,1,6
103409,102129,1,Presencial,1.215,2,Hombre,Portal Web,6,288172,82.0,71,Casado,30,2021,3,high,102142,Presencial,2.1,2,Mujer,Linkedin,3,590000,41.0,74,Soltero,24,2020,1,low,0.885,0,-3,301828,-430,1,-6
104067,102066,1,Presencial,1.705,2,Mujer,Portal Web,6,289865,84.0,84,Soltero,25,2016,5,high,102171,Presencial,3.62,3,Hombre,Referidos,5,1616000,97.0,84,Casado,55,2023,12,high,1.915,1,-1,1326135,2759,0,30
102395,102111,1,Presencial,1.805,4,Mujer,Portal Web,3,327270,91.0,77,Casado,31,2019,8,high,102097,Híbrida,2.04,1,Mujer,Referidos,15,1616000,94.0,67,Soltero,50,2021,5,high,0.2350000000000001,-3,12,1288730,639,0,19
103994,102040,1,Presencial,1.75,6,Mujer,Linkedin,5,368088,88.0,70,Soltero,28,2015,6,high,102106,Presencial,3.21,1,Hombre,Linkedin,15,1616000,91.0,84,Soltero,45,2016,7,high,1.46,-5,10,1247912,389,0,17
103574,102064,1,Presencial,2.2,2,Hombre,Portal Web,5,371715,87.0,72,Soltero,28,2015,3,high,102067,Presencial,1.34,0,Hombre,Portal Web,6,1616000,92.0,92,Casado,43,2018,2,high,-0.8600000000000001,-2,1,1244285,1051,0,15
103668,102116,1,Presencial,1.875,10,Hombre,Portal Web,3,389097,83.0,80,Casado,35,2021,1,high,102021,Presencial,2.32,0,Mujer,Portal Web,22,1616000,94.0,76,Casado,59,2020,7,high,0.44499999999999984,-10,19,1226903,-183,1,24
102228,102128,1,Presencial,1.55,1,Mujer,Portal Web,4,445437,98.0,72,Casado,39,2021,7,high,102056,Presencial,4.11,10,Mujer,Portal Web,16,1616000,46.0,72,Soltero,55,2021,2,low,2.5600000000000005,9,12,1170563,-148,1,16
102471,102072,1,Presencial,1.84,3,Hombre,Portal Web,5,264110,92.0,84,Soltero,40,2017,9,high,102046,Presencial,2.61,2,Hombre,Ferias & Networking,3,947000,41.0,71,Soltero,30,2018,11,low,0.7699999999999998,-1,-2,682890,449,0,-10
103194,102048,1,Presencial,3.4,2,Mujer,Portal Web,9,443206,81.0,81,Viudo,38,2013,4,high,102092,Presencial,3.99,0,Mujer,Portal Web,5,590000,59.0,76,Soltero,20,2015,8,low,0.5900000000000003,-2,-4,146794,846,0,-18
103097,102116,1,Presencial,6.03,2,Hombre,Linkedin,11,635455,97.0,80,Casado,46,2018,12,high,102021,Presencial,2.32,0,Mujer,Portal Web,22,1616000,94.0,76,Casado,59,2020,7,high,-3.7100000000000004,-2,11,980545,567,0,13
102767,102100,1,Presencial,1.89,3,Mujer,Portal Web,7,634051,88.0,72,Divorciado,45,2017,12,high,102007,Presencial,3.3,1,Mujer,Portal Web,3,1255430,21.0,59,Casado,30,2013,2,low,1.41,-2,-4,621379,-1777,1,-15
103826,102069,1,Presencial,3.6,5,Hombre,Linkedin,4,678529,90.0,83,Viudo,44,2015,1,high,102069,Presencial,4.64,1,Mujer,Ferias & Networking,19,1616000,47.0,74,Casado,60,2021,10,low,1.0399999999999996,-4,15,937471,2486,0,16
102603,102035,1,Presencial,2.02,1,Hombre,Portal Web,16,819421,83.0,78,Soltero,44,2013,11,high,102041,Presencial,2.86,1,Hombre,Portal Web,23,1900000,83.0,72,Casado,57,2013,8,high,0.8399999999999999,0,7,1080579,-112,1,13
101477,102049,1,Presencial,6.33,8,Mujer,Linkedin,1,103393,83.0,76,Soltero,12,2013,10,high,102029,Presencial,6.89,0,Mujer,Portal Web,9,1616000,19.0,77,Divorciado,49,2023,3,low,0.5599999999999996,-8,8,1512607,3435,0,37
101530,102110,1,Presencial,7.04,0,Mujer,Portal Web,2,120345,93.0,77,Soltero,17,2018,4,high,102045,Presencial,1.6,5,Mujer,Linkedin,2,998000,87.0,76,Soltero,29,2016,11,high,-5.4399999999999995,5,0,877655,-517,1,12
100449,102126,1,Presencial,5.46,1,Hombre,Portal Web,2,142786,91.0,83,Soltero,22,2020,8,high,102141,Presencial,2.5,1,Mujer,Referidos,2,1049000,94.0,79,Casado,34,2021,1,high,-2.96,0,0,906214,163,0,12
100068,102076,1,Presencial,2.145,2,Hombre,Portal Web,4,207920,95.0,72,Casado,21,2016,4,high,102168,Híbrida,1.95,1,Hombre,Referidos,9,1616000,95.0,82,Soltero,53,2023,9,high,-0.19500000000000006,-1,5,1408080,2698,0,32
101927,102127,1,Presencial,1.49,1,Hombre,Linkedin,1,228002,98.0,71,Soltero,26,2020,4,high,102028,Presencial,4.03,2,Mujer,Linkedin,9,1306940,88.0,78,Divorciado,32,2014,5,high,2.54,1,8,1078938,-2163,1,6
100905,102067,1,Presencial,1.27,9,Hombre,Linkedin,3,231757,96.0,75,Divorciado,20,2014,8,high,102058,Presencial,0.92,1,Mujer,Portal Web,5,1616000,90.0,70,Divorciado,46,2020,8,high,-0.35,-8,2,1384243,2211,0,26
101006,102062,1,Presencial,2.25,0,Hombre,Linkedin,5,230777,83.0,75,Soltero,21,2014,8,high,102149,Presencial,0.92,2,Mujer,Referidos,6,692000,38.0,72,Soltero,21,2014,10,low,-1.33,2,1,461223,57,0,0
102148,102116,2,Presencial,1.49,2,Mujer,Portal Web,2,539000,80.0,67,Soltero,26,2022,12,high,102021,Presencial,2.32,0,Mujer,Portal Web,22,1616000,94.0,76,Casado,59,2020,7,high,0.8299999999999998,-2,20,1077000,-874,1,33
101992,102116,1,Presencial,1.89,11,Hombre,Portal Web,3,389994,88.0,80,Casado,35,2021,1,high,102021,Presencial,2.32,0,Mujer,Portal Web,22,1616000,94.0,76,Casado,59,2020,7,high,0.42999999999999994,-11,19,1226006,-186,1,24
100044,102151,1,Presencial,3.63,2,Hombre,Ferias & Networking,8,432816,98.0,78,Casado,37,2021,11,high,102105,Presencial,1.51,2,Hombre,Ferias & Networking,10,1616000,85.0,80,Divorciado,45,2021,11,high,-2.12,0,2,1183184,1,0,8
102007,102070,2,Presencial,5.11,2,Mujer,Portal Web,6,1358450,96.0,62,Soltero,41,2022,4,high,102035,Presencial,1.7,1,Mujer,Referidos,4,1616000,77.0,73,Viudo,38,2013,3,low,-3.41,-1,-2,257550,-3327,1,-3
101399,102070,1,Presencial,2.27,1,Mujer,Portal Web,10,292008,86.0,74,Soltero,39,2015,4,high,102035,Presencial,1.7,1,Mujer,Referidos,4,1616000,77.0,73,Viudo,38,2013,3,low,-0.5700000000000001,0,-6,1323992,-763,1,-1
102161,102039,2,Presencial,3.93,5,Mujer,Portal Web,4,1409960,85.0,77,Casado,36,2016,10,high,102054,Presencial,3.66,0,Hombre,Referidos,5,1616000,93.0,75,Viudo,49,2018,6,high,-0.27,-5,1,206040,607,0,13
100025,102039,1,Presencial,3.315,1,Hombre,Portal Web,15,761792,85.0,67,Viudo,40,2013,1,high,102054,Presencial,3.66,0,Hombre,Referidos,5,1616000,93.0,75,Viudo,49,2018,6,high,0.3450000000000002,-1,-10,854208,1985,0,9
100457,102112,1,Presencial,1.27,8,Hombre,Portal Web,4,656313,97.0,87,Viudo,49,2020,11,high,102031,Presencial,2.27,7,Hombre,Linkedin,1,692000,83.0,74,Soltero,26,2020,6,high,1.0,-1,-3,35687,-157,1,-23
100260,102022,1,Presencial,2.05,1,Mujer,Portal Web,5,678305,95.0,70,Viudo,42,2012,10,high,102081,Presencial,2.07,0,Hombre,Portal Web,6,1616000,94.0,66,Viudo,47,2020,5,high,0.020000000000000018,-1,1,937695,2792,0,5
101280,102068,1,Presencial,2.01,1,Mujer,Portal Web,9,720206,88.0,79,Casado,47,2016,8,high,102043,Híbrida,2.17,3,Mujer,Referidos,4,896000,41.0,81,Soltero,23,2012,8,low,0.16000000000000014,2,-5,175794,-1448,1,-24
101331,102091,1,Presencial,2.37,2,Hombre,Referidos,8,737328,93.0,81,Casado,49,2017,1,high,102149,Presencial,1.54,1,Mujer,Portal Web,4,1616000,73.0,77,Casado,39,2014,12,low,-0.8300000000000001,-1,-4,878672,-751,1,-10
101057,102040,1,Presencial,1.6,8,Mujer,Portal Web,10,899738,95.0,72,Divorciado,45,2012,6,high,102106,Presencial,3.21,1,Hombre,Linkedin,15,1616000,91.0,84,Soltero,45,2016,7,high,1.6099999999999999,-7,5,716262,1499,0,0
102001,102018,2,Presencial,1.58,1,Mujer,Linkedin,8,1616000,81.0,76,Casado,51,2023,2,high,102160,Presencial,5.57,5,Hombre,Portal Web,3,692000,90.0,69,Divorciado,28,2022,2,high,3.99,4,-5,-924000,-358,1,-23
102102,102018,2,Presencial,2.48,0,Hombre,Portal Web,5,1616000,92.0,63,Viudo,49,2019,4,high,102160,Presencial,5.57,5,Hombre,Portal Web,3,692000,90.0,69,Divorciado,28,2022,2,high,3.0900000000000003,5,-2,-924000,1046,0,-21
101779,102018,1,Presencial,1.57,2,Mujer,Linkedin,14,878820,81.0,78,Soltero,49,2013,1,high,102160,Presencial,5.57,5,Hombre,Portal Web,3,692000,90.0,69,Divorciado,28,2022,2,high,4.0,3,-11,-186820,3342,0,-21
102169,102115,2,Presencial,2.24,7,Mujer,Linkedin,11,1616000,93.0,74,Soltero,55,2021,4,high,102116,Presencial,2.0,2,Mujer,Portal Web,4,1616000,94.0,76,Soltero,35,2018,12,high,-0.2400000000000002,-5,-7,0,-828,1,-20
102656,102115,1,Presencial,2.225,8,Mujer,Portal Web,2,181703,89.0,74,Casado,23,2020,8,high,102116,Presencial,2.0,2,Mujer,Portal Web,4,1616000,94.0,76,Soltero,35,2018,12,high,-0.2250000000000001,-6,2,1434297,-596,1,12
102607,102035,1,Presencial,3.85,5,Hombre,Portal Web,3,253366,95.0,85,Casado,21,2014,10,high,102041,Presencial,2.86,1,Hombre,Portal Web,23,1900000,83.0,72,Casado,57,2013,8,high,-0.9900000000000002,-4,20,1646634,-430,1,36
104039,102137,1,Presencial,1.27,0,Hombre,Portal Web,6,365149,83.0,62,Soltero,34,2021,1,high,102046,Presencial,1.18,0,Mujer,Portal Web,2,845000,37.0,79,Casado,27,2017,12,low,-0.09000000000000008,0,-4,479851,-1109,1,-7
103045,102114,1,Presencial,0.205,3,Mujer,Linkedin,4,825970,89.0,75,Soltero,37,2020,8,high,102050,Presencial,1.44,1,Mujer,Portal Web,5,1616000,91.0,69,Divorciado,47,2021,5,high,1.2349999999999999,-2,1,790030,288,0,10
102184,102069,1,Presencial,2.985,1,Mujer,Ferias & Networking,4,824319,87.0,66,Casado,35,2017,1,high,102069,Presencial,4.64,1,Mujer,Ferias & Networking,19,1616000,47.0,74,Casado,60,2021,10,low,1.6549999999999998,0,15,791681,1745,0,25
103481,102107,1,Presencial,1.755,8,Hombre,Linkedin,5,485681,96.0,74,Casado,39,2020,5,high,102069,Presencial,2.4,1,Mujer,Linkedin,8,1616000,47.0,79,Casado,63,2023,6,low,0.645,-7,3,1130319,1139,0,24
103884,102119,1,Presencial,3.545,3,Mujer,Referidos,6,258170,86.0,69,Casado,40,2018,12,high,102107,Presencial,2.22,2,Hombre,Portal Web,12,1616000,38.0,70,Divorciado,52,2021,1,low,-1.3249999999999997,-1,6,1357830,751,0,12
102185,102021,1,Presencial,2.465,1,Hombre,Linkedin,11,399263,92.0,66,Casado,36,2013,9,high,102069,Presencial,2.25,1,Hombre,Linkedin,8,1616000,47.0,80,Casado,52,2017,3,low,-0.21499999999999986,0,-3,1216737,1283,0,16
103852,102122,1,Presencial,2.27,1,Mujer,Linkedin,8,273749,81.0,63,Divorciado,44,2021,2,high,102075,Presencial,1.83,4,Hombre,Portal Web,6,1616000,90.0,66,Viudo,48,2019,3,high,-0.43999999999999995,3,-2,1342251,-687,1,4
102478,102104,1,Presencial,1.52,0,Mujer,Referidos,9,381403,94.0,82,Soltero,45,2020,7,high,102129,Híbrida,6.72,1,Mujer,Portal Web,6,743000,91.0,61,Soltero,30,2023,4,high,5.199999999999999,1,-3,361597,982,0,-15
102974,102089,1,Presencial,1.37,1,Hombre,Referidos,8,309419,92.0,85,Divorciado,44,2018,11,high,102077,Presencial,2.75,1,Hombre,Ferias & Networking,6,1616000,96.0,69,Divorciado,60,2021,10,high,1.38,0,-2,1306581,1080,0,16
102716,102114,1,Presencial,3.585,2,Mujer,Portal Web,4,308293,87.0,77,Divorciado,44,2018,9,high,102050,Presencial,1.44,1,Mujer,Portal Web,5,1616000,91.0,69,Divorciado,47,2021,5,high,-2.145,-1,1,1307707,970,0,3
102388,102039,1,Presencial,3.33,1,Hombre,Portal Web,15,758777,87.0,67,Viudo,40,2013,1,high,102054,Presencial,3.66,0,Hombre,Referidos,5,1616000,93.0,75,Viudo,49,2018,6,high,0.33000000000000007,-1,-10,857223,1984,0,9
102728,102112,1,Presencial,1.25,8,Hombre,Portal Web,4,655701,91.0,87,Viudo,49,2020,11,high,102031,Presencial,2.27,7,Hombre,Linkedin,1,692000,83.0,74,Soltero,26,2020,6,high,1.02,-1,-3,36299,-156,1,-23
103400,102139,1,Presencial,2.155,1,Mujer,Linkedin,11,701574,84.0,72,Viudo,52,2022,2,high,102154,Presencial,6.48,1,Hombre,Ferias & Networking,5,590000,90.0,67,Casado,25,2021,6,high,4.325000000000001,0,-6,-111574,-242,1,-27
102576,102080,1,Presencial,3.755,1,Mujer,Linkedin,7,702009,80.0,70,Divorciado,49,2018,10,high,102035,Presencial,1.93,0,Mujer,Linkedin,18,1616000,94.0,75,Viudo,47,2016,8,high,-1.825,-1,11,913991,-789,1,-2
102658,102039,1,Presencial,2.61,1,Hombre,Portal Web,17,721813,91.0,76,Divorciado,44,2013,9,high,102054,Presencial,3.66,0,Hombre,Referidos,5,1616000,93.0,75,Viudo,49,2018,6,high,1.0500000000000003,-1,-12,894187,1738,0,5
100896,102028,1,Presencial,6.235,3,Hombre,Linkedin,1,95610,80.0,75,Soltero,12,2013,4,high,102085,Presencial,1.39,2,Mujer,Linkedin,12,1358450,97.0,72,Soltero,35,2016,12,high,-4.845000000000001,-1,11,1262840,1345,0,23
100883,102172,1,Presencial,2.18,1,Mujer,Ferias & Networking,4,250238,84.0,75,Casado,30,2022,8,high,102020,Presencial,5.58,1,Hombre,Portal Web,7,1049000,57.0,70,Casado,29,2016,4,low,3.4,0,3,798762,-2303,1,-1
100825,102100,1,Presencial,4.535,8,Mujer,Linkedin,5,293716,87.0,79,Soltero,27,2017,9,high,102007,Presencial,3.3,1,Mujer,Portal Web,3,1255430,21.0,59,Casado,30,2013,2,low,-1.2350000000000003,-7,-2,961714,-1676,1,3
102052,102093,2,Presencial,4.45,0,Hombre,Linkedin,5,641000,84.0,76,Divorciado,17,2012,4,high,102139,Presencial,5.41,0,Mujer,Ferias & Networking,4,488000,89.0,62,Soltero,23,2021,6,high,0.96,0,-1,-153000,3362,0,6
101625,102093,1,Presencial,2.52,2,Hombre,Ferias & Networking,6,349225,81.0,83,Soltero,31,2019,3,high,102139,Presencial,5.41,0,Mujer,Ferias & Networking,4,488000,89.0,62,Soltero,23,2021,6,high,2.89,-2,-2,138775,831,0,-8
100447,102035,1,Presencial,5.09,1,Mujer,Portal Web,4,350850,91.0,71,Casado,26,2014,1,high,102041,Presencial,2.86,1,Hombre,Portal Web,23,1900000,83.0,72,Casado,57,2013,8,high,-2.23,0,19,1549150,-166,1,31
101670,102069,1,Presencial,2.94,1,Mujer,Headhunter,4,828652,95.0,66,Casado,35,2017,1,high,102069,Presencial,4.64,1,Mujer,Ferias & Networking,19,1616000,47.0,74,Casado,60,2021,10,low,1.6999999999999997,0,15,787348,1746,0,25
101895,102094,1,Presencial,1.905,3,Hombre,Portal Web,15,279538,89.0,76,Casado,42,2019,5,high,102095,Presencial,1.32,1,Hombre,Portal Web,4,998000,90.0,85,Casado,28,2016,2,high,-0.585,-2,-11,718462,-1212,1,-14
101571,102078,1,Presencial,3.775,9,Hombre,Linkedin,8,297929,82.0,66,Soltero,42,2016,8,high,102143,Presencial,2.17,1,Hombre,Ferias & Networking,9,998000,83.0,76,Casado,29,2017,5,high,-1.605,-8,1,700071,294,0,-13
102151,102105,2,Presencial,1.51,2,Hombre,Ferias & Networking,10,1616000,85.0,80,Divorciado,45,2021,11,high,102113,Híbrida,2.07,0,Hombre,Linkedin,8,1616000,85.0,71,Viudo,45,2017,3,high,0.5599999999999998,-2,-2,0,-1695,1,0
100115,102105,1,Presencial,3.3,7,Mujer,Linkedin,8,681281,84.0,81,Casado,46,2017,8,high,102113,Híbrida,2.07,0,Hombre,Linkedin,8,1616000,85.0,71,Viudo,45,2017,3,high,-1.23,-7,0,934719,-145,1,-1
101198,102039,1,Presencial,2.6,2,Hombre,Portal Web,17,721244,95.0,76,Divorciado,45,2013,9,high,102054,Presencial,3.66,0,Hombre,Referidos,5,1616000,93.0,75,Viudo,49,2018,6,high,1.06,-2,-12,894756,1737,0,4
102135,102028,2,Presencial,2.04,1,Hombre,Portal Web,2,1616000,82.0,75,Divorciado,49,2017,10,high,102085,Presencial,1.39,2,Mujer,Linkedin,12,1358450,97.0,72,Soltero,35,2016,12,high,-0.6500000000000001,1,10,-257550,-283,1,-14
103612,102028,1,Presencial,6.235,2,Hombre,Linkedin,1,100876,85.0,75,Soltero,12,2013,4,high,102085,Presencial,1.39,2,Mujer,Linkedin,12,1358450,97.0,72,Soltero,35,2016,12,high,-4.845000000000001,0,11,1257574,1346,0,23
104141,102097,1,Presencial,1.69,9,Mujer,Portal Web,1,120730,80.0,74,Soltero,16,2017,3,high,102024,Presencial,1.95,6,Hombre,Portal Web,4,1100900,57.0,77,Soltero,31,2016,10,low,0.26,-3,3,980170,-139,1,15
102820,102078,1,Presencial,2.0,2,Hombre,Referidos,5,189534,96.0,78,Soltero,22,2018,2,high,102143,Presencial,2.17,1,Hombre,Ferias & Networking,9,998000,83.0,76,Casado,29,2017,5,high,0.16999999999999993,-1,4,808466,-266,1,7
102884,102100,1,Presencial,4.535,9,Mujer,Linkedin,5,290456,83.0,79,Viudo,26,2017,9,high,102007,Presencial,3.3,1,Mujer,Portal Web,3,1255430,21.0,59,Casado,30,2013,2,low,-1.2350000000000003,-8,-2,964974,-1676,1,4
103161,102056,1,Presencial,5.815,1,Mujer,Linkedin,6,311984,97.0,71,Soltero,24,2014,5,high,102014,Presencial,5.24,1,Hombre,Ferias & Networking,16,1616000,70.0,63,Viudo,65,2023,3,low,-0.5750000000000002,0,10,1304016,3210,0,41
102726,102068,1,Presencial,5.26,1,Mujer,Ferias & Networking,11,275155,88.0,78,Soltero,39,2016,3,high,102043,Híbrida,2.17,3,Mujer,Referidos,4,896000,41.0,81,Soltero,23,2012,8,low,-3.09,2,-7,620845,-1288,1,-16
102644,102117,1,Presencial,2.01,4,Mujer,Portal Web,5,296613,94.0,62,Soltero,47,2021,9,high,102154,Presencial,4.05,1,Mujer,Linkedin,10,1616000,90.0,80,Divorciado,48,2021,1,high,2.04,-3,5,1319387,-229,1,1
104097,102105,1,Presencial,3.275,7,Mujer,Portal Web,8,680221,98.0,81,Casado,46,2017,8,high,102113,Híbrida,2.07,0,Hombre,Linkedin,8,1616000,85.0,71,Viudo,45,2017,3,high,-1.205,-7,0,935779,-143,1,-1
102630,102091,1,Presencial,2.37,2,Hombre,Referidos,8,740586,89.0,81,Casado,49,2017,1,high,102149,Presencial,1.54,1,Mujer,Portal Web,4,1616000,73.0,77,Casado,39,2014,12,low,-0.8300000000000001,-1,-4,875414,-750,1,-10
102564,102044,1,Presencial,4.335,2,Hombre,Linkedin,5,920230,90.0,65,Casado,48,2014,5,high,102155,Presencial,1.54,1,Hombre,Ferias & Networking,14,1616000,56.0,68,Soltero,47,2023,3,low,-2.795,-1,9,695770,3244,0,-1
102965,102018,1,Presencial,1.575,3,Mujer,Linkedin,14,879081,81.0,78,Soltero,49,2013,1,high,102160,Presencial,5.57,5,Hombre,Portal Web,3,692000,90.0,69,Divorciado,28,2022,2,high,3.995,2,-11,-187081,3340,0,-21
102981,102052,1,Presencial,2.51,1,Mujer,Linkedin,12,920219,82.0,77,Casado,54,2016,8,high,102093,Presencial,4.45,0,Hombre,Linkedin,5,641000,84.0,76,Divorciado,17,2012,4,high,1.9400000000000004,-1,-7,-279219,-1607,1,-37
100780,102081,1,Presencial,1.535,2,Hombre,Referidos,2,118184,96.0,77,Soltero,17,2018,2,high,102135,Presencial,2.5,2,Hombre,Portal Web,4,488000,26.0,64,Soltero,18,2015,8,low,0.9650000000000001,0,2,369816,-906,1,1
100008,102056,1,Presencial,5.84,2,Mujer,Linkedin,6,309654,91.0,71,Soltero,24,2014,5,high,102014,Presencial,5.24,1,Hombre,Ferias & Networking,16,1616000,70.0,63,Viudo,65,2023,3,low,-0.5999999999999996,-1,10,1306346,3209,0,41
100764,102085,1,Presencial,3.99,2,Mujer,Referidos,3,373022,92.0,76,Casado,29,2016,4,high,102145,Presencial,6.59,4,Hombre,Portal Web,12,1616000,47.0,71,Casado,39,2015,8,low,2.5999999999999996,2,9,1242978,-237,1,10
100154,102075,1,Presencial,2.835,2,Mujer,Referidos,10,408952,93.0,78,Divorciado,31,2017,2,high,102047,Presencial,2.7,1,Hombre,Referidos,11,1255430,90.0,76,Casado,30,2013,3,high,-0.1349999999999998,-1,1,846478,-1409,1,-1
101384,102171,1,Presencial,1.18,0,Mujer,Referidos,8,409721,84.0,74,Casado,38,2023,5,high,102088,Presencial,2.57,4,Hombre,Linkedin,8,1616000,80.0,69,Casado,43,2017,10,high,1.39,4,0,1206279,-2043,1,5
100869,102138,1,Presencial,2.955,7,Mujer,Portal Web,4,406138,92.0,71,Casado,36,2020,12,high,102059,Presencial,3.26,1,Hombre,Linkedin,5,1616000,57.0,75,Soltero,44,2018,4,low,0.3049999999999997,-6,1,1209862,-996,1,8
100975,102132,1,Presencial,2.88,0,Hombre,Linkedin,4,469363,81.0,79,Viudo,38,2019,12,high,102138,Presencial,4.51,1,Hombre,Linkedin,16,1616000,25.0,80,Viudo,45,2014,3,low,1.63,1,12,1146637,-2103,1,7
100931,102144,1,Presencial,3.345,2,Mujer,Portal Web,13,508108,91.0,71,Casado,42,2022,8,high,102156,Presencial,2.13,8,Mujer,Portal Web,11,1616000,5.0,82,Viudo,58,2015,6,low,-1.2150000000000003,6,-2,1107892,-2621,1,16
102130,102068,2,Presencial,1.97,6,Hombre,Linkedin,5,1616000,84.0,73,Soltero,31,2014,4,high,102043,Híbrida,2.17,3,Mujer,Referidos,4,896000,41.0,81,Soltero,23,2012,8,low,0.19999999999999996,-3,-1,-720000,-605,1,-8
101538,102068,1,Presencial,5.31,0,Mujer,Ferias & Networking,11,274579,87.0,78,Soltero,39,2016,3,high,102043,Híbrida,2.17,3,Mujer,Referidos,4,896000,41.0,81,Soltero,23,2012,8,low,-3.1399999999999997,3,-7,621421,-1286,1,-16
100333,102011,1,Presencial,3.01,1,Mujer,Referidos,17,676607,96.0,85,Casado,42,2013,2,high,102048,Presencial,5.37,1,Hombre,Ferias & Networking,7,845000,52.0,74,Casado,22,2012,11,low,2.3600000000000003,0,-10,168393,-97,1,-20
100289,102052,1,Presencial,2.48,2,Mujer,Linkedin,12,919882,82.0,77,Casado,54,2016,8,high,102093,Presencial,4.45,0,Hombre,Linkedin,5,641000,84.0,76,Divorciado,17,2012,4,high,1.9700000000000002,-2,-7,-278882,-1609,1,-37
103569,102081,1,Presencial,1.555,2,Hombre,Referidos,2,122670,85.0,77,Soltero,17,2018,2,high,102135,Presencial,2.5,2,Hombre,Portal Web,4,488000,26.0,64,Soltero,18,2015,8,low,0.9450000000000001,0,2,365330,-908,1,1
104081,102078,1,Presencial,3.28,3,Mujer,Linkedin,3,115874,90.0,75,Soltero,17,2018,7,high,102143,Presencial,2.17,1,Hombre,Ferias & Networking,9,998000,83.0,76,Casado,29,2017,5,high,-1.1099999999999999,-2,6,882126,-421,1,12
103842,102046,1,Presencial,6.995,1,Hombre,Portal Web,1,140927,91.0,72,Soltero,16,2015,1,high,102007,Presencial,1.68,0,Mujer,Portal Web,8,1616000,41.0,71,Soltero,50,2015,10,low,-5.315,-1,7,1475073,291,0,34
102850,102171,1,Presencial,1.175,1,Mujer,Referidos,8,410495,91.0,74,Casado,39,2023,5,high,102088,Presencial,2.57,4,Hombre,Linkedin,8,1616000,80.0,69,Casado,43,2017,10,high,1.3949999999999998,3,0,1205505,-2043,1,4
103638,102111,1,Presencial,4.295,2,Hombre,Linkedin,4,467515,91.0,87,Casado,36,2018,4,high,102097,Híbrida,2.04,1,Mujer,Referidos,15,1616000,94.0,67,Soltero,50,2021,5,high,-2.255,-1,11,1148485,1137,0,14
102353,102111,1,Presencial,5.54,2,Mujer,Linkedin,3,262465,85.0,69,Casado,41,2019,11,high,102097,Híbrida,2.04,1,Mujer,Referidos,15,1616000,94.0,67,Soltero,50,2021,5,high,-3.5,-1,12,1353535,559,0,9
102491,102026,1,Presencial,1.13,2,Mujer,Linkedin,13,407498,81.0,79,Casado,34,2012,7,high,102101,Presencial,2.7,1,Mujer,Portal Web,15,1616000,97.0,79,Casado,58,2017,6,high,1.5700000000000003,-1,2,1208502,1795,0,24
102477,102094,1,Presencial,1.95,2,Hombre,Portal Web,15,274491,84.0,76,Casado,42,2019,5,high,102095,Presencial,1.32,1,Hombre,Portal Web,4,998000,90.0,85,Casado,28,2016,2,high,-0.6299999999999999,-1,-11,723509,-1212,1,-14
102689,102011,1,Presencial,2.975,1,Mujer,Referidos,17,676213,85.0,85,Casado,42,2013,2,high,102048,Presencial,5.37,1,Hombre,Ferias & Networking,7,845000,52.0,74,Casado,22,2012,11,low,2.395,0,-10,168787,-96,1,-20
102365,102123,1,Presencial,1.565,0,Mujer,Ferias & Networking,18,719200,82.0,75,Casado,52,2021,1,high,102043,Presencial,5.5,1,Mujer,Linkedin,16,1616000,42.0,66,Soltero,51,2021,9,low,3.935,1,-2,896800,252,0,-1
100404,102085,1,Presencial,0.995,1,Mujer,Ferias & Networking,1,96906,81.0,76,Divorciado,14,2016,8,high,102145,Presencial,6.59,4,Hombre,Portal Web,12,1616000,47.0,71,Casado,39,2015,8,low,5.595,3,11,1519094,-369,1,25
101091,102057,1,Presencial,3.35,3,Hombre,Linkedin,10,756647,98.0,84,Viudo,43,2015,1,high,102019,Presencial,1.97,4,Hombre,Portal Web,5,1616000,90.0,73,Viudo,59,2022,12,high,-1.3800000000000001,1,-5,859353,2887,0,16
100881,102076,1,Presencial,5.765,1,Hombre,Linkedin,3,754284,98.0,80,Viudo,48,2017,1,high,102168,Híbrida,1.95,1,Hombre,Referidos,9,1616000,95.0,82,Soltero,53,2023,9,high,-3.8149999999999995,0,6,861716,2418,0,5
102038,102125,2,Presencial,2.06,1,Hombre,Portal Web,12,1616000,81.0,82,Casado,44,2018,1,high,102096,Híbrida,4.0,2,Mujer,Referidos,5,692000,87.0,82,Casado,29,2022,7,high,1.94,1,-7,-924000,1651,0,-15
101085,102125,1,Presencial,3.43,2,Hombre,Portal Web,18,841377,95.0,82,Soltero,55,2022,3,high,102096,Híbrida,4.0,2,Mujer,Referidos,5,692000,87.0,82,Casado,29,2022,7,high,0.5699999999999998,0,-13,-149377,140,0,-26
102794,102078,1,Presencial,5.02,5,Hombre,Portal Web,5,365476,90.0,72,Casado,31,2017,10,high,102143,Presencial,2.17,1,Hombre,Ferias & Networking,9,998000,83.0,76,Casado,29,2017,5,high,-2.8499999999999996,-4,4,632524,-149,1,-2
103330,102027,1,Presencial,2.845,2,Hombre,Portal Web,5,365914,83.0,76,Casado,27,2013,9,high,102065,Presencial,3.27,1,Mujer,Linkedin,8,1306940,80.0,80,Casado,32,2014,2,high,0.4249999999999998,-1,3,941026,152,0,5
102702,102147,1,Presencial,1.76,3,Hombre,Referidos,9,256082,86.0,70,Casado,43,2022,8,high,102057,Presencial,1.58,2,Hombre,Portal Web,4,1616000,90.0,80,Casado,49,2022,12,high,-0.17999999999999994,-1,-5,1359918,123,0,6
102657,102110,1,Presencial,2.015,0,Mujer,Portal Web,3,286320,87.0,76,Soltero,42,2018,4,high,102045,Presencial,1.6,5,Mujer,Linkedin,2,998000,87.0,76,Soltero,29,2016,11,high,-0.41500000000000004,5,-1,711680,-510,1,-13
101290,102147,1,Presencial,1.775,2,Hombre,Referidos,9,262022,98.0,70,Casado,43,2022,8,high,102057,Presencial,1.58,2,Hombre,Portal Web,4,1616000,90.0,80,Casado,49,2022,12,high,-0.19499999999999984,0,-5,1353978,126,0,6
102082,102050,2,Presencial,5.5,2,Mujer,Linkedin,7,1616000,81.0,70,Casado,36,2018,8,high,102069,Presencial,3.7,0,Mujer,Linkedin,11,1512980,90.0,88,Soltero,40,2017,10,high,-1.7999999999999998,-2,4,-103020,-312,1,4
102114,102050,2,Presencial,1.44,1,Mujer,Portal Web,5,1616000,91.0,69,Divorciado,47,2021,5,high,102069,Presencial,3.7,0,Mujer,Linkedin,11,1512980,90.0,88,Soltero,40,2017,10,high,2.2600000000000002,-1,6,-103020,-1321,1,-7
103622,102050,1,Presencial,4.445,2,Hombre,Portal Web,2,313257,97.0,75,Casado,25,2014,10,high,102069,Presencial,3.7,0,Mujer,Linkedin,11,1512980,90.0,88,Soltero,40,2017,10,high,-0.7450000000000001,-2,9,1199723,1082,0,15
104020,102138,1,Presencial,4.415,1,Mujer,Referidos,3,309969,83.0,88,Soltero,47,2021,9,high,102059,Presencial,3.26,1,Hombre,Linkedin,5,1616000,57.0,75,Soltero,44,2018,4,low,-1.1550000000000002,0,2,1306031,-1264,1,-3
101376,102050,1,Presencial,4.575,2,Mujer,Ferias & Networking,4,408855,92.0,72,Soltero,31,2016,1,high,102069,Presencial,3.7,0,Mujer,Linkedin,11,1512980,90.0,88,Soltero,40,2017,10,high,-0.875,-2,7,1104125,631,0,9
100864,102163,1,Presencial,5.15,1,Hombre,Portal Web,7,373855,89.0,82,Casado,44,2023,4,high,102120,Presencial,7.53,9,Hombre,Linkedin,7,1616000,37.0,75,Casado,49,2019,8,low,2.38,8,0,1242145,-1333,1,5
100653,102138,1,Presencial,4.415,2,Mujer,Referidos,3,306685,80.0,88,Soltero,47,2021,9,high,102059,Presencial,3.26,1,Hombre,Linkedin,5,1616000,57.0,75,Soltero,44,2018,4,low,-1.1550000000000002,-1,2,1309315,-1265,1,-3
102445,102050,1,Presencial,2.26,11,Mujer,Portal Web,1,188706,91.0,64,Casado,19,2016,1,high,102069,Presencial,3.7,0,Mujer,Linkedin,11,1512980,90.0,88,Soltero,40,2017,10,high,1.4400000000000004,-11,10,1324274,643,0,21
103026,102142,1,Presencial,2.13,11,Mujer,Linkedin,5,325077,90.0,86,Casado,33,2022,4,high,102047,Presencial,2.48,2,Hombre,Portal Web,3,1255430,90.0,66,Soltero,36,2019,7,high,0.3500000000000001,-9,-2,930353,-1016,1,3
104108,102146,1,Presencial,1.51,0,Hombre,Portal Web,12,296578,86.0,81,Casado,48,2023,4,high,102035,Presencial,2.66,0,Mujer,Portal Web,15,1616000,77.0,78,Casado,39,2013,10,low,1.1500000000000001,0,3,1319422,-3467,1,-9
101390,102146,1,Presencial,1.525,1,Hombre,Portal Web,12,293695,80.0,81,Casado,48,2023,4,high,102035,Presencial,2.66,0,Mujer,Portal Web,15,1616000,77.0,78,Casado,39,2013,10,low,1.1350000000000002,-1,3,1322305,-3467,1,-9
102083,102147,2,Presencial,1.61,0,Mujer,Portal Web,5,1564490,83.0,71,Soltero,44,2021,2,high,102057,Presencial,1.58,2,Hombre,Portal Web,4,1616000,90.0,80,Casado,49,2022,12,high,-0.030000000000000027,2,-1,51510,666,0,5
101566,102147,1,Presencial,1.795,12,Hombre,Headhunter,4,919398,96.0,80,Casado,57,2022,11,high,102057,Presencial,1.58,2,Hombre,Portal Web,4,1616000,90.0,80,Casado,49,2022,12,high,-0.21499999999999986,-10,0,696602,32,0,-8
103724,102078,1,Presencial,4.31,2,Mujer,Linkedin,2,79211,88.0,72,Soltero,15,2018,8,high,102143,Presencial,2.17,1,Hombre,Ferias & Networking,9,998000,83.0,76,Casado,29,2017,5,high,-2.1399999999999997,-1,7,918789,-437,1,14
103302,102028,1,Presencial,3.35,2,Hombre,Ferias & Networking,1,98237,91.0,83,Soltero,10,2012,6,high,102085,Presencial,1.39,2,Mujer,Linkedin,12,1358450,97.0,72,Soltero,35,2016,12,high,-1.9600000000000002,0,11,1260213,1658,0,25
102235,102070,1,Presencial,2.105,3,Mujer,Referidos,1,135684,91.0,75,Soltero,15,2015,1,high,102035,Presencial,1.7,1,Mujer,Referidos,4,1616000,77.0,73,Viudo,38,2013,3,low,-0.405,-2,3,1480316,-671,1,23
102553,102108,1,Presencial,3.335,2,Mujer,Referidos,3,180398,80.0,80,Soltero,21,2018,7,high,102040,Presencial,2.92,1,Mujer,Portal Web,5,1616000,46.0,75,Casado,50,2023,5,low,-0.41500000000000004,-1,2,1435602,1779,0,29
103087,102107,1,Presencial,4.645,2,Mujer,Portal Web,3,231547,90.0,66,Soltero,27,2020,8,high,102069,Presencial,2.4,1,Mujer,Linkedin,8,1616000,47.0,79,Casado,63,2023,6,low,-2.2449999999999997,-1,5,1384453,1044,0,36
102248,102117,1,Presencial,3.27,0,Mujer,Ferias & Networking,6,286247,98.0,74,Soltero,29,2020,5,high,102154,Presencial,4.05,1,Mujer,Linkedin,10,1616000,90.0,80,Divorciado,48,2021,1,high,0.7799999999999998,1,4,1329753,250,0,19
103146,102036,1,Presencial,1.975,9,Hombre,Linkedin,5,313478,95.0,75,Casado,24,2014,2,high,102054,Presencial,1.68,8,Hombre,Portal Web,5,1616000,92.0,76,Viudo,54,2022,1,high,-0.29500000000000015,-1,0,1302522,2897,0,30
103360,102050,1,Presencial,4.55,3,Mujer,Ferias & Networking,4,405863,84.0,72,Soltero,31,2016,1,high,102069,Presencial,3.7,0,Mujer,Linkedin,11,1512980,90.0,88,Soltero,40,2017,10,high,-0.8499999999999996,-3,7,1107117,632,0,9
102213,102171,1,Presencial,3.64,2,Hombre,Ferias & Networking,5,805961,98.0,80,Casado,40,2023,4,high,102088,Presencial,2.57,4,Hombre,Linkedin,8,1616000,80.0,69,Casado,43,2017,10,high,-1.0700000000000003,2,3,810039,-2008,1,3
102443,102148,1,Presencial,1.83,3,Mujer,Portal Web,8,428391,96.0,70,Casado,44,2022,1,high,102116,Presencial,1.49,2,Mujer,Portal Web,2,539000,80.0,67,Soltero,26,2022,12,high,-0.3400000000000001,-1,-6,110609,337,0,-18
100879,102048,1,Presencial,1.84,0,Mujer,Ferias & Networking,1,79098,97.0,74,Soltero,13,2015,7,high,102092,Presencial,3.99,0,Mujer,Portal Web,5,590000,59.0,76,Soltero,20,2015,8,low,2.1500000000000004,0,4,510902,40,0,7
101021,102096,1,Presencial,6.32,10,Hombre,Portal Web,2,98041,88.0,73,Soltero,16,2018,5,high,102116,Presencial,5.11,8,Mujer,Linkedin,13,1461470,90.0,74,Soltero,42,2021,5,high,-1.21,-2,11,1363429,1095,0,26
100207,102054,1,Presencial,1.635,0,Mujer,Ferias & Networking,3,141510,89.0,73,Soltero,16,2015,3,high,102044,Presencial,2.91,1,Hombre,Linkedin,17,1616000,85.0,74,Divorciado,41,2012,11,high,1.2750000000000001,1,14,1474490,-863,1,25
100571,102070,1,Presencial,2.065,2,Mujer,Referidos,1,143130,82.0,75,Soltero,15,2015,1,high,102035,Presencial,1.7,1,Mujer,Referidos,4,1616000,77.0,73,Viudo,38,2013,3,low,-0.365,-1,3,1472870,-674,1,23
101205,102108,1,Presencial,3.32,3,Mujer,Referidos,3,180218,80.0,80,Soltero,21,2018,7,high,102040,Presencial,2.92,1,Mujer,Portal Web,5,1616000,46.0,75,Casado,50,2023,5,low,-0.3999999999999999,-2,2,1435782,1776,0,29
101677,102108,1,Presencial,2.42,1,Mujer,Referidos,7,393510,83.0,65,Soltero,32,2018,2,high,102040,Presencial,2.92,1,Mujer,Portal Web,5,1616000,46.0,75,Casado,50,2023,5,low,0.5,0,-2,1222490,1935,0,18
100579,102121,1,Presencial,2.88,3,Mujer,Portal Web,11,443614,80.0,69,Casado,45,2019,11,high,102127,Híbrida,1.63,2,Hombre,Portal Web,4,1616000,90.0,77,Divorciado,44,2012,2,high,-1.25,-1,-7,1172386,-2824,1,-1
101279,102071,1,Presencial,4.01,2,Hombre,Linkedin,3,377951,96.0,76,Casado,43,2017,12,high,102171,Presencial,0.87,1,Hombre,Portal Web,11,1616000,85.0,72,Viudo,51,2023,11,high,-3.1399999999999997,-1,8,1238049,2165,0,8
101638,102039,1,Presencial,6.365,2,Mujer,Portal Web,15,301589,82.0,72,Divorciado,40,2015,4,high,102054,Presencial,3.66,0,Hombre,Referidos,5,1616000,93.0,75,Viudo,49,2018,6,high,-2.705,-2,-10,1314411,1151,0,9
100111,102136,1,Presencial,4.63,3,Mujer,Ferias & Networking,14,716817,95.0,66,Divorciado,54,2023,2,high,102034,Presencial,1.78,2,Hombre,Portal Web,3,1616000,89.0,78,Casado,35,2013,1,high,-2.8499999999999996,-1,-11,899183,-3684,1,-19
102039,102054,2,Presencial,3.66,0,Hombre,Referidos,5,1616000,93.0,75,Viudo,49,2018,6,high,102044,Presencial,2.91,1,Hombre,Linkedin,17,1616000,85.0,74,Divorciado,41,2012,11,high,-0.75,1,12,0,-2046,1,-8
102036,102054,2,Presencial,1.68,8,Hombre,Portal Web,5,1616000,92.0,76,Viudo,54,2022,1,high,102044,Presencial,2.91,1,Hombre,Linkedin,17,1616000,85.0,74,Divorciado,41,2012,11,high,1.2300000000000002,-7,12,0,-3350,1,-13
103382,102054,1,Presencial,1.66,1,Mujer,Ferias & Networking,3,143309,83.0,73,Soltero,16,2015,3,high,102044,Presencial,2.91,1,Hombre,Linkedin,17,1616000,85.0,74,Divorciado,41,2012,11,high,1.2500000000000002,0,14,1472691,-861,1,25
102775,102071,1,Presencial,4.025,3,Hombre,Linkedin,3,381346,90.0,76,Casado,43,2017,12,high,102171,Presencial,0.87,1,Hombre,Portal Web,11,1616000,85.0,72,Viudo,51,2023,11,high,-3.1550000000000002,-2,8,1234654,2167,0,8
101145,102115,1,Presencial,3.885,2,Hombre,Linkedin,2,78505,93.0,75,Soltero,18,2020,10,high,102116,Presencial,2.0,2,Mujer,Portal Web,4,1616000,94.0,76,Soltero,35,2018,12,high,-1.8849999999999998,0,2,1537495,-669,1,17
101435,102131,1,Presencial,1.595,2,Mujer,Portal Web,6,210588,90.0,78,Casado,25,2020,12,high,102109,Presencial,5.54,0,Hombre,Linkedin,3,998000,39.0,77,Soltero,34,2021,12,low,3.9450000000000003,-2,-3,787412,383,0,9
100686,102082,1,Presencial,1.54,1,Hombre,Headhunter,6,804235,86.0,76,Soltero,34,2016,5,high,102050,Presencial,5.5,2,Mujer,Linkedin,7,1616000,81.0,70,Casado,36,2018,8,high,3.96,1,1,811765,834,0,2
101228,102115,1,Presencial,4.27,0,Mujer,Portal Web,12,270875,87.0,74,Casado,43,2021,1,high,102116,Presencial,2.0,2,Mujer,Portal Web,4,1616000,94.0,76,Soltero,35,2018,12,high,-2.2699999999999996,2,-8,1345125,-756,1,-8
101267,102119,1,Presencial,3.39,5,Mujer,Portal Web,14,264053,82.0,70,Soltero,42,2020,1,high,102107,Presencial,2.22,2,Hombre,Portal Web,12,1616000,38.0,70,Divorciado,52,2021,1,low,-1.17,-3,-2,1351947,368,0,10
100533,102050,1,Presencial,4.53,1,Mujer,Ferias & Networking,10,701712,97.0,69,Divorciado,44,2014,7,high,102069,Presencial,3.7,0,Mujer,Linkedin,11,1512980,90.0,88,Soltero,40,2017,10,high,-0.8300000000000001,-1,1,811268,1170,0,-4
102752,102048,1,Presencial,1.825,0,Mujer,Ferias & Networking,1,83900,85.0,74,Soltero,13,2015,7,high,102092,Presencial,3.99,0,Mujer,Portal Web,5,590000,59.0,76,Soltero,20,2015,8,low,2.165,0,4,506100,41,0,7
103840,102082,1,Presencial,1.74,1,Hombre,Portal Web,2,96955,95.0,73,Soltero,15,2016,7,high,102050,Presencial,5.5,2,Mujer,Linkedin,7,1616000,81.0,70,Casado,36,2018,8,high,3.76,1,5,1519045,760,0,21
102903,102037,1,Presencial,1.97,3,Hombre,Referidos,4,352992,91.0,68,Casado,26,2013,5,high,102057,Presencial,1.12,1,Mujer,Linkedin,2,641000,50.0,76,Casado,21,2016,12,low,-0.8499999999999999,-2,-2,288008,1297,0,-5
103158,102082,1,Presencial,1.535,1,Hombre,Headhunter,6,804018,95.0,76,Soltero,34,2016,5,high,102050,Presencial,5.5,2,Mujer,Linkedin,7,1616000,81.0,70,Casado,36,2018,8,high,3.965,1,1,811982,834,0,2
104035,102125,1,Presencial,3.31,1,Hombre,Referidos,4,491372,84.0,72,Soltero,38,2019,4,high,102096,Híbrida,4.0,2,Mujer,Referidos,5,692000,87.0,82,Casado,29,2022,7,high,0.69,1,1,200628,1209,0,-9
103665,102032,1,Presencial,2.335,4,Mujer,Referidos,5,257667,89.0,79,Soltero,34,2013,4,high,102065,Presencial,1.78,7,Hombre,Portal Web,14,1616000,42.0,71,Casado,42,2015,11,low,-0.5549999999999999,3,9,1358333,948,0,8
104167,102119,1,Presencial,3.365,6,Mujer,Portal Web,15,271868,88.0,70,Soltero,42,2020,1,high,102107,Presencial,2.22,2,Hombre,Portal Web,12,1616000,38.0,70,Divorciado,52,2021,1,low,-1.145,-4,-3,1344132,369,0,10
102693,102034,1,Presencial,3.26,2,Hombre,Ferias & Networking,9,394600,95.0,78,Viudo,39,2013,2,high,102113,Presencial,7.84,7,Hombre,Linkedin,5,1564490,90.0,70,Casado,35,2012,9,high,4.58,5,-4,1169890,-158,1,-4
101667,102038,1,Presencial,2.385,0,Hombre,Headhunter,18,896665,93.0,85,Viudo,43,2012,10,high,102125,Presencial,2.06,1,Hombre,Portal Web,12,1616000,81.0,82,Casado,44,2018,1,high,-0.32499999999999973,1,-6,719335,1911,0,1
102074,102028,2,Presencial,1.35,0,Hombre,Ferias & Networking,4,1616000,80.0,83,Viudo,43,2015,12,high,102085,Presencial,1.39,2,Mujer,Linkedin,12,1358450,97.0,72,Soltero,35,2016,12,high,0.039999999999999813,2,8,-257550,364,0,-8
100605,102028,1,Presencial,3.34,2,Mujer,Referidos,9,900905,97.0,62,Viudo,46,2014,8,high,102085,Presencial,1.39,2,Mujer,Linkedin,12,1358450,97.0,72,Soltero,35,2016,12,high,-1.95,0,3,457545,866,0,-11
104157,102131,1,Presencial,1.58,2,Mujer,Portal Web,6,212684,84.0,78,Casado,25,2020,12,high,102109,Presencial,5.54,0,Hombre,Linkedin,3,998000,39.0,77,Soltero,34,2021,12,low,3.96,-2,-3,785316,383,0,9
102904,102115,1,Presencial,4.245,0,Mujer,Portal Web,12,270020,93.0,74,Casado,43,2021,1,high,102116,Presencial,2.0,2,Mujer,Portal Web,4,1616000,94.0,76,Soltero,35,2018,12,high,-2.245,2,-8,1345980,-759,1,-8
104015,102143,1,Presencial,2.11,1,Mujer,Linkedin,5,635586,84.0,70,Viudo,48,2020,11,high,102142,Presencial,1.07,2,Hombre,Portal Web,2,590000,90.0,78,Casado,25,2022,2,high,-1.0399999999999998,1,-3,-45586,458,0,-23
100440,102159,1,Presencial,3.05,1,Mujer,Portal Web,7,429579,94.0,88,Soltero,39,2022,10,high,102120,Híbrida,0.98,2,Hombre,Referidos,14,808000,90.0,86,Soltero,44,2022,8,high,-2.07,1,7,378421,-53,1,5
102412,102171,1,Presencial,6.85,1,Hombre,Referidos,8,452226,81.0,75,Soltero,40,2023,6,high,102088,Presencial,2.57,4,Hombre,Linkedin,8,1616000,80.0,69,Casado,43,2017,10,high,-4.279999999999999,3,0,1163774,-2075,1,3
103221,102056,1,Presencial,1.815,3,Hombre,Portal Web,6,276306,96.0,72,Casado,38,2015,5,high,102014,Presencial,5.24,1,Hombre,Ferias & Networking,16,1616000,70.0,63,Viudo,65,2023,3,low,3.4250000000000003,-2,10,1339694,2844,0,27
101152,102061,1,Presencial,2.46,0,Mujer,Ferias & Networking,8,274624,83.0,75,Casado,39,2016,11,high,102115,Presencial,2.14,2,Hombre,Ferias & Networking,10,1203920,37.0,80,Casado,29,2012,11,low,-0.31999999999999984,2,2,929296,-1451,1,-10
101605,102056,1,Presencial,1.815,2,Hombre,Portal Web,6,278866,88.0,72,Casado,38,2015,5,high,102014,Presencial,5.24,1,Hombre,Ferias & Networking,16,1616000,70.0,63,Viudo,65,2023,3,low,3.4250000000000003,-1,10,1337134,2843,0,27
102053,102030,2,Presencial,1.29,0,Hombre,Portal Web,11,1616000,81.0,64,Soltero,36,2012,12,high,102058,Presencial,6.34,0,Mujer,Referidos,14,1616000,90.0,76,Viudo,41,2015,4,high,5.05,0,3,0,832,0,5
103063,102030,1,Presencial,4.81,5,Mujer,Linkedin,6,790446,94.0,82,Casado,30,2013,6,high,102058,Presencial,6.34,0,Mujer,Referidos,14,1616000,90.0,76,Viudo,41,2015,4,high,1.5300000000000002,-5,8,825554,675,0,11
102941,102032,1,Presencial,3.71,0,Hombre,Portal Web,9,779978,88.0,71,Divorciado,42,2013,6,high,102065,Presencial,1.78,7,Hombre,Portal Web,14,1616000,42.0,71,Casado,42,2015,11,low,-1.93,7,5,836022,895,0,0
100675,102054,1,Presencial,1.92,1,Mujer,Linkedin,2,164252,92.0,71,Soltero,18,2016,6,high,102044,Presencial,2.91,1,Hombre,Linkedin,17,1616000,85.0,74,Divorciado,41,2012,11,high,0.9900000000000002,0,15,1451748,-1308,1,23
100170,102102,1,Presencial,5.04,7,Hombre,Portal Web,3,387896,94.0,63,Casado,35,2020,8,high,102018,Presencial,2.48,0,Hombre,Portal Web,5,1616000,92.0,63,Viudo,49,2019,4,high,-2.56,-7,2,1228104,-483,1,14
101795,102114,1,Presencial,2.195,5,Hombre,Linkedin,15,427144,89.0,77,Viudo,46,2020,3,high,102050,Presencial,1.44,1,Mujer,Portal Web,5,1616000,91.0,69,Divorciado,47,2021,5,high,-0.7549999999999999,-4,-10,1188856,447,0,1
101252,102032,1,Presencial,3.72,1,Hombre,Portal Web,9,782182,86.0,71,Divorciado,42,2013,6,high,102065,Presencial,1.78,7,Hombre,Portal Web,14,1616000,42.0,71,Casado,42,2015,11,low,-1.9400000000000002,6,5,833818,897,0,0
103711,102085,1,Presencial,2.2,2,Hombre,Ferias & Networking,6,329585,85.0,75,Soltero,28,2017,5,high,102145,Presencial,6.59,4,Hombre,Portal Web,12,1616000,47.0,71,Casado,39,2015,8,low,4.39,2,6,1286415,-652,1,11
103572,102099,1,Presencial,2.56,9,Mujer,Portal Web,8,390423,90.0,91,Casado,32,2017,9,high,102080,Presencial,1.71,0,Hombre,Portal Web,11,1616000,76.0,80,Viudo,51,2021,10,low,-0.8500000000000001,-9,3,1225577,1469,0,19
102472,102037,1,Presencial,2.355,2,Mujer,Referidos,6,393182,90.0,76,Casado,28,2013,10,high,102057,Presencial,1.12,1,Mujer,Linkedin,2,641000,50.0,76,Casado,21,2016,12,low,-1.2349999999999999,-1,-4,247818,1135,0,-7
104040,102026,1,Presencial,1.15,2,Hombre,Portal Web,9,429236,93.0,71,Soltero,28,2012,3,high,102101,Presencial,2.7,1,Mujer,Portal Web,15,1616000,97.0,79,Casado,58,2017,6,high,1.5500000000000003,-1,6,1186764,1935,0,30
102809,102134,1,Presencial,2.84,0,Mujer,Portal Web,10,264128,84.0,84,Casado,43,2020,11,high,102135,Presencial,2.25,2,Hombre,Portal Web,5,1358450,90.0,69,Viudo,31,2012,7,high,-0.5899999999999999,2,-5,1094322,-3039,1,-12
103589,102079,1,Presencial,1.955,2,Hombre,Referidos,7,457694,81.0,78,Soltero,40,2017,12,high,102146,Presencial,2.63,1,Mujer,Portal Web,4,1358450,80.0,81,Soltero,35,2016,3,high,0.6749999999999998,-1,-3,900756,-651,1,-5
103175,102114,1,Presencial,2.165,6,Hombre,Linkedin,15,423519,89.0,77,Viudo,46,2020,3,high,102050,Presencial,1.44,1,Mujer,Portal Web,5,1616000,91.0,69,Divorciado,47,2021,5,high,-0.7250000000000001,-5,-10,1192481,446,0,1
101961,102109,1,Presencial,2.785,2,Mujer,Linkedin,8,327265,96.0,78,Viudo,30,2019,1,high,102123,Presencial,3.86,1,Mujer,Portal Web,5,998000,97.0,82,Casado,32,2019,9,high,1.0749999999999997,-1,-3,670735,261,0,2
100063,102007,1,Presencial,2.35,1,Hombre,Referidos,5,264076,97.0,75,Casado,34,2012,1,high,102070,Presencial,5.11,2,Mujer,Portal Web,6,1358450,96.0,62,Soltero,41,2022,4,high,2.7600000000000002,1,1,1094374,3752,0,7
101284,102100,1,Presencial,1.91,3,Mujer,Referidos,11,405250,91.0,83,Divorciado,44,2018,2,high,102007,Presencial,3.3,1,Mujer,Portal Web,3,1255430,21.0,59,Casado,30,2013,2,low,1.39,-2,-8,850180,-1832,1,-14
101063,102089,1,Presencial,4.545,1,Hombre,Portal Web,12,896019,95.0,76,Divorciado,47,2019,7,high,102077,Presencial,2.75,1,Hombre,Ferias & Networking,6,1616000,96.0,69,Divorciado,60,2021,10,high,-1.795,0,-6,719981,818,0,13
100331,102075,1,Presencial,1.975,2,Mujer,Referidos,8,719310,91.0,73,Casado,47,2016,5,high,102047,Presencial,2.7,1,Hombre,Referidos,11,1255430,90.0,76,Casado,30,2013,3,high,0.7250000000000001,-1,3,536120,-1132,1,-17
103927,102049,1,Presencial,1.775,2,Hombre,Portal Web,3,141213,92.0,78,Soltero,14,2014,3,high,102029,Presencial,6.89,0,Mujer,Portal Web,9,1616000,19.0,77,Divorciado,49,2023,3,low,5.115,-2,6,1474787,3285,0,35
102394,102060,1,Presencial,1.845,1,Hombre,Ferias & Networking,2,193812,84.0,62,Soltero,20,2016,2,high,102041,Presencial,4.42,3,Hombre,Referidos,16,1616000,82.0,62,Casado,45,2013,10,high,2.575,2,14,1422188,-844,1,25
103807,102128,1,Presencial,2.555,2,Hombre,Portal Web,8,308029,87.0,71,Casado,31,2021,5,high,102056,Presencial,4.11,10,Mujer,Portal Web,16,1616000,46.0,72,Soltero,55,2021,2,low,1.5550000000000002,8,8,1307971,-91,1,24
102641,102039,1,Presencial,3.21,0,Hombre,Portal Web,8,331290,80.0,81,Casado,26,2014,7,high,102054,Presencial,3.66,0,Hombre,Referidos,5,1616000,93.0,75,Viudo,49,2018,6,high,0.4500000000000002,0,-3,1284710,1443,0,23
100096,102128,1,Presencial,1.5,8,Hombre,Linkedin,10,409114,98.0,77,Soltero,35,2019,8,high,102056,Presencial,4.11,10,Mujer,Portal Web,16,1616000,46.0,72,Soltero,55,2021,2,low,2.6100000000000003,2,6,1206886,537,0,20
102089,102077,2,Presencial,2.75,1,Hombre,Ferias & Networking,6,1616000,96.0,69,Divorciado,60,2021,10,high,102146,Presencial,2.27,0,Hombre,Ferias & Networking,11,1306940,31.0,64,Soltero,39,2021,6,low,-0.48,-1,5,-309060,-114,1,-21
104062,102077,1,Presencial,1.93,6,Hombre,Portal Web,5,786736,97.0,72,Soltero,33,2018,7,high,102146,Presencial,2.27,0,Hombre,Ferias & Networking,11,1306940,31.0,64,Soltero,39,2021,6,low,0.3400000000000001,-6,6,520204,1089,0,6
103043,102112,1,Presencial,6.095,2,Hombre,Portal Web,2,470549,88.0,69,Casado,39,2020,10,high,102031,Presencial,2.27,7,Hombre,Linkedin,1,692000,83.0,74,Soltero,26,2020,6,high,-3.8249999999999997,5,-1,221451,-118,1,-13
102446,102135,1,Presencial,2.75,3,Hombre,Portal Web,12,401396,88.0,78,Soltero,45,2020,5,high,102028,Presencial,2.04,1,Hombre,Portal Web,2,1616000,82.0,75,Divorciado,49,2017,10,high,-0.71,-2,-10,1214604,-957,1,4
102975,102089,1,Presencial,4.53,2,Hombre,Portal Web,12,896822,98.0,76,Divorciado,47,2019,7,high,102077,Presencial,2.75,1,Hombre,Ferias & Networking,6,1616000,96.0,69,Divorciado,60,2021,10,high,-1.7800000000000002,-1,-6,719178,818,0,13
102951,102067,1,Presencial,2.925,3,Mujer,Portal Web,4,898002,97.0,75,Casado,49,2017,2,high,102058,Presencial,0.92,1,Mujer,Portal Web,5,1616000,90.0,70,Divorciado,46,2020,8,high,-2.005,-2,1,717998,1293,0,-3
101172,102138,1,Presencial,4.05,7,Hombre,Portal Web,2,205041,83.0,74,Viudo,24,2020,5,high,102059,Presencial,3.26,1,Hombre,Linkedin,5,1616000,57.0,75,Soltero,44,2018,4,low,-0.79,-6,3,1410959,-761,1,20
100895,102083,1,Presencial,2.42,1,Mujer,Portal Web,10,367115,86.0,78,Soltero,28,2015,11,high,102147,Presencial,1.61,0,Mujer,Portal Web,5,1564490,83.0,71,Soltero,44,2021,2,high,-0.8099999999999998,-1,-5,1197375,1923,0,16
102073,102139,2,Presencial,1.98,2,Hombre,Portal Web,11,1306940,95.0,86,Soltero,37,2019,7,high,102154,Presencial,6.48,1,Hombre,Ferias & Networking,5,590000,90.0,67,Casado,25,2021,6,high,4.5,-1,-6,-716940,712,0,-12
101451,102139,1,Presencial,1.67,12,Mujer,Linkedin,7,308062,96.0,74,Viudo,48,2021,11,high,102154,Presencial,6.48,1,Hombre,Ferias & Networking,5,590000,90.0,67,Casado,25,2021,6,high,4.8100000000000005,-11,-2,281938,-145,1,-23
101104,102031,1,Presencial,5.59,1,Mujer,Portal Web,14,460556,90.0,72,Divorciado,38,2012,2,high,102111,Presencial,2.95,2,Hombre,Portal Web,8,1610000,76.0,87,Casado,31,2017,7,low,-2.6399999999999997,1,-6,1149444,1954,0,-7
100263,102119,1,Presencial,1.565,2,Hombre,Portal Web,3,878378,95.0,68,Casado,49,2021,9,high,102107,Presencial,2.22,2,Hombre,Portal Web,12,1616000,38.0,70,Divorciado,52,2021,1,low,0.6550000000000002,0,9,737622,-249,1,3
100122,102102,1,Presencial,1.865,2,Mujer,Ferias & Networking,9,822237,88.0,81,Viudo,51,2019,8,high,102018,Presencial,2.48,0,Hombre,Portal Web,5,1616000,92.0,63,Viudo,49,2019,4,high,0.615,-2,-4,793763,-113,1,-2
102181,102023,1,Presencial,3.67,0,Hombre,Ferias & Networking,5,289850,94.0,79,Soltero,22,2013,8,high,102105,Híbrida,4.9,1,Hombre,Portal Web,4,539000,80.0,65,Casado,23,2019,12,high,1.2300000000000004,1,-1,249150,2317,0,1
102759,102137,1,Presencial,2.25,2,Mujer,Portal Web,3,465300,98.0,77,Soltero,40,2021,10,high,102046,Presencial,1.18,0,Mujer,Portal Web,2,845000,37.0,79,Casado,27,2017,12,low,-1.07,-2,-1,379700,-1385,1,-13
103308,102139,1,Presencial,1.645,11,Mujer,Linkedin,5,309250,91.0,74,Viudo,47,2021,11,high,102154,Presencial,6.48,1,Hombre,Ferias & Networking,5,590000,90.0,67,Casado,25,2021,6,high,4.835000000000001,-10,0,280750,-144,1,-22
102688,102119,1,Presencial,1.53,3,Hombre,Portal Web,3,876863,89.0,68,Casado,49,2021,9,high,102107,Presencial,2.22,2,Hombre,Portal Web,12,1616000,38.0,70,Divorciado,52,2021,1,low,0.6900000000000002,-1,9,739137,-250,1,3
100005,102158,1,Presencial,1.505,1,Mujer,Referidos,1,102728,80.0,78,Soltero,21,2022,7,high,102093,Presencial,1.79,1,Mujer,Referidos,27,1900000,87.0,74,Viudo,54,2013,9,high,0.28500000000000014,0,26,1797272,-3232,1,33
100320,102123,1,Presencial,4.39,1,Hombre,Portal Web,2,168109,81.0,68,Casado,22,2020,8,high,102043,Presencial,5.5,1,Mujer,Linkedin,16,1616000,42.0,66,Soltero,51,2021,9,low,1.1100000000000003,0,14,1447891,395,0,29
100259,102106,1,Presencial,2.525,1,Mujer,Portal Web,7,407727,93.0,65,Casado,35,2020,4,high,102081,Presencial,1.39,1,Mujer,Ferias & Networking,5,1049000,86.0,86,Soltero,32,2019,6,high,-1.135,0,-2,641273,-320,1,-3
100993,102168,1,Presencial,1.315,1,Hombre,Portal Web,9,259435,85.0,72,Casado,44,2023,6,high,102172,Presencial,6.22,1,Hombre,Referidos,15,1616000,75.0,68,Viudo,42,2012,1,low,4.904999999999999,0,6,1356565,-4173,1,-2
100693,102054,1,Presencial,2.315,2,Mujer,Linkedin,13,433625,91.0,78,Casado,35,2013,10,high,102044,Presencial,2.91,1,Hombre,Linkedin,17,1616000,85.0,74,Divorciado,41,2012,11,high,0.5950000000000002,-1,4,1182375,-358,1,6
100603,102139,1,Presencial,2.49,2,Mujer,Linkedin,11,916130,95.0,79,Viudo,59,2022,11,high,102154,Presencial,6.48,1,Hombre,Ferias & Networking,5,590000,90.0,67,Casado,25,2021,6,high,3.99,-1,-6,-326130,-509,1,-34
102303,102158,1,Presencial,1.525,1,Mujer,Referidos,1,96483,95.0,78,Soltero,21,2022,7,high,102093,Presencial,1.79,1,Mujer,Referidos,27,1900000,87.0,74,Viudo,54,2013,9,high,0.2650000000000001,0,26,1803517,-3231,1,33
103796,102105,1,Presencial,4.425,1,Mujer,Linkedin,1,103891,85.0,65,Soltero,17,2018,6,high,102113,Híbrida,2.07,0,Hombre,Linkedin,8,1616000,85.0,71,Viudo,45,2017,3,high,-2.355,-1,7,1512109,-444,1,28
103014,102142,1,Presencial,1.52,1,Hombre,Portal Web,3,163690,82.0,70,Soltero,24,2022,4,high,102047,Presencial,2.48,2,Hombre,Portal Web,3,1255430,90.0,66,Soltero,36,2019,7,high,0.96,1,0,1091740,-1005,1,12
104144,102138,1,Presencial,4.06,7,Hombre,Portal Web,2,203288,95.0,74,Viudo,24,2020,5,high,102059,Presencial,3.26,1,Hombre,Linkedin,5,1616000,57.0,75,Soltero,44,2018,4,low,-0.7999999999999998,-6,3,1412712,-763,1,20
103463,102060,1,Presencial,2.485,1,Mujer,Ferias & Networking,8,637075,88.0,75,Viudo,44,2016,6,high,102041,Presencial,4.42,3,Hombre,Referidos,16,1616000,82.0,62,Casado,45,2013,10,high,1.935,2,8,978925,-976,1,1
102550,102042,1,Presencial,1.48,1,Hombre,Portal Web,13,873238,80.0,85,Viudo,44,2015,5,high,102107,Presencial,2.19,2,Hombre,Ferias & Networking,8,1616000,38.0,78,Divorciado,57,2018,6,low,0.71,1,-5,742762,1126,0,13
103500,102137,1,Presencial,0.88,2,Mujer,Linkedin,4,795232,94.0,78,Viudo,52,2022,11,high,102046,Presencial,1.18,0,Mujer,Portal Web,2,845000,37.0,79,Casado,27,2017,12,low,0.29999999999999993,-2,-2,49768,-1775,1,-25
103501,102054,1,Presencial,1.31,2,Mujer,Linkedin,9,734878,89.0,71,Casado,47,2015,10,high,102044,Presencial,2.91,1,Hombre,Linkedin,17,1616000,85.0,74,Divorciado,41,2012,11,high,1.6,-1,8,881122,-1058,1,-6
102739,102030,1,Presencial,5.22,0,Mujer,Portal Web,7,734481,81.0,74,Divorciado,46,2013,11,high,102058,Presencial,6.34,0,Mujer,Referidos,14,1616000,90.0,76,Viudo,41,2015,4,high,1.12,0,7,881519,521,0,-5
100740,102074,1,Presencial,2.315,1,Hombre,Linkedin,1,82029,91.0,83,Soltero,12,2015,1,high,102028,Presencial,1.35,0,Hombre,Ferias & Networking,4,1616000,80.0,83,Viudo,43,2015,12,high,-0.9649999999999999,-1,3,1533971,342,0,31
100829,102148,1,Presencial,1.005,2,Mujer,Linkedin,6,228184,91.0,67,Soltero,29,2023,1,high,102116,Presencial,1.49,2,Mujer,Portal Web,2,539000,80.0,67,Soltero,26,2022,12,high,0.4850000000000001,0,-4,310816,-30,1,-3
101188,102057,1,Presencial,2.19,1,Mujer,Portal Web,2,251897,84.0,79,Casado,24,2016,7,high,102019,Presencial,1.97,4,Hombre,Portal Web,5,1616000,90.0,73,Viudo,59,2022,12,high,-0.21999999999999997,3,3,1364103,2341,0,35
100019,102084,1,Presencial,3.945,3,Hombre,Linkedin,7,288351,94.0,70,Casado,27,2018,2,high,102171,Presencial,2.62,3,Mujer,Portal Web,14,1616000,89.0,76,Divorciado,50,2023,7,high,-1.3249999999999997,0,7,1327649,1971,0,23
100631,102138,1,Presencial,5.06,2,Hombre,Portal Web,14,662472,85.0,70,Divorciado,51,2023,4,high,102059,Presencial,3.26,1,Hombre,Linkedin,5,1616000,57.0,75,Soltero,44,2018,4,low,-1.7999999999999998,-1,-9,953528,-1833,1,-7
100794,102042,1,Presencial,1.505,0,Hombre,Portal Web,13,879220,80.0,85,Viudo,44,2015,5,high,102107,Presencial,2.19,2,Hombre,Ferias & Networking,8,1616000,38.0,78,Divorciado,57,2018,6,low,0.685,2,-5,736780,1126,0,13
100538,102137,1,Presencial,0.885,2,Mujer,Linkedin,4,800767,80.0,78,Viudo,51,2022,11,high,102046,Presencial,1.18,0,Mujer,Portal Web,2,845000,37.0,79,Casado,27,2017,12,low,0.29499999999999993,-2,-2,44233,-1774,1,-24
101044,102054,1,Presencial,1.31,2,Mujer,Linkedin,9,733997,90.0,71,Casado,47,2015,9,high,102044,Presencial,2.91,1,Hombre,Linkedin,17,1616000,85.0,74,Divorciado,41,2012,11,high,1.6,-1,8,882003,-1056,1,-6
102457,102074,1,Presencial,2.31,1,Hombre,Linkedin,1,82974,90.0,83,Soltero,12,2015,1,high,102028,Presencial,1.35,0,Hombre,Ferias & Networking,4,1616000,80.0,83,Viudo,43,2015,12,high,-0.96,-1,3,1533026,343,0,31
103433,102148,1,Presencial,0.97,3,Mujer,Linkedin,6,229674,96.0,67,Soltero,29,2023,1,high,102116,Presencial,1.49,2,Mujer,Portal Web,2,539000,80.0,67,Soltero,26,2022,12,high,0.52,-1,-4,309326,-31,1,-3
103130,102057,1,Presencial,2.205,1,Mujer,Portal Web,2,253078,81.0,79,Casado,24,2016,7,high,102019,Presencial,1.97,4,Hombre,Portal Web,5,1616000,90.0,73,Viudo,59,2022,12,high,-0.2350000000000001,3,3,1362922,2339,0,35
102795,102142,1,Presencial,1.99,12,Hombre,Linkedin,7,331772,88.0,75,Casado,34,2022,8,high,102047,Presencial,2.48,2,Hombre,Portal Web,3,1255430,90.0,66,Soltero,36,2019,7,high,0.49,-10,-4,923658,-1147,1,2
103108,102092,1,Presencial,1.055,2,Hombre,Referidos,6,775334,84.0,81,Casado,47,2016,12,high,102120,Presencial,1.23,6,Mujer,Linkedin,13,1616000,98.0,95,Viudo,41,2013,6,high,0.17500000000000004,4,7,840666,-1259,1,-6
100386,102104,1,Presencial,6.17,3,Mujer,Portal Web,2,166082,97.0,66,Soltero,22,2020,3,high,102129,Híbrida,6.72,1,Mujer,Portal Web,6,743000,91.0,61,Soltero,30,2023,4,high,0.5499999999999998,-2,4,576918,1113,0,8
100520,102024,1,Presencial,1.475,1,Mujer,Portal Web,3,205280,84.0,79,Casado,16,2012,1,high,102074,Presencial,2.28,0,Hombre,Headhunter,9,1616000,84.0,70,Casado,48,2018,3,high,0.8049999999999997,-1,6,1410720,2261,0,32
101163,102100,1,Presencial,1.745,0,Hombre,Ferias & Networking,5,286445,97.0,71,Soltero,27,2017,5,high,102007,Presencial,3.3,1,Mujer,Portal Web,3,1255430,21.0,59,Casado,30,2013,2,low,1.5549999999999997,1,-2,968985,-1568,1,3
100555,102044,1,Presencial,1.105,1,Hombre,Ferias & Networking,8,328863,80.0,64,Casado,23,2012,8,high,102155,Presencial,1.54,1,Hombre,Ferias & Networking,14,1616000,56.0,68,Soltero,47,2023,3,low,0.43500000000000005,0,6,1287137,3870,0,24
101674,102164,1,Presencial,1.825,3,Mujer,Portal Web,6,365983,91.0,68,Soltero,36,2022,12,high,102109,Presencial,3.78,2,Hombre,Linkedin,7,1461470,83.0,77,Casado,40,2018,9,high,1.9549999999999998,-1,1,1095487,-1526,1,4
100223,102075,1,Presencial,2.315,8,Hombre,Linkedin,6,386124,92.0,79,Casado,30,2015,12,high,102047,Presencial,2.7,1,Hombre,Referidos,11,1255430,90.0,76,Casado,30,2013,3,high,0.38500000000000023,-7,5,869306,-994,1,0
101602,102044,1,Presencial,1.685,10,Mujer,Linkedin,3,388271,89.0,67,Soltero,27,2013,1,high,102155,Presencial,1.54,1,Hombre,Ferias & Networking,14,1616000,56.0,68,Soltero,47,2023,3,low,-0.14500000000000002,-9,11,1227729,3706,0,20
101481,102113,1,Presencial,3.445,1,Hombre,Referidos,3,411602,82.0,77,Soltero,33,2018,5,high,102041,Presencial,2.96,2,Hombre,Portal Web,6,1152410,46.0,75,Casado,27,2012,1,low,-0.4849999999999999,1,3,740808,-2297,1,-6
100668,102145,1,Presencial,5.71,1,Hombre,Ferias & Networking,5,792386,86.0,68,Casado,40,2020,12,high,102116,Presencial,1.43,1,Mujer,Portal Web,3,692000,89.0,73,Viudo,23,2016,12,high,-4.28,0,-2,-100386,-1471,1,-17
101531,102104,1,Presencial,3.88,2,Mujer,Ferias & Networking,5,487977,93.0,76,Soltero,38,2018,4,high,102129,Híbrida,6.72,1,Mujer,Portal Web,6,743000,91.0,61,Soltero,30,2023,4,high,2.84,-1,1,255023,1822,0,-8
101733,102059,1,Presencial,2.845,2,Mujer,Portal Web,7,484265,97.0,83,Soltero,33,2014,4,high,102021,Presencial,2.55,2,Hombre,Portal Web,16,1616000,27.0,76,Viudo,50,2019,6,low,-0.2950000000000004,0,9,1131735,1875,0,17
101686,102125,1,Presencial,1.83,2,Hombre,Portal Web,13,278527,85.0,79,Divorciado,43,2020,6,high,102096,Híbrida,4.0,2,Mujer,Referidos,5,692000,87.0,82,Casado,29,2022,7,high,2.17,0,-8,413473,780,0,-14
101031,102112,1,Presencial,4.14,1,Hombre,Linkedin,9,296283,92.0,77,Casado,45,2019,11,high,102031,Presencial,2.27,7,Hombre,Linkedin,1,692000,83.0,74,Soltero,26,2020,6,high,-1.8699999999999997,6,-8,395717,234,0,-19
101516,102023,1,Presencial,5.9,2,Mujer,Linkedin,12,661445,89.0,67,Soltero,41,2013,4,high,102105,Híbrida,4.9,1,Hombre,Portal Web,4,539000,80.0,65,Casado,23,2019,12,high,-1.0,-1,-8,-122445,2442,0,-18
103693,102055,1,Presencial,1.845,8,Mujer,Portal Web,5,180760,96.0,71,Soltero,17,2015,2,high,102129,Presencial,1.92,2,Hombre,Referidos,8,1616000,97.0,63,Casado,42,2013,2,high,0.07499999999999996,-6,3,1435240,-714,1,25
103434,102043,1,Presencial,3.085,1,Hombre,Linkedin,5,186515,90.0,77,Soltero,18,2014,1,high,102051,Presencial,1.03,0,Hombre,Portal Web,5,1616000,60.0,76,Casado,44,2019,5,low,-2.0549999999999997,-1,0,1429485,1966,0,26
102195,102142,1,Presencial,3.635,0,Hombre,Ferias & Networking,1,231475,92.0,75,Casado,28,2021,10,high,102047,Presencial,2.48,2,Hombre,Portal Web,3,1255430,90.0,66,Soltero,36,2019,7,high,-1.1549999999999998,2,2,1023955,-840,1,8
103499,102100,1,Presencial,1.7,0,Hombre,Ferias & Networking,5,291959,90.0,71,Soltero,27,2017,5,high,102007,Presencial,3.3,1,Mujer,Portal Web,3,1255430,21.0,59,Casado,30,2013,2,low,1.5999999999999999,1,-2,963471,-1570,1,3
103913,102044,1,Presencial,5.97,3,Mujer,Linkedin,8,306898,85.0,79,Soltero,25,2015,6,high,102155,Presencial,1.54,1,Hombre,Ferias & Networking,14,1616000,56.0,68,Soltero,47,2023,3,low,-4.43,-2,6,1309102,2825,0,22
104128,102164,1,Presencial,1.85,3,Mujer,Portal Web,6,366785,85.0,68,Soltero,36,2022,12,high,102109,Presencial,3.78,2,Hombre,Linkedin,7,1461470,83.0,77,Casado,40,2018,9,high,1.9299999999999997,-1,1,1094685,-1525,1,4
103664,102044,1,Presencial,1.705,10,Mujer,Linkedin,3,393514,88.0,67,Soltero,27,2013,1,high,102155,Presencial,1.54,1,Hombre,Ferias & Networking,14,1616000,56.0,68,Soltero,47,2023,3,low,-0.16500000000000004,-9,11,1222486,3709,0,20
102698,102113,1,Presencial,3.46,2,Hombre,Referidos,3,412371,93.0,77,Soltero,33,2018,4,high,102041,Presencial,2.96,2,Hombre,Portal Web,6,1152410,46.0,75,Casado,27,2012,1,low,-0.5,0,3,740039,-2295,1,-6
103057,102119,1,Presencial,1.785,2,Hombre,Portal Web,12,464934,85.0,76,Divorciado,40,2021,12,high,102107,Presencial,2.22,2,Hombre,Portal Web,12,1616000,38.0,70,Divorciado,52,2021,1,low,0.4350000000000003,0,0,1151066,-346,1,12
102701,102082,1,Presencial,6.81,8,Mujer,Linkedin,14,266776,90.0,76,Casado,41,2018,7,high,102050,Presencial,5.5,2,Mujer,Linkedin,7,1616000,81.0,70,Casado,36,2018,8,high,-1.3099999999999996,-6,-7,1349224,18,0,-5
102523,102085,1,Presencial,5.795,1,Hombre,Linkedin,12,288487,89.0,88,Casado,42,2018,10,high,102145,Presencial,6.59,4,Hombre,Portal Web,12,1616000,47.0,71,Casado,39,2015,8,low,0.7949999999999999,3,0,1327513,-1153,1,-3
102296,102112,1,Presencial,4.165,1,Hombre,Portal Web,9,296281,86.0,77,Casado,45,2019,11,high,102031,Presencial,2.27,7,Hombre,Linkedin,1,692000,83.0,74,Soltero,26,2020,6,high,-1.895,6,-8,395719,233,0,-19
103867,102114,1,Presencial,6.065,7,Hombre,Portal Web,6,307826,84.0,77,Divorciado,46,2019,10,high,102050,Presencial,1.44,1,Mujer,Portal Web,5,1616000,91.0,69,Divorciado,47,2021,5,high,-4.625,-6,-1,1308174,591,0,1
102743,102130,1,Presencial,2.395,1,Hombre,Linkedin,9,695247,89.0,63,Divorciado,52,2022,10,high,102068,Presencial,1.97,6,Hombre,Linkedin,5,1616000,84.0,73,Soltero,31,2014,4,high,-0.42500000000000004,5,-4,920753,-3114,1,-21
101183,102041,1,Presencial,5.75,1,Hombre,Ferias & Networking,2,119883,89.0,75,Soltero,14,2014,11,high,102147,Presencial,1.29,0,Mujer,Portal Web,8,1616000,44.0,73,Casado,51,2014,5,low,-4.46,-1,6,1496117,-187,1,37
100467,102043,1,Presencial,3.085,2,Hombre,Linkedin,5,187644,81.0,77,Soltero,17,2014,1,high,102051,Presencial,1.03,0,Hombre,Portal Web,5,1616000,60.0,76,Casado,44,2019,5,low,-2.0549999999999997,-2,0,1428356,1966,0,27
100398,102151,1,Presencial,5.175,1,Hombre,Headhunter,4,266865,84.0,70,Casado,30,2022,9,high,102105,Presencial,1.51,2,Hombre,Ferias & Networking,10,1616000,85.0,80,Divorciado,45,2021,11,high,-3.665,1,6,1349135,-312,1,15
101518,102129,1,Presencial,2.11,1,Hombre,Portal Web,7,246586,96.0,65,Soltero,27,2020,7,high,102142,Presencial,2.1,2,Mujer,Linkedin,3,590000,41.0,74,Soltero,24,2020,1,low,-0.009999999999999787,1,-4,343414,-182,1,-3
101160,102140,1,Presencial,6.575,0,Hombre,Ferias & Networking,7,289311,94.0,75,Soltero,30,2021,4,high,102040,Presencial,2.55,0,Mujer,Portal Web,16,1616000,46.0,69,Casado,39,2012,2,low,-4.025,0,9,1326689,-3363,1,9
101691,102044,1,Presencial,5.99,3,Mujer,Linkedin,8,313254,85.0,79,Soltero,25,2015,6,high,102155,Presencial,1.54,1,Hombre,Ferias & Networking,14,1616000,56.0,68,Soltero,47,2023,3,low,-4.45,-2,6,1302746,2824,0,22
101119,102044,1,Presencial,4.69,4,Hombre,Referidos,3,327091,98.0,72,Soltero,25,2014,11,high,102155,Presencial,1.54,1,Hombre,Ferias & Networking,14,1616000,56.0,68,Soltero,47,2023,3,low,-3.1500000000000004,-3,11,1288909,3061,0,22
100699,102172,1,Presencial,2.39,1,Hombre,Referidos,8,792202,93.0,64,Casado,37,2022,11,high,102020,Presencial,5.58,1,Hombre,Portal Web,7,1049000,57.0,70,Casado,29,2016,4,low,3.19,0,-1,256798,-2402,1,-8
101977,102058,1,Presencial,2.375,2,Mujer,Referidos,5,432693,93.0,72,Soltero,29,2013,9,high,102172,Presencial,1.4,2,Hombre,Ferias & Networking,11,1616000,75.0,71,Casado,59,2021,2,low,-0.9750000000000001,0,6,1183307,2725,0,30
100232,102040,1,Presencial,1.345,1,Hombre,Referidos,5,768163,92.0,83,Soltero,30,2013,1,high,102106,Presencial,3.21,1,Hombre,Linkedin,15,1616000,91.0,84,Soltero,45,2016,7,high,1.865,0,10,847837,1280,0,15
101656,102119,1,Presencial,1.75,2,Hombre,Portal Web,12,470811,81.0,76,Divorciado,40,2021,12,high,102107,Presencial,2.22,2,Hombre,Portal Web,12,1616000,38.0,70,Divorciado,52,2021,1,low,0.4700000000000002,0,0,1145189,-345,1,12
100341,102085,1,Presencial,1.655,1,Mujer,Portal Web,9,243779,87.0,61,Casado,39,2018,8,high,102145,Presencial,6.59,4,Hombre,Portal Web,12,1616000,47.0,71,Casado,39,2015,8,low,4.935,3,3,1372221,-1106,1,0
100597,102105,1,Presencial,4.095,2,Mujer,Linkedin,8,255103,92.0,79,Casado,39,2018,10,high,102113,Híbrida,2.07,0,Hombre,Linkedin,8,1616000,85.0,71,Viudo,45,2017,3,high,-2.025,-2,0,1360897,-583,1,6
100276,102082,1,Presencial,6.77,8,Mujer,Linkedin,14,267580,88.0,76,Casado,41,2018,7,high,102050,Presencial,5.5,2,Mujer,Linkedin,7,1616000,81.0,70,Casado,36,2018,8,high,-1.2699999999999996,-6,-7,1348420,18,0,-5
102028,102085,2,Presencial,1.39,2,Mujer,Linkedin,12,1358450,97.0,72,Soltero,35,2016,12,high,102145,Presencial,6.59,4,Hombre,Portal Web,12,1616000,47.0,71,Casado,39,2015,8,low,5.2,2,0,257550,-508,1,4
102086,102085,2,Presencial,2.22,2,Mujer,Linkedin,7,1306940,87.0,68,Divorciado,39,2021,3,high,102145,Presencial,6.59,4,Hombre,Portal Web,12,1616000,47.0,71,Casado,39,2015,8,low,4.369999999999999,2,5,309060,-2036,1,0
102150,102085,2,Presencial,3.9,8,Mujer,Portal Web,10,1358450,85.0,75,Casado,32,2012,12,high,102145,Presencial,6.59,4,Hombre,Portal Web,12,1616000,47.0,71,Casado,39,2015,8,low,2.69,-4,2,257550,962,0,7
101689,102085,1,Presencial,5.77,2,Hombre,Linkedin,12,284655,86.0,88,Casado,42,2018,10,high,102145,Presencial,6.59,4,Hombre,Portal Web,12,1616000,47.0,71,Casado,39,2015,8,low,0.8200000000000003,2,0,1331345,-1152,1,-3
101622,102048,1,Presencial,4.41,1,Hombre,Ferias & Networking,3,309096,97.0,81,Soltero,42,2016,2,high,102092,Presencial,3.99,0,Mujer,Portal Web,5,590000,59.0,76,Soltero,20,2015,8,low,-0.41999999999999993,-1,2,280904,-164,1,-22
102022,102081,2,Presencial,2.07,0,Hombre,Portal Web,6,1616000,94.0,66,Viudo,47,2020,5,high,102135,Presencial,2.5,2,Hombre,Portal Web,4,488000,26.0,64,Soltero,18,2015,8,low,0.43000000000000016,2,-2,-1128000,-1742,1,-29
101378,102081,1,Presencial,3.78,6,Hombre,Linkedin,6,893594,84.0,86,Casado,52,2017,2,high,102135,Presencial,2.5,2,Hombre,Portal Web,4,488000,26.0,64,Soltero,18,2015,8,low,-1.2799999999999998,-4,-2,-405594,-534,1,-34
102035,102041,2,Presencial,2.86,1,Hombre,Portal Web,23,1900000,83.0,72,Casado,57,2013,8,high,102147,Presencial,1.29,0,Mujer,Portal Web,8,1616000,44.0,73,Casado,51,2014,5,low,-1.5699999999999998,-1,-15,-284000,285,0,-6
103392,102041,1,Presencial,5.735,1,Hombre,Ferias & Networking,2,122600,82.0,75,Soltero,14,2014,11,high,102147,Presencial,1.29,0,Mujer,Portal Web,8,1616000,44.0,73,Casado,51,2014,5,low,-4.445,-1,6,1493400,-186,1,37
104092,102129,1,Presencial,2.105,2,Hombre,Portal Web,7,253675,83.0,65,Soltero,27,2020,7,high,102142,Presencial,2.1,2,Mujer,Linkedin,3,590000,41.0,74,Soltero,24,2020,1,low,-0.004999999999999893,0,-4,336325,-182,1,-3
103163,102145,1,Presencial,5.715,1,Hombre,Ferias & Networking,5,791189,98.0,68,Casado,40,2020,12,high,102116,Presencial,1.43,1,Mujer,Portal Web,3,692000,89.0,73,Viudo,23,2016,12,high,-4.285,0,-2,-99189,-1470,1,-17
103323,102081,1,Presencial,4.63,2,Mujer,Ferias & Networking,7,274422,92.0,85,Viudo,39,2016,8,high,102135,Presencial,2.5,2,Hombre,Portal Web,4,488000,26.0,64,Soltero,18,2015,8,low,-2.13,0,-3,213578,-356,1,-21
104044,102125,1,Presencial,1.84,2,Hombre,Portal Web,13,277936,80.0,79,Divorciado,44,2020,6,high,102096,Híbrida,4.0,2,Mujer,Referidos,5,692000,87.0,82,Casado,29,2022,7,high,2.16,0,-8,414064,781,0,-15
102968,102048,1,Presencial,4.445,2,Hombre,Ferias & Networking,3,312292,97.0,81,Soltero,42,2016,2,high,102092,Presencial,3.99,0,Mujer,Portal Web,5,590000,59.0,76,Soltero,20,2015,8,low,-0.45500000000000007,-2,2,277708,-164,1,-22
103218,102031,1,Presencial,2.215,1,Mujer,Portal Web,6,895724,88.0,88,Viudo,49,2012,3,high,102111,Presencial,2.95,2,Hombre,Portal Web,8,1610000,76.0,87,Casado,31,2017,7,low,0.7350000000000003,1,2,714276,1938,0,-18
100426,102043,1,Presencial,2.34,0,Mujer,Referidos,1,208498,98.0,67,Soltero,19,2014,2,high,102051,Presencial,1.03,0,Hombre,Portal Web,5,1616000,60.0,76,Casado,44,2019,5,low,-1.3099999999999998,0,4,1407502,1920,0,25
100215,102084,1,Presencial,1.67,8,Mujer,Portal Web,4,428422,90.0,65,Casado,33,2016,7,high,102171,Presencial,2.62,3,Mujer,Portal Web,14,1616000,89.0,76,Divorciado,50,2023,7,high,0.9500000000000002,-5,10,1187578,2551,0,17
102110,102045,2,Presencial,1.6,5,Mujer,Linkedin,2,998000,87.0,76,Soltero,29,2016,11,high,102171,Presencial,3.19,3,Hombre,Portal Web,11,1616000,97.0,65,Casado,53,2023,9,high,1.5899999999999999,-2,9,618000,2497,0,24
100074,102045,1,Presencial,2.405,2,Hombre,Portal Web,14,440246,90.0,70,Casado,37,2013,2,high,102171,Presencial,3.19,3,Hombre,Portal Web,11,1616000,97.0,65,Casado,53,2023,9,high,0.7850000000000001,1,-3,1175754,3868,0,16
100082,102065,1,Presencial,5.35,6,Mujer,Portal Web,3,837045,92.0,72,Soltero,45,2017,5,high,102026,Presencial,2.44,2,Hombre,Ferias & Networking,13,1616000,45.0,60,Divorciado,35,2014,10,low,-2.9099999999999997,-4,10,778955,-962,1,-10
100406,102018,1,Presencial,3.13,1,Mujer,Portal Web,8,797939,98.0,71,Divorciado,42,2013,2,high,102160,Presencial,5.57,5,Hombre,Portal Web,3,692000,90.0,69,Divorciado,28,2022,2,high,2.4400000000000004,4,-5,-105939,3313,0,-14
103300,102024,1,Presencial,4.725,3,Mujer,Referidos,8,486856,86.0,77,Soltero,31,2012,7,high,102074,Presencial,2.28,0,Hombre,Headhunter,9,1616000,84.0,70,Casado,48,2018,3,high,-2.445,-3,1,1129144,2068,0,17
102875,102018,1,Presencial,3.155,1,Mujer,Portal Web,8,796781,83.0,71,Divorciado,42,2013,1,high,102160,Presencial,5.57,5,Hombre,Portal Web,3,692000,90.0,69,Divorciado,28,2022,2,high,2.4150000000000005,4,-5,-104781,3315,0,-14
100325,102003,1,Presencial,4.48,3,Mujer,Linkedin,3,227618,83.0,77,Casado,18,2012,6,high,102130,Presencial,4.05,12,Hombre,Portal Web,8,1616000,83.0,82,Divorciado,49,2023,2,high,-0.4300000000000006,9,5,1388382,3917,0,31
101570,102062,1,Presencial,1.35,0,Mujer,Portal Web,3,445745,90.0,76,Soltero,34,2016,11,high,102149,Presencial,0.92,2,Mujer,Referidos,6,692000,38.0,72,Soltero,21,2014,10,low,-0.43000000000000005,2,3,246255,-789,1,-13
101767,102037,1,Presencial,1.81,3,Mujer,Portal Web,9,695104,88.0,73,Viudo,43,2013,7,high,102057,Presencial,1.12,1,Mujer,Linkedin,2,641000,50.0,76,Casado,21,2016,12,low,-0.69,-2,-7,-54104,1239,0,-22
103677,102003,1,Presencial,4.495,2,Mujer,Linkedin,3,226487,92.0,77,Casado,18,2012,6,high,102130,Presencial,4.05,12,Hombre,Portal Web,8,1616000,83.0,82,Divorciado,49,2023,2,high,-0.4450000000000003,10,5,1389513,3919,0,31
103005,102073,1,Presencial,5.765,1,Mujer,Portal Web,9,407185,98.0,86,Casado,31,2016,6,high,102139,Presencial,1.98,2,Hombre,Portal Web,11,1306940,95.0,86,Soltero,37,2019,7,high,-3.7849999999999997,1,2,899755,1123,0,6
102343,102062,1,Presencial,1.35,1,Mujer,Portal Web,3,451669,87.0,76,Soltero,34,2016,12,high,102149,Presencial,0.92,2,Mujer,Referidos,6,692000,38.0,72,Soltero,21,2014,10,low,-0.43000000000000005,1,3,240331,-792,1,-13
100937,102101,1,Presencial,0.855,2,Mujer,Linkedin,1,140559,85.0,77,Soltero,19,2018,6,high,102089,Presencial,6.23,0,Hombre,Portal Web,26,1616000,92.0,68,Divorciado,55,2014,1,high,5.375,-2,25,1475441,-1612,1,36
100565,102154,1,Presencial,4.95,0,Hombre,Linkedin,6,227557,89.0,70,Soltero,28,2022,7,high,102172,Presencial,5.45,1,Hombre,Portal Web,7,1512980,93.0,69,Soltero,39,2017,10,high,0.5,1,1,1285423,-1744,1,11
101817,102115,1,Presencial,3.105,2,Hombre,Ferias & Networking,3,246416,81.0,70,Casado,26,2018,10,high,102116,Presencial,2.0,2,Mujer,Portal Web,4,1616000,94.0,76,Soltero,35,2018,12,high,-1.105,0,1,1369584,62,0,9
100769,102150,1,Presencial,5.43,7,Hombre,Portal Web,9,390718,91.0,61,Soltero,37,2022,7,high,102085,Presencial,3.9,8,Mujer,Portal Web,10,1358450,85.0,75,Casado,32,2012,12,high,-1.5299999999999998,1,1,967732,-3484,1,-5
100149,102117,1,Presencial,1.94,1,Mujer,Referidos,6,788434,85.0,77,Casado,36,2020,12,high,102154,Presencial,4.05,1,Mujer,Linkedin,10,1616000,90.0,80,Divorciado,48,2021,1,high,2.11,0,4,827566,58,0,12
100243,102013,1,Presencial,1.49,3,Mujer,Portal Web,6,877505,86.0,70,Casado,46,2012,12,high,102139,Presencial,2.0,2,Mujer,Linkedin,4,743000,96.0,79,Casado,30,2022,11,high,0.51,-1,-2,-134505,3622,0,-16
103215,102109,1,Presencial,5.855,2,Mujer,Referidos,1,250693,90.0,74,Soltero,27,2020,11,high,102123,Presencial,3.86,1,Mujer,Portal Web,5,998000,97.0,82,Casado,32,2019,9,high,-1.9950000000000006,-1,4,747307,-407,1,5
103715,102150,1,Presencial,5.435,6,Hombre,Portal Web,9,390678,82.0,61,Soltero,37,2022,7,high,102085,Presencial,3.9,8,Mujer,Portal Web,10,1358450,85.0,75,Casado,32,2012,12,high,-1.5349999999999997,2,1,967772,-3484,1,-5
102367,102117,1,Presencial,1.935,1,Mujer,Referidos,6,790710,81.0,77,Casado,36,2020,12,high,102154,Presencial,4.05,1,Mujer,Linkedin,10,1616000,90.0,80,Divorciado,48,2021,1,high,2.1149999999999998,0,4,825290,55,0,12
100152,102110,1,Presencial,3.945,0,Hombre,Portal Web,1,180570,90.0,79,Casado,24,2020,12,high,102045,Presencial,1.6,5,Mujer,Linkedin,2,998000,87.0,76,Soltero,29,2016,11,high,-2.3449999999999998,5,1,817430,-1493,1,5
101204,102084,1,Presencial,1.445,1,Hombre,Linkedin,5,307154,91.0,64,Casado,28,2017,11,high,102171,Presencial,2.62,3,Mujer,Portal Web,14,1616000,89.0,76,Divorciado,50,2023,7,high,1.175,2,9,1308846,2069,0,22
100577,102152,1,Presencial,0.955,1,Mujer,Portal Web,5,301061,80.0,86,Divorciado,47,2021,7,high,102089,Presencial,2.75,5,Hombre,Portal Web,7,1616000,15.0,68,Soltero,47,2019,8,low,1.795,4,2,1314939,-670,1,0
101478,102075,1,Presencial,1.69,2,Mujer,Linkedin,3,419357,92.0,81,Viudo,41,2016,6,high,102047,Presencial,2.7,1,Hombre,Referidos,11,1255430,90.0,76,Casado,30,2013,3,high,1.0100000000000002,-1,8,836073,-1182,1,-11
102026,102101,2,Presencial,2.7,1,Mujer,Portal Web,15,1616000,97.0,79,Casado,58,2017,6,high,102089,Presencial,6.23,0,Hombre,Portal Web,26,1616000,92.0,68,Divorciado,55,2014,1,high,3.5300000000000002,-1,11,0,-1265,1,-3
103479,102101,1,Presencial,0.825,1,Mujer,Linkedin,1,146416,96.0,77,Soltero,19,2018,6,high,102089,Presencial,6.23,0,Hombre,Portal Web,26,1616000,92.0,68,Divorciado,55,2014,1,high,5.405,-1,25,1469584,-1611,1,36
102549,102068,1,Presencial,1.9,0,Mujer,Linkedin,1,160667,97.0,82,Soltero,19,2016,9,high,102043,Híbrida,2.17,3,Mujer,Referidos,4,896000,41.0,81,Soltero,23,2012,8,low,0.27,3,3,735333,-1481,1,4
103588,102110,1,Presencial,3.96,0,Hombre,Portal Web,1,185488,92.0,79,Casado,24,2020,12,high,102045,Presencial,1.6,5,Mujer,Linkedin,2,998000,87.0,76,Soltero,29,2016,11,high,-2.36,5,1,812512,-1491,1,5
103336,102064,1,Presencial,2.48,1,Mujer,Portal Web,7,420718,97.0,76,Casado,38,2017,6,high,102067,Presencial,1.34,0,Hombre,Portal Web,6,1616000,92.0,92,Casado,43,2018,2,high,-1.14,-1,-1,1195282,220,0,5
102515,102056,1,Presencial,1.98,0,Mujer,Linkedin,10,269612,86.0,76,Divorciado,36,2013,11,high,102014,Presencial,5.24,1,Hombre,Ferias & Networking,16,1616000,70.0,63,Viudo,65,2023,3,low,3.2600000000000002,1,6,1346388,3392,0,29
102703,102172,1,Presencial,1.645,2,Hombre,Referidos,12,317459,88.0,70,Casado,50,2023,6,high,102020,Presencial,5.58,1,Hombre,Portal Web,7,1049000,57.0,70,Casado,29,2016,4,low,3.935,-1,-5,731541,-2621,1,-21
103013,102098,1,Presencial,3.505,2,Hombre,Ferias & Networking,13,873262,96.0,87,Divorciado,45,2017,7,high,102049,Presencial,1.8,1,Mujer,Portal Web,16,1616000,90.0,86,Casado,46,2021,1,high,-1.7049999999999998,-1,3,742738,1281,0,1
102950,102048,1,Presencial,6.205,2,Mujer,Portal Web,18,742229,86.0,71,Divorciado,47,2015,7,high,102092,Presencial,3.99,0,Mujer,Portal Web,5,590000,59.0,76,Soltero,20,2015,8,low,-2.215,-2,-13,-152229,28,0,-27
101105,102068,1,Presencial,1.91,1,Mujer,Linkedin,1,165775,87.0,82,Soltero,19,2016,9,high,102043,Híbrida,2.17,3,Mujer,Referidos,4,896000,41.0,81,Soltero,23,2012,8,low,0.26,2,3,730225,-1482,1,4
101804,102069,1,Presencial,3.295,2,Mujer,Portal Web,3,186157,85.0,71,Soltero,20,2017,2,high,102069,Presencial,4.64,1,Mujer,Ferias & Networking,19,1616000,47.0,74,Casado,60,2021,10,low,1.3449999999999998,-1,16,1429843,1720,0,40
100402,102096,1,Presencial,1.15,5,Mujer,Portal Web,6,326166,89.0,68,Casado,30,2018,6,high,102116,Presencial,5.11,8,Mujer,Linkedin,13,1461470,90.0,74,Soltero,42,2021,5,high,3.9600000000000004,3,7,1135304,1050,0,12
102714,102096,1,Presencial,1.135,4,Mujer,Portal Web,6,327055,88.0,68,Casado,30,2018,6,high,102116,Presencial,5.11,8,Mujer,Linkedin,13,1461470,90.0,74,Soltero,42,2021,5,high,3.9750000000000005,4,7,1134415,1053,0,12
102417,102065,1,Presencial,2.01,9,Hombre,Portal Web,1,141722,92.0,76,Soltero,16,2016,3,high,102026,Presencial,2.44,2,Hombre,Ferias & Networking,13,1616000,45.0,60,Divorciado,35,2014,10,low,0.43000000000000016,-7,12,1474278,-540,1,19
100485,102101,1,Presencial,1.81,1,Mujer,Ferias & Networking,2,143062,94.0,72,Casado,18,2017,8,high,102089,Presencial,6.23,0,Hombre,Portal Web,26,1616000,92.0,68,Divorciado,55,2014,1,high,4.42,-1,24,1472938,-1322,1,37
100746,102122,1,Presencial,1.895,1,Hombre,Ferias & Networking,3,163646,91.0,76,Soltero,22,2020,5,high,102075,Presencial,1.83,4,Hombre,Portal Web,6,1616000,90.0,66,Viudo,48,2019,3,high,-0.06499999999999995,3,3,1452354,-426,1,26
100043,102011,1,Presencial,1.42,1,Mujer,Portal Web,6,328927,96.0,82,Soltero,24,2012,12,high,102048,Presencial,5.37,1,Hombre,Ferias & Networking,7,845000,52.0,74,Casado,22,2012,11,low,3.95,0,1,516073,-26,1,-2
100600,102010,1,Presencial,1.32,1,Mujer,Portal Web,8,408888,98.0,69,Soltero,27,2012,3,high,102035,Presencial,2.02,0,Mujer,Linkedin,5,1564490,77.0,73,Casado,44,2021,8,low,0.7,-1,-3,1155602,3432,0,17
101758,102138,1,Presencial,1.01,4,Hombre,Portal Web,5,310423,94.0,77,Soltero,48,2022,12,high,102059,Presencial,3.26,1,Hombre,Linkedin,5,1616000,57.0,75,Soltero,44,2018,4,low,2.25,-3,0,1305577,-1726,1,-4
101434,102105,1,Presencial,4.605,0,Hombre,Referidos,8,310809,85.0,76,Viudo,44,2018,2,high,102113,Híbrida,2.07,0,Hombre,Linkedin,8,1616000,85.0,71,Viudo,45,2017,3,high,-2.5350000000000006,0,0,1305191,-327,1,1
100718,102091,1,Presencial,2.46,2,Mujer,Linkedin,9,405082,88.0,81,Divorciado,43,2017,5,high,102149,Presencial,1.54,1,Mujer,Portal Web,4,1616000,73.0,77,Casado,39,2014,12,low,-0.9199999999999999,-1,-5,1210918,-862,1,-4
101577,102153,1,Presencial,3.925,1,Mujer,Portal Web,7,676172,95.0,76,Viudo,50,2021,9,high,102143,Presencial,6.39,1,Mujer,Linkedin,5,1616000,90.0,68,Casado,41,2019,6,high,2.465,0,-2,939828,-828,1,-9
101932,102036,1,Presencial,2.475,0,Hombre,Portal Web,4,720228,89.0,71,Casado,43,2012,12,high,102054,Presencial,1.68,8,Hombre,Portal Web,5,1616000,92.0,76,Viudo,54,2022,1,high,-0.7950000000000002,8,1,895772,3325,0,11
101772,102031,1,Presencial,1.695,1,Mujer,Referidos,21,901724,85.0,80,Casado,49,2013,4,high,102111,Presencial,2.95,2,Hombre,Portal Web,8,1610000,76.0,87,Casado,31,2017,7,low,1.2550000000000001,1,-13,708276,1546,0,-18
104075,102094,1,Presencial,1.4,2,Mujer,Portal Web,1,100872,89.0,74,Soltero,16,2018,6,high,102095,Presencial,1.32,1,Hombre,Portal Web,4,998000,90.0,85,Casado,28,2016,2,high,-0.07999999999999985,-1,3,897128,-850,1,12
102422,102102,1,Presencial,4.52,2,Hombre,Ferias & Networking,1,227979,88.0,75,Soltero,25,2018,10,high,102018,Presencial,2.48,0,Hombre,Portal Web,5,1616000,92.0,63,Viudo,49,2019,4,high,-2.0399999999999996,-2,4,1388021,188,0,24
102502,102026,1,Presencial,2.035,0,Mujer,Portal Web,1,226937,82.0,74,Soltero,19,2013,3,high,102101,Presencial,2.7,1,Mujer,Portal Web,15,1616000,97.0,79,Casado,58,2017,6,high,0.665,1,14,1389063,1563,0,39
103732,102071,1,Presencial,1.305,0,Mujer,Linkedin,7,331890,98.0,74,Soltero,27,2016,12,high,102171,Presencial,0.87,1,Hombre,Portal Web,11,1616000,85.0,72,Viudo,51,2023,11,high,-0.43499999999999994,1,4,1284110,2510,0,24
102942,102011,1,Presencial,1.44,1,Mujer,Portal Web,6,333345,87.0,82,Soltero,24,2012,12,high,102048,Presencial,5.37,1,Hombre,Ferias & Networking,7,845000,52.0,74,Casado,22,2012,11,low,3.93,0,1,511655,-29,1,-2
102336,102069,1,Presencial,6.265,8,Mujer,Portal Web,5,351052,92.0,74,Soltero,29,2017,5,high,102069,Presencial,4.64,1,Mujer,Ferias & Networking,19,1616000,47.0,74,Casado,60,2021,10,low,-1.625,-7,14,1264948,1635,0,31
102949,102083,1,Presencial,5.88,1,Hombre,Linkedin,6,468818,83.0,75,Casado,35,2016,6,high,102147,Presencial,1.61,0,Mujer,Portal Web,5,1564490,83.0,71,Soltero,44,2021,2,high,-4.27,-1,-1,1095672,1721,0,9
102673,102103,1,Presencial,2.19,1,Hombre,Portal Web,12,264111,82.0,61,Soltero,41,2019,11,high,102023,Presencial,1.69,6,Hombre,Portal Web,3,1616000,90.0,74,Casado,45,2013,5,high,-0.5,5,-9,1351889,-2379,1,4
103531,102121,1,Presencial,1.68,5,Hombre,Portal Web,10,269868,87.0,83,Soltero,45,2022,6,high,102127,Híbrida,1.63,2,Hombre,Portal Web,4,1616000,90.0,77,Divorciado,44,2012,2,high,-0.050000000000000044,-3,-6,1346132,-3752,1,-1
102258,102092,1,Presencial,5.08,0,Mujer,Referidos,12,285019,82.0,72,Soltero,41,2017,1,high,102120,Presencial,1.23,6,Mujer,Linkedin,13,1616000,98.0,95,Viudo,41,2013,6,high,-3.85,6,1,1330981,-1295,1,0
102804,102088,1,Presencial,1.56,2,Mujer,Linkedin,14,312036,87.0,87,Soltero,44,2018,6,high,102139,Presencial,4.96,1,Mujer,Portal Web,3,488000,82.0,65,Soltero,20,2018,4,high,3.4,-1,-11,175964,-77,1,-24
102983,102091,1,Presencial,2.47,3,Mujer,Linkedin,9,406177,91.0,81,Divorciado,42,2017,5,high,102149,Presencial,1.54,1,Mujer,Portal Web,4,1616000,73.0,77,Casado,39,2014,12,low,-0.9300000000000002,-2,-5,1209823,-862,1,-3
103682,102116,1,Presencial,2.015,2,Hombre,Ferias & Networking,5,642085,82.0,72,Viudo,48,2020,9,high,102021,Presencial,2.32,0,Mujer,Portal Web,22,1616000,94.0,76,Casado,59,2020,7,high,0.3049999999999997,-2,17,973915,-53,1,11
102583,102153,1,Presencial,3.925,2,Mujer,Portal Web,7,682624,92.0,76,Viudo,50,2021,9,high,102143,Presencial,6.39,1,Mujer,Linkedin,5,1616000,90.0,68,Casado,41,2019,6,high,2.465,-1,-2,933376,-828,1,-9
103750,102067,1,Presencial,1.475,2,Hombre,Portal Web,3,736279,96.0,66,Casado,49,2017,9,high,102058,Presencial,0.92,1,Mujer,Portal Web,5,1616000,90.0,70,Divorciado,46,2020,8,high,-0.555,-1,2,879721,1067,0,-3
103287,102031,1,Presencial,1.685,2,Mujer,Referidos,20,898122,83.0,80,Casado,49,2013,4,high,102111,Presencial,2.95,2,Hombre,Portal Web,8,1610000,76.0,87,Casado,31,2017,7,low,1.2650000000000001,0,-12,711878,1547,0,-18
101973,102144,1,Presencial,2.225,1,Mujer,Portal Web,3,138624,84.0,68,Soltero,23,2023,3,high,102156,Presencial,2.13,8,Mujer,Portal Web,11,1616000,5.0,82,Viudo,58,2015,6,low,-0.0950000000000002,7,8,1477376,-2827,1,35
100809,102122,1,Presencial,1.77,2,Mujer,Portal Web,1,139161,88.0,82,Soltero,19,2019,1,high,102075,Presencial,1.83,4,Hombre,Portal Web,6,1616000,90.0,66,Viudo,48,2019,3,high,0.06000000000000005,2,5,1476839,58,0,29
100791,102104,1,Presencial,2.605,3,Mujer,Referidos,2,166920,92.0,75,Soltero,22,2019,12,high,102129,Híbrida,6.72,1,Mujer,Portal Web,6,743000,91.0,61,Soltero,30,2023,4,high,4.115,-2,4,576080,1217,0,8
101019,102065,1,Presencial,5.735,0,Mujer,Ferias & Networking,4,229014,90.0,72,Casado,24,2017,9,high,102026,Presencial,2.44,2,Hombre,Ferias & Networking,13,1616000,45.0,60,Divorciado,35,2014,10,low,-3.2950000000000004,2,9,1386986,-1089,1,11
102014,102096,2,Presencial,1.78,1,Mujer,Portal Web,2,488000,98.0,78,Soltero,25,2023,1,high,102116,Presencial,5.11,8,Mujer,Linkedin,13,1461470,90.0,74,Soltero,42,2021,5,high,3.33,7,11,973470,-615,1,17
101411,102096,1,Presencial,3.96,0,Mujer,Portal Web,4,269006,88.0,76,Casado,28,2020,4,high,102116,Presencial,5.11,8,Mujer,Linkedin,13,1461470,90.0,74,Soltero,42,2021,5,high,1.1500000000000004,8,9,1192464,381,0,14
101607,102094,1,Presencial,2.38,11,Mujer,Linkedin,5,267730,97.0,76,Soltero,27,2019,4,high,102095,Presencial,1.32,1,Hombre,Portal Web,4,998000,90.0,85,Casado,28,2016,2,high,-1.0599999999999998,-10,-1,730270,-1183,1,1
100510,102047,1,Presencial,1.475,1,Mujer,Portal Web,7,312053,82.0,74,Casado,25,2015,10,high,102089,Presencial,2.67,1,Hombre,Linkedin,4,743000,14.0,70,Casado,22,2015,11,low,1.1949999999999998,0,-3,430947,30,0,-3
101876,102099,1,Presencial,7.6,2,Hombre,Linkedin,2,311691,98.0,71,Casado,28,2017,9,high,102080,Presencial,1.71,0,Hombre,Portal Web,11,1616000,76.0,80,Viudo,51,2021,10,low,-5.89,-2,9,1304309,1483,0,23
100067,102071,1,Presencial,1.3,0,Mujer,Linkedin,7,333688,85.0,74,Soltero,27,2016,12,high,102171,Presencial,0.87,1,Hombre,Portal Web,11,1616000,85.0,72,Viudo,51,2023,11,high,-0.43000000000000005,1,4,1282312,2509,0,24
100977,102142,1,Presencial,6.395,2,Mujer,Portal Web,3,329986,83.0,74,Casado,32,2021,4,high,102047,Presencial,2.48,2,Hombre,Portal Web,3,1255430,90.0,66,Soltero,36,2019,7,high,-3.9149999999999996,0,0,925444,-640,1,4
100508,102171,1,Presencial,1.37,1,Hombre,Portal Web,4,405453,92.0,72,Soltero,38,2023,6,high,102088,Presencial,2.57,4,Hombre,Linkedin,8,1616000,80.0,69,Casado,43,2017,10,high,1.1999999999999997,3,4,1210547,-2085,1,5
102109,102123,2,Presencial,3.86,1,Mujer,Portal Web,5,998000,97.0,82,Casado,32,2019,9,high,102043,Presencial,5.5,1,Mujer,Linkedin,16,1616000,42.0,66,Soltero,51,2021,9,low,1.6400000000000001,0,11,618000,727,0,19
100735,102123,1,Presencial,1.6,3,Mujer,Portal Web,12,849030,98.0,82,Casado,37,2019,2,high,102043,Presencial,5.5,1,Mujer,Linkedin,16,1616000,42.0,66,Soltero,51,2021,9,low,3.9,-2,4,766970,959,0,14
100585,102077,1,Presencial,4.295,3,Mujer,Linkedin,4,845456,82.0,69,Soltero,36,2017,11,high,102146,Presencial,2.27,0,Hombre,Ferias & Networking,11,1306940,31.0,64,Soltero,39,2021,6,low,-2.025,-3,7,461484,1316,0,3
101837,102102,1,Presencial,2.835,1,Hombre,Linkedin,9,809260,86.0,79,Divorciado,39,2020,7,high,102018,Presencial,2.48,0,Hombre,Portal Web,5,1616000,92.0,63,Viudo,49,2019,4,high,-0.355,-1,-4,806740,-464,1,10
101029,102112,1,Presencial,1.67,0,Mujer,Linkedin,15,378245,97.0,76,Divorciado,43,2018,3,high,102031,Presencial,2.27,7,Hombre,Linkedin,1,692000,83.0,74,Soltero,26,2020,6,high,0.6000000000000001,7,-14,313755,837,0,-17
101417,102129,1,Presencial,1.005,1,Hombre,Linkedin,11,418469,89.0,63,Viudo,46,2020,2,high,102142,Presencial,2.1,2,Mujer,Linkedin,3,590000,41.0,74,Soltero,24,2020,1,low,1.0950000000000002,1,-8,171531,-34,1,-22
100806,102116,1,Presencial,4.0,0,Mujer,Referidos,14,657322,93.0,72,Divorciado,47,2019,5,high,102021,Presencial,2.32,0,Mujer,Portal Web,22,1616000,94.0,76,Casado,59,2020,7,high,-1.6800000000000002,0,8,958678,434,0,12
102064,102067,2,Presencial,1.34,0,Hombre,Portal Web,6,1616000,92.0,92,Casado,43,2018,2,high,102058,Presencial,0.92,1,Mujer,Portal Web,5,1616000,90.0,70,Divorciado,46,2020,8,high,-0.42000000000000004,1,-1,0,942,0,3
101415,102067,1,Presencial,1.47,2,Hombre,Portal Web,3,741647,91.0,66,Casado,49,2017,9,high,102058,Presencial,0.92,1,Mujer,Portal Web,5,1616000,90.0,70,Divorciado,46,2020,8,high,-0.5499999999999999,-1,2,874353,1070,0,-3
100749,102137,1,Presencial,1.86,2,Mujer,Referidos,7,734277,89.0,71,Casado,53,2021,3,high,102046,Presencial,1.18,0,Mujer,Portal Web,2,845000,37.0,79,Casado,27,2017,12,low,-0.6800000000000002,-2,-5,110723,-1172,1,-26
101946,102153,1,Presencial,3.59,2,Hombre,Portal Web,9,918753,96.0,80,Divorciado,58,2023,1,high,102143,Presencial,6.39,1,Mujer,Linkedin,5,1616000,90.0,68,Casado,41,2019,6,high,2.8,-1,-4,697247,-1301,1,-17
102029,102132,2,Presencial,5.79,2,Hombre,Portal Web,16,1616000,80.0,84,Casado,49,2017,9,high,102138,Presencial,4.51,1,Hombre,Linkedin,16,1616000,25.0,80,Viudo,45,2014,3,low,-1.2800000000000002,-1,0,0,-1284,1,-4
100257,102132,1,Presencial,5.25,8,Mujer,Linkedin,6,856924,94.0,75,Divorciado,58,2021,9,high,102138,Presencial,4.51,1,Hombre,Linkedin,16,1616000,25.0,80,Viudo,45,2014,3,low,-0.7400000000000002,-7,10,759076,-2744,1,-13
100674,102108,1,Presencial,1.63,0,Mujer,Linkedin,10,920911,84.0,67,Divorciado,58,2020,7,high,102040,Presencial,2.92,1,Mujer,Portal Web,5,1616000,46.0,75,Casado,50,2023,5,low,1.29,1,-5,695089,1030,0,-8
102101,102089,2,Presencial,6.23,0,Hombre,Portal Web,26,1616000,92.0,68,Divorciado,55,2014,1,high,102077,Presencial,2.75,1,Hombre,Ferias & Networking,6,1616000,96.0,69,Divorciado,60,2021,10,high,-3.4800000000000004,1,-20,0,2841,0,5
103623,102089,1,Presencial,1.835,1,Mujer,Linkedin,2,83936,80.0,98,Soltero,16,2019,3,high,102077,Presencial,2.75,1,Hombre,Ferias & Networking,6,1616000,96.0,69,Divorciado,60,2021,10,high,0.915,0,4,1532064,943,0,44
103223,102101,1,Presencial,1.79,2,Mujer,Ferias & Networking,2,146479,89.0,72,Casado,18,2017,8,high,102089,Presencial,6.23,0,Hombre,Portal Web,26,1616000,92.0,68,Divorciado,55,2014,1,high,4.44,-2,24,1469521,-1321,1,37
103929,102119,1,Presencial,2.095,2,Mujer,Ferias & Networking,2,182791,84.0,64,Soltero,22,2019,1,high,102107,Presencial,2.22,2,Hombre,Portal Web,12,1616000,38.0,70,Divorciado,52,2021,1,low,0.125,0,10,1433209,738,0,30
104071,102079,1,Presencial,2.44,2,Hombre,Referidos,1,185396,98.0,75,Soltero,21,2018,1,high,102146,Presencial,2.63,1,Mujer,Portal Web,4,1358450,80.0,81,Soltero,35,2016,3,high,0.18999999999999995,-1,3,1173054,-670,1,14
103387,102070,1,Presencial,4.91,2,Mujer,Linkedin,1,187433,98.0,70,Soltero,21,2016,6,high,102035,Presencial,1.7,1,Mujer,Referidos,4,1616000,77.0,73,Viudo,38,2013,3,low,-3.21,-1,3,1428567,-1184,1,17
103939,102131,1,Presencial,4.54,1,Mujer,Portal Web,4,270882,85.0,84,Casado,28,2020,10,high,102109,Presencial,5.54,0,Hombre,Linkedin,3,998000,39.0,77,Soltero,34,2021,12,low,1.0,-1,-1,727118,418,0,6
102428,102096,1,Presencial,3.955,0,Mujer,Portal Web,4,270434,81.0,76,Casado,28,2020,4,high,102116,Presencial,5.11,8,Mujer,Linkedin,13,1461470,90.0,74,Soltero,42,2021,5,high,1.1550000000000002,8,9,1191036,381,0,14
102861,102014,1,Presencial,4.13,1,Hombre,Ferias & Networking,2,290432,93.0,82,Casado,21,2012,10,high,102096,Presencial,1.78,1,Mujer,Portal Web,2,488000,98.0,78,Soltero,25,2023,1,high,-2.3499999999999996,0,0,197568,3735,0,4
103681,102047,1,Presencial,1.485,1,Mujer,Portal Web,7,304771,93.0,74,Casado,25,2015,10,high,102089,Presencial,2.67,1,Hombre,Linkedin,4,743000,14.0,70,Casado,22,2015,11,low,1.1849999999999998,0,-3,438229,32,0,-3
103822,102142,1,Presencial,6.38,2,Mujer,Portal Web,3,330753,85.0,74,Casado,32,2021,4,high,102047,Presencial,2.48,2,Hombre,Portal Web,3,1255430,90.0,66,Soltero,36,2019,7,high,-3.9,0,0,924677,-643,1,4
102589,102099,1,Presencial,7.6,2,Hombre,Linkedin,2,311489,87.0,71,Casado,28,2017,9,high,102080,Presencial,1.71,0,Hombre,Portal Web,11,1616000,76.0,80,Viudo,51,2021,10,low,-5.89,-2,9,1304511,1483,0,23
103328,102129,1,Presencial,3.505,1,Hombre,Portal Web,3,326682,86.0,75,Casado,31,2020,2,high,102142,Presencial,2.1,2,Mujer,Linkedin,3,590000,41.0,74,Soltero,24,2020,1,low,-1.4049999999999998,1,0,263318,-31,1,-7
102350,102041,1,Presencial,1.675,1,Mujer,Portal Web,2,388577,91.0,71,Soltero,28,2014,9,high,102147,Presencial,1.29,0,Mujer,Portal Web,8,1616000,44.0,73,Casado,51,2014,5,low,-0.385,-1,6,1227423,-109,1,23
102512,102097,1,Presencial,4.66,1,Hombre,Linkedin,11,428675,86.0,75,Casado,35,2019,7,high,102024,Presencial,1.95,6,Hombre,Portal Web,4,1100900,57.0,77,Soltero,31,2016,10,low,-2.71,5,-7,672225,-1000,1,-4
102685,102010,1,Presencial,1.355,1,Mujer,Portal Web,8,409018,98.0,69,Soltero,27,2012,3,high,102035,Presencial,2.02,0,Mujer,Linkedin,5,1564490,77.0,73,Casado,44,2021,8,low,0.665,-1,-3,1155472,3430,0,17
102880,102109,1,Presencial,2.545,2,Mujer,Referidos,4,466567,98.0,77,Soltero,38,2020,12,high,102123,Presencial,3.86,1,Mujer,Portal Web,5,998000,97.0,82,Casado,32,2019,9,high,1.315,-1,1,531433,-443,1,-6
103850,102077,1,Presencial,4.29,2,Mujer,Linkedin,4,850127,90.0,69,Soltero,36,2017,11,high,102146,Presencial,2.27,0,Hombre,Ferias & Networking,11,1306940,31.0,64,Soltero,39,2021,6,low,-2.02,-2,7,456813,1316,0,3
103241,102102,1,Presencial,2.825,1,Hombre,Linkedin,9,806013,95.0,79,Divorciado,39,2020,7,high,102018,Presencial,2.48,0,Hombre,Portal Web,5,1616000,92.0,63,Viudo,49,2019,4,high,-0.3450000000000002,-1,-4,809987,-465,1,10
102369,102041,1,Presencial,1.55,2,Mujer,Linkedin,6,511828,82.0,70,Divorciado,36,2015,10,high,102147,Presencial,1.29,0,Mujer,Portal Web,8,1616000,44.0,73,Casado,51,2014,5,low,-0.26,-2,2,1104172,-509,1,15
104064,102032,1,Presencial,2.535,3,Mujer,Portal Web,7,257764,94.0,79,Casado,35,2014,6,high,102065,Presencial,1.78,7,Hombre,Portal Web,14,1616000,42.0,71,Casado,42,2015,11,low,-0.7550000000000001,4,7,1358236,513,0,7
102813,102105,1,Presencial,4.615,1,Hombre,Referidos,8,311511,94.0,76,Viudo,44,2018,2,high,102113,Híbrida,2.07,0,Hombre,Linkedin,8,1616000,85.0,71,Viudo,45,2017,3,high,-2.5450000000000004,-1,0,1304489,-327,1,1
102610,102144,1,Presencial,4.785,3,Mujer,Referidos,5,660243,84.0,68,Divorciado,50,2021,9,high,102156,Presencial,2.13,8,Mujer,Portal Web,11,1616000,5.0,82,Viudo,58,2015,6,low,-2.6550000000000002,5,6,955757,-2268,1,8
103726,102112,1,Presencial,2.245,2,Mujer,Portal Web,4,695922,82.0,77,Casado,48,2018,8,high,102031,Presencial,2.27,7,Hombre,Linkedin,1,692000,83.0,74,Soltero,26,2020,6,high,0.02499999999999991,5,-3,-3922,678,0,-22
101218,102045,1,Presencial,3.02,1,Hombre,Ferias & Networking,1,99657,88.0,80,Soltero,12,2013,8,high,102171,Presencial,3.19,3,Hombre,Portal Web,11,1616000,97.0,65,Casado,53,2023,9,high,0.16999999999999993,2,10,1516343,3684,0,41
101310,102056,1,Presencial,1.79,0,Hombre,Portal Web,3,163660,81.0,83,Casado,17,2016,3,high,102014,Presencial,5.24,1,Hombre,Ferias & Networking,16,1616000,70.0,63,Viudo,65,2023,3,low,3.45,1,13,1452340,2540,0,48
101208,102069,1,Presencial,1.495,2,Mujer,Portal Web,1,163445,84.0,76,Soltero,17,2015,5,high,102069,Presencial,4.64,1,Mujer,Ferias & Networking,19,1616000,47.0,74,Casado,60,2021,10,low,3.1449999999999996,-1,18,1452555,2356,0,43
101332,102119,1,Presencial,2.09,1,Mujer,Ferias & Networking,2,183897,84.0,64,Soltero,22,2019,1,high,102107,Presencial,2.22,2,Hombre,Portal Web,12,1616000,38.0,70,Divorciado,52,2021,1,low,0.13000000000000034,1,10,1432103,738,0,30
101156,102086,1,Presencial,3.04,1,Mujer,Linkedin,5,273003,92.0,72,Soltero,27,2019,1,high,102085,Presencial,2.22,2,Mujer,Linkedin,7,1306940,87.0,68,Divorciado,39,2021,3,high,-0.8199999999999998,1,2,1033937,793,0,12
100689,102129,1,Presencial,3.495,2,Hombre,Portal Web,3,332707,95.0,75,Casado,31,2020,2,high,102142,Presencial,2.1,2,Mujer,Linkedin,3,590000,41.0,74,Soltero,24,2020,1,low,-1.395,0,0,257293,-33,1,-7
100354,102052,1,Presencial,6.06,1,Mujer,Referidos,11,453026,97.0,72,Casado,32,2015,10,high,102093,Presencial,4.45,0,Hombre,Linkedin,5,641000,84.0,76,Divorciado,17,2012,4,high,-1.6099999999999994,-1,-6,187974,-1297,1,-15
101261,102032,1,Presencial,2.54,4,Mujer,Portal Web,7,258081,82.0,79,Casado,35,2014,6,high,102065,Presencial,1.78,7,Hombre,Portal Web,14,1616000,42.0,71,Casado,42,2015,11,low,-0.76,3,7,1357919,512,0,7
101439,102121,1,Presencial,2.535,2,Mujer,Linkedin,10,433399,88.0,70,Casado,44,2022,1,high,102127,Híbrida,1.63,2,Hombre,Portal Web,4,1616000,90.0,77,Divorciado,44,2012,2,high,-0.9050000000000002,0,-6,1182601,-3606,1,0
101224,102124,1,Presencial,2.085,2,Mujer,Portal Web,6,307104,89.0,83,Casado,47,2021,2,high,102099,Presencial,2.84,2,Mujer,Linkedin,4,947000,90.0,70,Soltero,24,2012,10,high,0.7549999999999999,0,-2,639896,-3037,1,-23
100608,102047,1,Presencial,2.765,2,Mujer,Ferias & Networking,13,457527,93.0,87,Soltero,41,2014,10,high,102089,Presencial,2.67,1,Hombre,Linkedin,4,743000,14.0,70,Casado,22,2015,11,low,-0.0950000000000002,-1,-9,285473,410,0,-19
100437,102114,1,Presencial,1.755,11,Hombre,Portal Web,4,675685,83.0,86,Casado,50,2020,12,high,102050,Presencial,1.44,1,Mujer,Portal Web,5,1616000,91.0,69,Divorciado,47,2021,5,high,-0.31499999999999995,-10,1,940315,160,0,-3
103485,102057,1,Presencial,6.645,2,Mujer,Linkedin,1,97212,80.0,65,Soltero,11,2013,11,high,102019,Presencial,1.97,4,Hombre,Portal Web,5,1616000,90.0,73,Viudo,59,2022,12,high,-4.675,2,4,1518788,3322,0,48
104027,102122,1,Presencial,1.75,2,Mujer,Linkedin,1,136755,88.0,82,Soltero,19,2019,1,high,102075,Presencial,1.83,4,Hombre,Portal Web,6,1616000,90.0,66,Viudo,48,2019,3,high,0.08000000000000007,2,5,1479245,57,0,29
104149,102131,1,Presencial,2.04,1,Mujer,Linkedin,7,251902,93.0,87,Divorciado,28,2021,3,high,102109,Presencial,5.54,0,Hombre,Linkedin,3,998000,39.0,77,Soltero,34,2021,12,low,3.5,-1,-4,746098,266,0,6
102890,102042,1,Presencial,2.105,2,Hombre,Ferias & Networking,2,312907,92.0,70,Casado,25,2015,4,high,102107,Presencial,2.19,2,Hombre,Ferias & Networking,8,1616000,38.0,78,Divorciado,57,2018,6,low,0.08499999999999996,0,6,1303093,1177,0,32
103457,102073,1,Presencial,3.145,4,Hombre,Portal Web,3,348779,96.0,85,Casado,29,2016,11,high,102139,Presencial,1.98,2,Hombre,Portal Web,11,1306940,95.0,86,Soltero,37,2019,7,high,-1.165,-2,8,958161,975,0,8
103375,102122,1,Presencial,2.525,1,Mujer,Linkedin,10,488929,85.0,76,Soltero,39,2019,12,high,102075,Presencial,1.83,4,Hombre,Portal Web,6,1616000,90.0,66,Viudo,48,2019,3,high,-0.6949999999999998,3,-4,1127071,-257,1,9
103866,102121,1,Presencial,2.51,1,Mujer,Linkedin,10,437851,84.0,70,Casado,44,2022,1,high,102127,Híbrida,1.63,2,Hombre,Portal Web,4,1616000,90.0,77,Divorciado,44,2012,2,high,-0.8799999999999999,1,-6,1178149,-3608,1,0
103565,102047,1,Presencial,2.765,2,Mujer,Ferias & Networking,13,453673,93.0,87,Soltero,41,2014,10,high,102089,Presencial,2.67,1,Hombre,Linkedin,4,743000,14.0,70,Casado,22,2015,11,low,-0.0950000000000002,-1,-9,289327,412,0,-19
103197,102008,1,Presencial,3.89,1,Mujer,Portal Web,11,423949,87.0,79,Soltero,38,2012,9,high,102107,Presencial,3.99,1,Mujer,Linkedin,7,405435,90.0,82,Soltero,39,2023,1,high,0.10000000000000009,0,-4,-18514,3777,0,1
103938,102026,1,Presencial,3.93,9,Hombre,Portal Web,7,894707,88.0,79,Casado,40,2012,3,high,102101,Presencial,2.7,1,Mujer,Portal Web,15,1616000,97.0,79,Casado,58,2017,6,high,-1.23,-8,8,721293,1924,0,18
103835,102040,1,Presencial,1.49,5,Mujer,Portal Web,9,814625,81.0,58,Divorciado,46,2013,6,high,102106,Presencial,3.21,1,Hombre,Linkedin,15,1616000,91.0,84,Soltero,45,2016,7,high,1.72,-4,6,801375,1131,0,-1
103995,102153,1,Presencial,3.58,3,Hombre,Portal Web,9,913239,81.0,80,Divorciado,58,2023,1,high,102143,Presencial,6.39,1,Mujer,Linkedin,5,1616000,90.0,68,Casado,41,2019,6,high,2.8099999999999996,-2,-4,702761,-1300,1,-17
101528,102102,1,Presencial,1.455,3,Mujer,Linkedin,2,148824,96.0,77,Soltero,19,2018,1,high,102018,Presencial,2.48,0,Hombre,Portal Web,5,1616000,92.0,63,Viudo,49,2019,4,high,1.025,-3,3,1467176,459,0,30
101505,102076,1,Presencial,2.025,5,Mujer,Portal Web,7,332559,97.0,85,Soltero,27,2015,12,high,102168,Híbrida,1.95,1,Hombre,Referidos,9,1616000,95.0,82,Soltero,53,2023,9,high,-0.07499999999999996,-4,2,1283441,2830,0,26
102160,102087,2,Presencial,2.21,0,Hombre,Portal Web,3,794000,83.0,78,Casado,28,2019,8,high,102111,Presencial,7.16,9,Mujer,Linkedin,10,1616000,98.0,79,Casado,42,2012,5,high,4.95,9,7,822000,-2663,1,14
101127,102087,1,Presencial,2.99,1,Mujer,Referidos,9,784444,93.0,82,Casado,34,2016,8,high,102111,Presencial,7.16,9,Mujer,Linkedin,10,1616000,98.0,79,Casado,42,2012,5,high,4.17,8,1,831556,-1575,1,8
100974,102089,1,Presencial,1.645,5,Hombre,Portal Web,3,805397,85.0,92,Soltero,37,2018,5,high,102077,Presencial,2.75,1,Hombre,Ferias & Networking,6,1616000,96.0,69,Divorciado,60,2021,10,high,1.105,-4,3,810603,1243,0,23
101982,102073,1,Presencial,2.08,2,Mujer,Ferias & Networking,4,492094,91.0,69,Soltero,37,2018,4,high,102139,Presencial,1.98,2,Hombre,Portal Web,11,1306940,95.0,86,Soltero,37,2019,7,high,-0.10000000000000009,0,7,814846,440,0,0
101771,102092,1,Presencial,2.115,2,Hombre,Referidos,10,279513,97.0,84,Casado,42,2019,3,high,102120,Presencial,1.23,6,Mujer,Linkedin,13,1616000,98.0,95,Viudo,41,2013,6,high,-0.8850000000000002,4,3,1336487,-2094,1,-1
101220,102072,1,Presencial,5.55,5,Mujer,Portal Web,15,914778,85.0,82,Viudo,47,2017,10,high,102046,Presencial,2.61,2,Hombre,Ferias & Networking,3,947000,41.0,71,Soltero,30,2018,11,low,-2.94,-3,-12,32222,405,0,-17
102003,102130,2,Presencial,4.05,12,Hombre,Portal Web,8,1616000,83.0,82,Divorciado,49,2023,2,high,102068,Presencial,1.97,6,Hombre,Linkedin,5,1616000,84.0,73,Soltero,31,2014,4,high,-2.08,-6,-3,0,-3234,1,-18
102157,102130,2,Presencial,0.73,1,Mujer,Portal Web,6,1616000,85.0,66,Viudo,44,2015,8,high,102068,Presencial,1.97,6,Hombre,Linkedin,5,1616000,84.0,73,Soltero,31,2014,4,high,1.24,5,-1,0,-488,1,-13
103967,102130,1,Presencial,3.025,1,Mujer,Linkedin,1,83957,89.0,76,Soltero,19,2021,11,high,102068,Presencial,1.97,6,Hombre,Linkedin,5,1616000,84.0,73,Soltero,31,2014,4,high,-1.055,5,4,1532043,-2775,1,12
103022,102045,1,Presencial,3.045,1,Hombre,Ferias & Networking,1,100689,89.0,80,Soltero,12,2013,8,high,102171,Presencial,3.19,3,Hombre,Portal Web,11,1616000,97.0,65,Casado,53,2023,9,high,0.14500000000000002,2,10,1515311,3681,0,41
103364,102102,1,Presencial,1.49,3,Mujer,Linkedin,2,147472,93.0,77,Soltero,19,2018,1,high,102018,Presencial,2.48,0,Hombre,Portal Web,5,1616000,92.0,63,Viudo,49,2019,4,high,0.99,-3,3,1468528,460,0,30
102346,102086,1,Presencial,3.04,1,Mujer,Linkedin,5,268744,97.0,72,Soltero,27,2019,1,high,102085,Presencial,2.22,2,Mujer,Linkedin,7,1306940,87.0,68,Divorciado,39,2021,3,high,-0.8199999999999998,1,2,1038196,793,0,12
103417,102079,1,Presencial,1.62,3,Hombre,Portal Web,4,265668,96.0,74,Casado,27,2018,11,high,102146,Presencial,2.63,1,Mujer,Portal Web,4,1358450,80.0,81,Soltero,35,2016,3,high,1.0099999999999998,-2,0,1092782,-981,1,8
103642,102021,1,Presencial,5.13,2,Mujer,Referidos,2,267561,80.0,75,Divorciado,21,2013,6,high,102069,Presencial,2.25,1,Hombre,Linkedin,8,1616000,47.0,80,Casado,52,2017,3,low,-2.88,-1,6,1348439,1369,0,31
102556,102128,1,Presencial,1.73,3,Mujer,Ferias & Networking,5,390975,83.0,81,Casado,36,2021,7,high,102056,Presencial,4.11,10,Mujer,Portal Web,16,1616000,46.0,72,Soltero,55,2021,2,low,2.3800000000000003,7,11,1225025,-152,1,19
103100,102082,1,Presencial,1.95,2,Mujer,Linkedin,10,428595,97.0,80,Soltero,35,2018,5,high,102050,Presencial,5.5,2,Mujer,Linkedin,7,1616000,81.0,70,Casado,36,2018,8,high,3.55,0,-3,1187405,95,0,1
102790,102035,1,Presencial,4.51,0,Hombre,Portal Web,5,485543,95.0,83,Casado,33,2014,2,high,102041,Presencial,2.86,1,Hombre,Portal Web,23,1900000,83.0,72,Casado,57,2013,8,high,-1.65,1,18,1414457,-188,1,24
103231,102092,1,Presencial,2.15,1,Hombre,Referidos,10,278001,96.0,84,Casado,42,2019,3,high,102120,Presencial,1.23,6,Mujer,Linkedin,13,1616000,98.0,95,Viudo,41,2013,6,high,-0.9199999999999999,5,3,1337999,-2097,1,-1
102233,102044,1,Presencial,1.495,1,Hombre,Ferias & Networking,14,376876,92.0,80,Viudo,36,2012,10,high,102155,Presencial,1.54,1,Hombre,Ferias & Networking,14,1616000,56.0,68,Soltero,47,2023,3,low,0.04499999999999993,0,0,1239124,3798,0,11
103222,102051,1,Presencial,6.41,1,Mujer,Portal Web,4,286232,90.0,71,Casado,39,2015,6,high,102075,Híbrida,1.39,1,Hombre,Portal Web,11,1616000,83.0,76,Casado,46,2019,11,high,-5.0200000000000005,0,7,1329768,1624,0,7
103383,102069,1,Presencial,2.705,2,Hombre,Portal Web,9,682586,85.0,81,Divorciado,47,2017,10,high,102069,Presencial,4.64,1,Mujer,Ferias & Networking,19,1616000,47.0,74,Casado,60,2021,10,low,1.9349999999999996,-1,10,933414,1463,0,13
103550,102072,1,Presencial,5.51,6,Mujer,Portal Web,15,914026,91.0,82,Viudo,47,2017,10,high,102046,Presencial,2.61,2,Hombre,Ferias & Networking,3,947000,41.0,71,Soltero,30,2018,11,low,-2.9,-4,-12,32974,405,0,-17
102392,102151,1,Presencial,6.7,1,Hombre,Linkedin,6,838669,95.0,72,Soltero,56,2023,5,high,102105,Presencial,1.51,2,Hombre,Ferias & Networking,10,1616000,85.0,80,Divorciado,45,2021,11,high,-5.19,1,4,777331,-544,1,-11
104093,102086,1,Presencial,1.27,3,Hombre,Portal Web,14,893905,84.0,73,Divorciado,52,2019,4,high,102085,Presencial,2.22,2,Mujer,Linkedin,7,1306940,87.0,68,Divorciado,39,2021,3,high,0.9500000000000002,-1,-7,413035,694,0,-13
102435,102069,1,Presencial,2.095,2,Mujer,Portal Web,13,899570,85.0,81,Divorciado,48,2014,12,high,102069,Presencial,4.64,1,Mujer,Ferias & Networking,19,1616000,47.0,74,Casado,60,2021,10,low,2.5449999999999995,-1,6,716430,2515,0,12
100751,102147,1,Presencial,3.575,2,Mujer,Portal Web,2,118206,92.0,75,Soltero,20,2021,12,high,102057,Presencial,1.58,2,Hombre,Portal Web,4,1616000,90.0,80,Casado,49,2022,12,high,-1.995,0,2,1497794,374,0,29
101693,102108,1,Presencial,2.75,7,Mujer,Portal Web,4,183660,84.0,80,Soltero,21,2018,5,high,102040,Presencial,2.92,1,Mujer,Portal Web,5,1616000,46.0,75,Casado,50,2023,5,low,0.16999999999999993,-6,1,1432340,1826,0,29
100212,102068,1,Presencial,2.01,0,Hombre,Linkedin,4,245098,90.0,77,Soltero,21,2014,8,high,102043,Híbrida,2.17,3,Mujer,Referidos,4,896000,41.0,81,Soltero,23,2012,8,low,0.16000000000000014,3,0,650902,-730,1,2
101131,102021,1,Presencial,5.125,2,Mujer,Portal Web,2,273683,83.0,75,Divorciado,22,2013,6,high,102069,Presencial,2.25,1,Hombre,Linkedin,8,1616000,47.0,80,Casado,52,2017,3,low,-2.875,-1,6,1342317,1369,0,30
101153,102131,1,Presencial,4.43,10,Mujer,Linkedin,4,330181,90.0,78,Soltero,33,2021,10,high,102109,Presencial,5.54,0,Hombre,Linkedin,3,998000,39.0,77,Soltero,34,2021,12,low,1.1100000000000003,-10,-1,667819,53,0,1
100666,102123,1,Presencial,6.56,3,Hombre,Referidos,5,408928,84.0,81,Soltero,36,2021,9,high,102043,Presencial,5.5,1,Mujer,Linkedin,16,1616000,42.0,66,Soltero,51,2021,9,low,-1.0599999999999996,-2,11,1207072,8,0,15
101465,102103,1,Presencial,1.625,1,Mujer,Linkedin,5,844532,87.0,76,Casado,37,2019,9,high,102023,Presencial,1.69,6,Hombre,Portal Web,3,1616000,90.0,74,Casado,45,2013,5,high,0.06499999999999995,5,-2,771468,-2308,1,8
100964,102101,1,Presencial,2.985,2,Hombre,Ferias & Networking,10,659526,96.0,68,Viudo,47,2018,8,high,102089,Presencial,6.23,0,Hombre,Portal Web,26,1616000,92.0,68,Divorciado,55,2014,1,high,3.2450000000000006,-2,16,956474,-1693,1,8
100012,102099,1,Presencial,4.985,2,Mujer,Ferias & Networking,13,733778,92.0,70,Viudo,52,2019,9,high,102080,Presencial,1.71,0,Hombre,Portal Web,11,1616000,76.0,80,Viudo,51,2021,10,low,-3.2750000000000004,-2,-2,882222,750,0,-1
103613,102120,1,Presencial,0.915,2,Hombre,Ferias & Networking,5,345607,87.0,71,Soltero,33,2021,2,high,102171,Presencial,6.48,2,Hombre,Ferias & Networking,9,1616000,80.0,71,Casado,47,2023,8,high,5.565,0,4,1270393,918,0,14
102635,102083,1,Presencial,1.31,2,Mujer,Referidos,10,386575,92.0,67,Casado,32,2018,5,high,102147,Presencial,1.61,0,Mujer,Portal Web,5,1564490,83.0,71,Soltero,44,2021,2,high,0.30000000000000004,-2,-5,1177915,1009,0,12
103562,102123,1,Presencial,6.555,2,Hombre,Referidos,5,413312,81.0,81,Soltero,36,2021,9,high,102043,Presencial,5.5,1,Mujer,Linkedin,16,1616000,42.0,66,Soltero,51,2021,9,low,-1.0549999999999997,-1,11,1202688,8,0,15
103134,102103,1,Presencial,1.655,1,Mujer,Linkedin,5,846640,97.0,76,Casado,37,2019,9,high,102023,Presencial,1.69,6,Hombre,Portal Web,3,1616000,90.0,74,Casado,45,2013,5,high,0.03499999999999992,5,-2,769360,-2309,1,8
102511,102131,1,Presencial,2.53,1,Hombre,Linkedin,10,258477,92.0,78,Casado,41,2020,2,high,102109,Presencial,5.54,0,Hombre,Linkedin,3,998000,39.0,77,Soltero,34,2021,12,low,3.0100000000000002,-1,-7,739523,675,0,-7
103309,102110,1,Presencial,2.415,1,Hombre,Ferias & Networking,7,289877,81.0,76,Casado,44,2020,1,high,102045,Presencial,1.6,5,Mujer,Linkedin,2,998000,87.0,76,Soltero,29,2016,11,high,-0.815,4,-5,708123,-1144,1,-15
102594,102113,1,Presencial,5.155,5,Hombre,Linkedin,12,862087,87.0,80,Casado,52,2021,1,high,102041,Presencial,2.96,2,Hombre,Portal Web,6,1152410,46.0,75,Casado,27,2012,1,low,-2.1950000000000003,-3,-6,290323,-3288,1,-25
103414,102083,1,Presencial,1.91,3,Hombre,Portal Web,13,777291,91.0,78,Casado,50,2019,3,high,102147,Presencial,1.61,0,Mujer,Portal Web,5,1564490,83.0,71,Soltero,44,2021,2,high,-0.2999999999999998,-3,-8,787199,721,0,-6
103786,102172,1,Presencial,2.43,2,Mujer,Portal Web,9,856103,95.0,74,Casado,55,2023,2,high,102020,Presencial,5.58,1,Hombre,Portal Web,7,1049000,57.0,70,Casado,29,2016,4,low,3.15,-1,-2,192897,-2502,1,-26
103115,102099,1,Presencial,4.945,1,Mujer,Ferias & Networking,13,736348,98.0,70,Viudo,52,2019,9,high,102080,Presencial,1.71,0,Hombre,Portal Web,11,1616000,76.0,80,Viudo,51,2021,10,low,-3.2350000000000003,-1,-2,879652,747,0,-1
101269,102138,1,Presencial,2.525,1,Mujer,Ferias & Networking,1,76490,81.0,81,Soltero,18,2021,6,high,102059,Presencial,3.26,1,Hombre,Linkedin,5,1616000,57.0,75,Soltero,44,2018,4,low,0.7349999999999999,0,4,1539510,-1177,1,26
100479,102050,1,Presencial,7.215,1,Hombre,Portal Web,2,122530,83.0,76,Soltero,12,2013,6,high,102069,Presencial,3.7,0,Mujer,Linkedin,11,1512980,90.0,88,Soltero,40,2017,10,high,-3.5149999999999997,-1,9,1390450,1577,0,28
100611,102035,1,Presencial,2.94,2,Mujer,Ferias & Networking,1,166899,84.0,77,Soltero,17,2014,6,high,102041,Presencial,2.86,1,Hombre,Portal Web,23,1900000,83.0,72,Casado,57,2013,8,high,-0.08000000000000007,-1,22,1733101,-313,1,40
100077,102134,1,Presencial,1.47,3,Hombre,Portal Web,5,227370,86.0,79,Soltero,28,2021,7,high,102135,Presencial,2.25,2,Hombre,Portal Web,5,1358450,90.0,69,Viudo,31,2012,7,high,0.78,-1,0,1131080,-3298,1,3
101191,102070,1,Presencial,2.05,7,Hombre,Portal Web,4,292841,85.0,76,Casado,27,2017,9,high,102035,Presencial,1.7,1,Mujer,Referidos,4,1616000,77.0,73,Viudo,38,2013,3,low,-0.34999999999999987,-6,0,1323159,-1659,1,11
101548,102017,1,Presencial,4.825,3,Mujer,Referidos,11,258060,94.0,84,Casado,34,2013,9,high,102035,Presencial,4.62,0,Mujer,Linkedin,2,641000,90.0,84,Casado,25,2019,11,high,-0.20500000000000007,-3,-9,382940,2248,0,-9
100475,102101,1,Presencial,1.07,0,Hombre,Linkedin,10,677210,83.0,80,Divorciado,48,2019,6,high,102089,Presencial,6.23,0,Hombre,Portal Web,26,1616000,92.0,68,Divorciado,55,2014,1,high,5.16,0,16,938790,-1994,1,7
101792,102073,1,Presencial,3.065,1,Mujer,Referidos,4,840074,80.0,72,Casado,46,2014,12,high,102139,Presencial,1.98,2,Hombre,Portal Web,11,1306940,95.0,86,Soltero,37,2019,7,high,-1.085,1,7,466866,1677,0,-9
100182,102050,1,Presencial,3.76,3,Hombre,Linkedin,11,758170,88.0,70,Casado,46,2014,1,high,102069,Presencial,3.7,0,Mujer,Linkedin,11,1512980,90.0,88,Soltero,40,2017,10,high,-0.05999999999999961,-3,0,754810,1376,0,-6
104148,102117,1,Presencial,3.54,2,Hombre,Portal Web,3,123591,86.0,69,Soltero,21,2021,12,high,102154,Presencial,4.05,1,Mujer,Linkedin,10,1616000,90.0,80,Divorciado,48,2021,1,high,0.5099999999999998,-1,7,1492409,-311,1,27
103733,102050,1,Presencial,7.245,2,Hombre,Portal Web,2,115618,82.0,76,Soltero,12,2013,6,high,102069,Presencial,3.7,0,Mujer,Linkedin,11,1512980,90.0,88,Soltero,40,2017,10,high,-3.545,-2,9,1397362,1578,0,28
103593,102030,1,Presencial,0.14,6,Hombre,Linkedin,2,138784,85.0,72,Soltero,15,2014,10,high,102058,Presencial,6.34,0,Mujer,Referidos,14,1616000,90.0,76,Viudo,41,2015,4,high,6.2,-6,12,1477216,185,0,26
103684,102150,1,Presencial,4.17,8,Hombre,Portal Web,1,229142,93.0,82,Soltero,27,2021,8,high,102085,Presencial,3.9,8,Mujer,Portal Web,10,1358450,85.0,75,Casado,32,2012,12,high,-0.27,0,9,1129308,-3175,1,5
102704,102081,1,Presencial,4.77,2,Hombre,Linkedin,8,768565,90.0,84,Casado,32,2018,2,high,102135,Presencial,2.5,2,Hombre,Portal Web,4,488000,26.0,64,Soltero,18,2015,8,low,-2.2699999999999996,0,-4,-280565,-894,1,-14
102558,102072,1,Presencial,3.33,2,Hombre,Referidos,9,257745,90.0,76,Soltero,38,2016,12,high,102046,Presencial,2.61,2,Hombre,Ferias & Networking,3,947000,41.0,71,Soltero,30,2018,11,low,-0.7200000000000002,0,-6,689255,709,0,-8
102563,102085,1,Presencial,3.995,2,Hombre,Portal Web,10,276075,83.0,70,Soltero,40,2016,12,high,102145,Presencial,6.59,4,Hombre,Portal Web,12,1616000,47.0,71,Casado,39,2015,8,low,2.5949999999999998,2,2,1339925,-492,1,-1
103812,102127,1,Presencial,3.76,2,Mujer,Ferias & Networking,16,637957,86.0,72,Viudo,48,2021,5,high,102028,Presencial,4.03,2,Mujer,Linkedin,9,1306940,88.0,78,Divorciado,32,2014,5,high,0.27000000000000046,0,-7,668983,-2546,1,-16
103448,102052,1,Presencial,4.85,2,Mujer,Portal Web,3,913218,97.0,77,Viudo,48,2013,2,high,102093,Presencial,4.45,0,Hombre,Linkedin,5,641000,84.0,76,Divorciado,17,2012,4,high,-0.39999999999999947,-2,2,-272218,-329,1,-31
100469,102159,1,Presencial,3.25,0,Hombre,Ferias & Networking,2,137456,88.0,79,Soltero,22,2022,4,high,102120,Híbrida,0.98,2,Hombre,Referidos,14,808000,90.0,86,Soltero,44,2022,8,high,-2.27,2,12,670544,119,0,22
100390,102043,1,Presencial,2.455,1,Mujer,Portal Web,1,135882,88.0,85,Divorciado,14,2014,8,high,102051,Presencial,1.03,0,Hombre,Portal Web,5,1616000,60.0,76,Casado,44,2019,5,low,-1.425,-1,4,1480118,1733,0,30
101064,102154,1,Presencial,3.095,2,Mujer,Referidos,2,203590,94.0,76,Casado,27,2022,6,high,102172,Presencial,5.45,1,Hombre,Portal Web,7,1512980,93.0,69,Soltero,39,2017,10,high,2.355,-1,5,1309390,-1707,1,12
100465,102144,1,Presencial,2.71,3,Hombre,Referidos,7,372493,98.0,75,Soltero,35,2022,4,high,102156,Presencial,2.13,8,Mujer,Portal Web,11,1616000,5.0,82,Viudo,58,2015,6,low,-0.5800000000000001,5,4,1243507,-2490,1,23
100612,102053,1,Presencial,2.36,0,Mujer,Referidos,4,401739,98.0,79,Casado,40,2014,8,high,102030,Presencial,1.29,0,Hombre,Portal Web,11,1616000,81.0,64,Soltero,36,2012,12,high,-1.0699999999999998,0,7,1214261,-597,1,-4
102033,102172,2,Presencial,6.25,2,Mujer,Portal Web,16,1616000,90.0,79,Divorciado,39,2014,5,high,102020,Presencial,5.58,1,Hombre,Portal Web,7,1049000,57.0,70,Casado,29,2016,4,low,-0.6699999999999999,-1,-9,-567000,715,0,-10
100192,102172,1,Presencial,2.645,3,Mujer,Ferias & Networking,4,700499,90.0,79,Viudo,53,2023,6,high,102020,Presencial,5.58,1,Hombre,Portal Web,7,1049000,57.0,70,Casado,29,2016,4,low,2.935,-2,3,348501,-2608,1,-24
102092,102120,2,Presencial,1.23,6,Mujer,Linkedin,13,1616000,98.0,95,Viudo,41,2013,6,high,102171,Presencial,6.48,2,Hombre,Ferias & Networking,9,1616000,80.0,71,Casado,47,2023,8,high,5.25,-4,-4,0,3706,0,6
101189,102120,1,Presencial,2.055,0,Hombre,Portal Web,13,893481,90.0,70,Casado,54,2020,10,high,102171,Presencial,6.48,2,Hombre,Ferias & Networking,9,1616000,80.0,71,Casado,47,2023,8,high,4.425000000000001,2,-4,722519,1031,0,-7
102080,102035,2,Presencial,1.93,0,Mujer,Linkedin,18,1616000,94.0,75,Viudo,47,2016,8,high,102041,Presencial,2.86,1,Hombre,Portal Web,23,1900000,83.0,72,Casado,57,2013,8,high,0.9299999999999999,1,5,284000,-1106,1,10
103444,102035,1,Presencial,2.93,3,Mujer,Ferias & Networking,1,168343,87.0,77,Soltero,16,2014,6,high,102041,Presencial,2.86,1,Hombre,Portal Web,23,1900000,83.0,72,Casado,57,2013,8,high,-0.07000000000000028,-2,22,1731657,-312,1,41
102920,102009,1,Presencial,3.77,1,Hombre,Portal Web,3,188884,86.0,82,Soltero,16,2013,1,high,102116,Presencial,2.06,2,Hombre,Referidos,9,1461470,90.0,73,Casado,44,2022,8,high,-1.71,1,6,1272586,3502,0,28
103489,102010,1,Presencial,2.04,0,Hombre,Portal Web,2,291831,84.0,79,Soltero,22,2013,2,high,102035,Presencial,2.02,0,Mujer,Linkedin,5,1564490,77.0,73,Casado,44,2021,8,low,-0.020000000000000018,0,3,1272659,3096,0,22
102530,102171,1,Presencial,1.985,0,Hombre,Linkedin,6,365673,97.0,77,Casado,36,2023,1,high,102088,Presencial,2.57,4,Hombre,Linkedin,8,1616000,80.0,69,Casado,43,2017,10,high,0.5849999999999997,4,2,1250327,-1932,1,7
102799,102039,1,Presencial,5.09,7,Hombre,Portal Web,2,390073,87.0,79,Casado,29,2014,6,high,102054,Presencial,3.66,0,Hombre,Referidos,5,1616000,93.0,75,Viudo,49,2018,6,high,-1.4299999999999997,-7,3,1225927,1450,0,20
103144,102113,1,Presencial,2.35,1,Mujer,Referidos,8,446206,94.0,86,Casado,35,2018,6,high,102041,Presencial,2.96,2,Hombre,Portal Web,6,1152410,46.0,75,Casado,27,2012,1,low,0.6099999999999999,1,-2,706204,-2349,1,-8
103122,102070,1,Presencial,4.115,1,Hombre,Ferias & Networking,5,451897,91.0,80,Soltero,32,2015,4,high,102035,Presencial,1.7,1,Mujer,Referidos,4,1616000,77.0,73,Viudo,38,2013,3,low,-2.415,0,-1,1164103,-769,1,6
103806,102077,1,Presencial,1.925,1,Hombre,Portal Web,4,471789,85.0,79,Soltero,34,2016,9,high,102146,Presencial,2.27,0,Hombre,Ferias & Networking,11,1306940,31.0,64,Soltero,39,2021,6,low,0.345,-1,7,835151,1746,0,5
102640,102017,1,Presencial,4.835,2,Mujer,Referidos,11,259263,82.0,84,Casado,34,2013,9,high,102035,Presencial,4.62,0,Mujer,Linkedin,2,641000,90.0,84,Casado,25,2019,11,high,-0.21499999999999986,-2,-9,381737,2250,0,-9
104146,102079,1,Presencial,3.14,2,Hombre,Linkedin,9,288681,89.0,71,Casado,42,2018,7,high,102146,Presencial,2.63,1,Mujer,Portal Web,4,1358450,80.0,81,Soltero,35,2016,3,high,-0.5100000000000002,-1,-5,1069769,-855,1,-7
104095,102063,1,Presencial,2.175,2,Hombre,Ferias & Networking,9,453922,98.0,73,Viudo,41,2016,4,high,102135,Presencial,2.73,0,Mujer,Linkedin,1,539000,26.0,75,Soltero,24,2021,4,low,0.5550000000000002,-2,-8,85078,1822,0,-17
103777,102033,1,Presencial,2.0,12,Hombre,Portal Web,15,641285,91.0,75,Casado,40,2013,10,high,102172,Presencial,6.25,2,Mujer,Portal Web,16,1616000,90.0,79,Divorciado,39,2014,5,high,4.25,-10,1,974715,205,0,-1
103082,102099,1,Presencial,2.655,3,Mujer,Linkedin,6,718904,95.0,75,Soltero,49,2019,1,high,102080,Presencial,1.71,0,Hombre,Portal Web,11,1616000,76.0,80,Viudo,51,2021,10,low,-0.9449999999999998,-3,5,897096,983,0,2
102544,102073,1,Presencial,3.04,0,Mujer,Referidos,4,839740,88.0,72,Casado,46,2014,12,high,102139,Presencial,1.98,2,Hombre,Portal Web,11,1306940,95.0,86,Soltero,37,2019,7,high,-1.06,2,7,467200,1678,0,-9
101964,102061,1,Presencial,1.42,1,Mujer,Portal Web,1,77350,88.0,81,Soltero,12,2014,12,high,102115,Presencial,2.14,2,Hombre,Ferias & Networking,10,1203920,37.0,80,Casado,29,2012,11,low,0.7200000000000002,1,9,1126570,-778,1,17
100240,102044,1,Presencial,3.92,2,Mujer,Portal Web,4,164678,90.0,74,Soltero,17,2014,9,high,102155,Presencial,1.54,1,Hombre,Ferias & Networking,14,1616000,56.0,68,Soltero,47,2023,3,low,-2.38,-1,10,1451322,3106,0,30
101931,102069,1,Presencial,6.9,0,Hombre,Portal Web,5,253489,96.0,81,Casado,25,2017,8,high,102069,Presencial,4.64,1,Mujer,Ferias & Networking,19,1616000,47.0,74,Casado,60,2021,10,low,-2.2600000000000007,1,14,1362511,1519,0,35
100599,102136,1,Presencial,1.595,3,Mujer,Referidos,4,273246,93.0,78,Casado,30,2022,4,high,102034,Presencial,1.78,2,Hombre,Portal Web,3,1616000,89.0,78,Casado,35,2013,1,high,0.18500000000000005,-1,-1,1342754,-3377,1,5
101710,102089,1,Presencial,1.655,3,Hombre,Ferias & Networking,6,326801,98.0,68,Casado,29,2018,6,high,102077,Presencial,2.75,1,Hombre,Ferias & Networking,6,1616000,96.0,69,Divorciado,60,2021,10,high,1.095,-2,0,1289199,1214,0,31
101322,102077,1,Presencial,1.915,2,Hombre,Portal Web,4,466618,86.0,79,Soltero,34,2016,9,high,102146,Presencial,2.27,0,Hombre,Ferias & Networking,11,1306940,31.0,64,Soltero,39,2021,6,low,0.355,-2,7,840322,1744,0,5
100292,102042,1,Presencial,1.6,1,Hombre,Referidos,5,469179,85.0,78,Casado,32,2014,3,high,102107,Presencial,2.19,2,Hombre,Ferias & Networking,8,1616000,38.0,78,Divorciado,57,2018,6,low,0.5899999999999999,1,3,1146821,1569,0,25
101342,102029,1,Presencial,3.845,1,Hombre,Linkedin,4,490162,83.0,77,Casado,33,2013,8,high,102132,Presencial,5.79,2,Hombre,Portal Web,16,1616000,80.0,84,Casado,49,2017,9,high,1.9449999999999998,1,12,1125838,1504,0,16
100681,102039,1,Presencial,4.655,2,Hombre,Referidos,3,270076,87.0,70,Casado,37,2014,11,high,102054,Presencial,3.66,0,Hombre,Referidos,5,1616000,93.0,75,Viudo,49,2018,6,high,-0.9950000000000001,-2,2,1345924,1313,0,12
101959,102079,1,Presencial,3.19,3,Hombre,Linkedin,9,284693,86.0,71,Casado,42,2018,7,high,102146,Presencial,2.63,1,Mujer,Portal Web,4,1358450,80.0,81,Soltero,35,2016,3,high,-0.56,-2,-5,1073757,-857,1,-7
101778,102099,1,Presencial,2.635,12,Mujer,Portal Web,9,299035,98.0,70,Soltero,45,2020,2,high,102080,Presencial,1.71,0,Hombre,Portal Web,11,1616000,76.0,80,Viudo,51,2021,10,low,-0.9249999999999998,-12,2,1316965,589,0,6
100715,102115,1,Presencial,1.34,2,Hombre,Portal Web,15,455724,92.0,77,Viudo,45,2020,1,high,102116,Presencial,2.0,2,Mujer,Portal Web,4,1616000,94.0,76,Soltero,35,2018,12,high,0.6599999999999999,0,-11,1160276,-391,1,-10
100783,102092,1,Presencial,1.815,7,Hombre,Portal Web,8,298529,80.0,85,Casado,43,2018,5,high,102120,Presencial,1.23,6,Mujer,Linkedin,13,1616000,98.0,95,Viudo,41,2013,6,high,-0.585,-1,5,1317471,-1775,1,-2
100928,102075,1,Presencial,4.91,1,Mujer,Portal Web,12,636682,98.0,79,Casado,43,2016,7,high,102047,Presencial,2.7,1,Hombre,Referidos,11,1255430,90.0,76,Casado,30,2013,3,high,-2.21,0,-1,618748,-1218,1,-13
101356,102016,1,Presencial,1.57,3,Mujer,Ferias & Networking,11,879451,92.0,79,Viudo,41,2013,7,high,102008,Híbrida,2.51,2,Mujer,Portal Web,6,1616000,40.0,80,Casado,44,2017,8,low,0.9399999999999997,-1,-5,736549,1515,0,3
101027,102008,1,Presencial,3.89,3,Hombre,Portal Web,14,861045,85.0,70,Casado,41,2012,3,high,102107,Presencial,3.99,1,Mujer,Linkedin,7,405435,90.0,82,Soltero,39,2023,1,high,0.10000000000000009,-2,-7,-455610,3949,0,-2
102087,102111,2,Presencial,7.16,9,Mujer,Linkedin,10,1616000,98.0,79,Casado,42,2012,5,high,102097,Híbrida,2.04,1,Mujer,Referidos,15,1616000,94.0,67,Soltero,50,2021,5,high,-5.12,-8,5,0,3296,0,8
100009,102111,1,Presencial,1.39,1,Mujer,Portal Web,13,917750,97.0,77,Soltero,55,2021,2,high,102097,Híbrida,2.04,1,Mujer,Referidos,15,1616000,94.0,67,Soltero,50,2021,5,high,0.6500000000000001,0,2,698250,87,0,-5
102060,102041,2,Presencial,4.42,3,Hombre,Referidos,16,1616000,82.0,62,Casado,45,2013,10,high,102147,Presencial,1.29,0,Mujer,Portal Web,8,1616000,44.0,73,Casado,51,2014,5,low,-3.13,-3,-8,0,202,0,6
102814,102041,1,Presencial,2.74,1,Hombre,Referidos,1,103723,89.0,75,Soltero,11,2012,11,high,102147,Presencial,1.29,0,Mujer,Portal Web,8,1616000,44.0,73,Casado,51,2014,5,low,-1.4500000000000002,-1,7,1512277,541,0,40
103305,102060,1,Presencial,2.04,1,Mujer,Portal Web,2,203154,89.0,90,Casado,21,2016,12,high,102041,Presencial,4.42,3,Hombre,Referidos,16,1616000,82.0,62,Casado,45,2013,10,high,2.38,2,14,1412846,-1158,1,24
102711,102098,1,Presencial,5.145,1,Mujer,Portal Web,7,365463,80.0,72,Soltero,33,2020,5,high,102049,Presencial,1.8,1,Mujer,Portal Web,16,1616000,90.0,86,Casado,46,2021,1,high,-3.3449999999999998,0,9,1250537,273,0,13
102631,102154,1,Presencial,1.445,1,Hombre,Portal Web,10,407992,92.0,70,Casado,37,2022,5,high,102172,Presencial,5.45,1,Hombre,Portal Web,7,1512980,93.0,69,Soltero,39,2017,10,high,4.005,0,-3,1104988,-1686,1,2
102634,102046,1,Presencial,4.815,2,Mujer,Portal Web,8,448194,88.0,76,Casado,30,2013,2,high,102007,Presencial,1.68,0,Mujer,Portal Web,8,1616000,41.0,71,Soltero,50,2015,10,low,-3.1350000000000007,-2,0,1167806,976,0,20
102255,102042,1,Presencial,1.58,1,Hombre,Referidos,5,469752,81.0,78,Casado,32,2014,3,high,102107,Presencial,2.19,2,Hombre,Ferias & Networking,8,1616000,38.0,78,Divorciado,57,2018,6,low,0.6099999999999999,1,3,1146248,1569,0,25
103975,102088,1,Presencial,3.185,1,Hombre,Portal Web,7,443778,80.0,71,Soltero,37,2016,10,high,102139,Presencial,4.96,1,Mujer,Portal Web,3,488000,82.0,65,Soltero,20,2018,4,high,1.775,0,-4,44222,537,0,-17
102440,102032,1,Presencial,1.43,0,Hombre,Portal Web,3,507572,80.0,74,Casado,35,2014,9,high,102065,Presencial,1.78,7,Hombre,Portal Web,14,1616000,42.0,71,Casado,42,2015,11,low,0.3500000000000001,7,11,1108428,430,0,7
103577,102069,1,Presencial,2.24,4,Hombre,Portal Web,8,268667,95.0,76,Casado,39,2016,11,high,102069,Presencial,4.64,1,Mujer,Ferias & Networking,19,1616000,47.0,74,Casado,60,2021,10,low,2.3999999999999995,-3,11,1347333,1816,0,21
102629,102065,1,Presencial,7.07,1,Mujer,Ferias & Networking,10,271281,82.0,76,Soltero,37,2014,12,high,102026,Presencial,2.44,2,Hombre,Ferias & Networking,13,1616000,45.0,60,Divorciado,35,2014,10,low,-4.630000000000001,1,3,1344719,-79,1,-2
102723,102093,1,Presencial,2.315,6,Mujer,Portal Web,13,461896,82.0,74,Viudo,42,2018,1,high,102139,Presencial,5.41,0,Mujer,Ferias & Networking,4,488000,89.0,62,Soltero,23,2021,6,high,3.095,-6,-9,26104,1247,0,-19
102918,102172,1,Presencial,2.945,0,Hombre,Portal Web,7,389853,82.0,75,Divorciado,48,2023,5,high,102020,Presencial,5.58,1,Hombre,Portal Web,7,1049000,57.0,70,Casado,29,2016,4,low,2.6350000000000002,1,0,659147,-2593,1,-19
103725,102115,1,Presencial,1.325,2,Hombre,Portal Web,15,457299,94.0,77,Viudo,45,2020,1,high,102116,Presencial,2.0,2,Mujer,Portal Web,4,1616000,94.0,76,Soltero,35,2018,12,high,0.675,0,-11,1158701,-393,1,-10
103601,102092,1,Presencial,1.85,7,Hombre,Portal Web,8,298957,91.0,85,Casado,43,2018,5,high,102120,Presencial,1.23,6,Mujer,Linkedin,13,1616000,98.0,95,Viudo,41,2013,6,high,-0.6200000000000001,-1,5,1317043,-1775,1,-2
102808,102053,1,Presencial,2.385,1,Mujer,Referidos,4,396418,85.0,79,Casado,41,2014,8,high,102030,Presencial,1.29,0,Hombre,Portal Web,11,1616000,81.0,64,Soltero,36,2012,12,high,-1.0949999999999998,-1,7,1219582,-596,1,-5
102839,102122,1,Presencial,1.62,4,Hombre,Referidos,8,654339,97.0,79,Casado,47,2019,3,high,102075,Presencial,1.83,4,Hombre,Portal Web,6,1616000,90.0,66,Viudo,48,2019,3,high,0.20999999999999996,0,-2,961661,3,0,1
102211,102016,1,Presencial,1.585,3,Mujer,Ferias & Networking,11,881899,97.0,79,Viudo,41,2013,7,high,102008,Híbrida,2.51,2,Mujer,Portal Web,6,1616000,40.0,80,Casado,44,2017,8,low,0.9249999999999998,-1,-5,734101,1514,0,3
103795,102065,1,Presencial,1.995,2,Mujer,Portal Web,9,879821,89.0,78,Viudo,49,2017,6,high,102026,Presencial,2.44,2,Hombre,Ferias & Networking,13,1616000,45.0,60,Divorciado,35,2014,10,low,0.44499999999999984,0,4,736179,-970,1,-14
102309,102120,1,Presencial,2.065,0,Hombre,Portal Web,13,893347,96.0,70,Casado,54,2020,10,high,102171,Presencial,6.48,2,Hombre,Ferias & Networking,9,1616000,80.0,71,Casado,47,2023,8,high,4.415000000000001,2,-4,722653,1030,0,-7
100855,102007,1,Presencial,4.625,2,Mujer,Linkedin,2,95604,91.0,72,Soltero,10,2012,4,high,102070,Presencial,5.11,2,Mujer,Portal Web,6,1358450,96.0,62,Soltero,41,2022,4,high,0.4850000000000003,0,4,1262846,3656,0,31
101955,102015,1,Presencial,4.33,9,Mujer,Portal Web,2,251801,80.0,77,Casado,20,2013,2,high,102121,Presencial,6.18,1,Mujer,Referidos,10,1358450,74.0,82,Soltero,33,2014,6,low,1.8499999999999996,-8,8,1106649,501,0,13
101426,102133,1,Presencial,2.705,9,Mujer,Linkedin,7,288710,94.0,76,Soltero,31,2022,4,high,102151,Híbrida,2.61,2,Hombre,Linkedin,4,1255430,98.0,65,Soltero,35,2018,2,high,-0.0950000000000002,-7,-3,966720,-1509,1,4
100235,102110,1,Presencial,3.64,5,Mujer,Portal Web,5,365409,85.0,76,Casado,31,2018,1,high,102045,Presencial,1.6,5,Mujer,Linkedin,2,998000,87.0,76,Soltero,29,2016,11,high,-2.04,0,-3,632591,-412,1,-2
101432,102089,1,Presencial,1.71,2,Mujer,Portal Web,3,411351,84.0,76,Casado,32,2017,7,high,102077,Presencial,2.75,1,Hombre,Ferias & Networking,6,1616000,96.0,69,Divorciado,60,2021,10,high,1.04,-1,3,1204649,1547,0,28
100592,102065,1,Presencial,7.105,1,Mujer,Ferias & Networking,10,271937,94.0,76,Soltero,37,2014,12,high,102026,Presencial,2.44,2,Hombre,Ferias & Networking,13,1616000,45.0,60,Divorciado,35,2014,10,low,-4.665000000000001,1,3,1344063,-82,1,-2
101849,102131,1,Presencial,1.61,2,Hombre,Linkedin,13,290277,92.0,80,Soltero,47,2022,10,high,102109,Presencial,5.54,0,Hombre,Linkedin,3,998000,39.0,77,Soltero,34,2021,12,low,3.9299999999999997,-2,-10,707723,-304,1,-13
101176,102144,1,Presencial,4.5,7,Hombre,Linkedin,10,284287,90.0,85,Soltero,47,2022,8,high,102156,Presencial,2.13,8,Mujer,Portal Web,11,1616000,5.0,82,Viudo,58,2015,6,low,-2.37,1,1,1331713,-2616,1,11
100237,102101,1,Presencial,2.36,10,Mujer,Linkedin,14,409842,88.0,78,Soltero,43,2018,7,high,102089,Presencial,6.23,0,Hombre,Portal Web,26,1616000,92.0,68,Divorciado,55,2014,1,high,3.8700000000000006,-10,12,1206158,-1643,1,12
101050,102058,1,Presencial,0.535,1,Mujer,Portal Web,8,439318,94.0,71,Soltero,42,2016,10,high,102172,Presencial,1.4,2,Hombre,Ferias & Networking,11,1616000,75.0,71,Casado,59,2021,2,low,0.8649999999999999,1,3,1176682,1582,0,17
101852,102054,1,Presencial,2.885,2,Mujer,Portal Web,8,702302,89.0,78,Viudo,46,2016,4,high,102044,Presencial,2.91,1,Hombre,Linkedin,17,1616000,85.0,74,Divorciado,41,2012,11,high,0.025000000000000355,-1,9,913698,-1266,1,-5
101759,102146,1,Presencial,2.19,1,Mujer,Portal Web,13,715178,86.0,71,Casado,52,2021,9,high,102035,Presencial,2.66,0,Mujer,Portal Web,15,1616000,77.0,78,Casado,39,2013,10,low,0.4700000000000002,-1,2,900822,-2887,1,-13
101878,102053,1,Presencial,3.335,4,Hombre,Portal Web,10,741986,86.0,76,Divorciado,45,2013,7,high,102030,Presencial,1.29,0,Hombre,Portal Web,11,1616000,81.0,64,Soltero,36,2012,12,high,-2.045,-4,1,874014,-209,1,-9
101706,102009,1,Presencial,2.015,0,Mujer,Referidos,8,878877,89.0,79,Casado,48,2012,7,high,102116,Presencial,2.06,2,Hombre,Referidos,9,1461470,90.0,73,Casado,44,2022,8,high,0.04499999999999993,2,1,582593,3658,0,-4
102490,102036,1,Presencial,2.91,0,Hombre,Ferias & Networking,1,169169,87.0,75,Soltero,15,2012,7,high,102054,Presencial,1.68,8,Hombre,Portal Web,5,1616000,92.0,76,Viudo,54,2022,1,high,-1.2300000000000002,8,4,1446831,3455,0,39
102227,102135,1,Presencial,2.75,2,Hombre,Referidos,2,189117,89.0,78,Soltero,24,2021,2,high,102028,Presencial,2.04,1,Hombre,Portal Web,2,1616000,82.0,75,Divorciado,49,2017,10,high,-0.71,-1,0,1426883,-1224,1,25
102192,102115,1,Presencial,1.72,2,Mujer,Referidos,4,225035,81.0,71,Casado,24,2018,10,high,102116,Presencial,2.0,2,Mujer,Portal Web,4,1616000,94.0,76,Soltero,35,2018,12,high,0.28,0,0,1390965,79,0,11
103198,102015,1,Presencial,4.29,10,Mujer,Portal Web,2,246660,81.0,77,Casado,20,2013,2,high,102121,Presencial,6.18,1,Mujer,Referidos,10,1358450,74.0,82,Soltero,33,2014,6,low,1.8899999999999997,-9,8,1111790,501,0,13
103233,102110,1,Presencial,3.63,5,Mujer,Portal Web,5,372527,89.0,76,Casado,30,2018,1,high,102045,Presencial,1.6,5,Mujer,Linkedin,2,998000,87.0,76,Soltero,29,2016,11,high,-2.03,0,-3,625473,-409,1,-1
103510,102106,1,Presencial,3.4,0,Hombre,Linkedin,4,386898,98.0,78,Divorciado,32,2018,6,high,102081,Presencial,1.39,1,Mujer,Ferias & Networking,5,1049000,86.0,86,Soltero,32,2019,6,high,-2.01,1,1,662102,377,0,0
103442,102077,1,Presencial,3.66,3,Hombre,Portal Web,8,509804,90.0,78,Divorciado,35,2015,5,high,102146,Presencial,2.27,0,Hombre,Ferias & Networking,11,1306940,31.0,64,Soltero,39,2021,6,low,-1.3900000000000001,-3,3,797136,2237,0,4
103949,102093,1,Presencial,3.395,9,Hombre,Portal Web,7,427230,98.0,84,Soltero,38,2016,10,high,102139,Presencial,5.41,0,Mujer,Ferias & Networking,4,488000,89.0,62,Soltero,23,2021,6,high,2.015,-9,-3,60770,1693,0,-15
103561,102072,1,Presencial,4.315,3,Mujer,Portal Web,5,270921,84.0,71,Casado,38,2015,10,high,102046,Presencial,2.61,2,Hombre,Ferias & Networking,3,947000,41.0,71,Soltero,30,2018,11,low,-1.7050000000000005,-1,-2,676079,1130,0,-8
103107,102039,1,Presencial,4.685,3,Hombre,Referidos,3,266359,80.0,70,Casado,37,2014,11,high,102054,Presencial,3.66,0,Hombre,Referidos,5,1616000,93.0,75,Viudo,49,2018,6,high,-1.0249999999999995,-3,2,1349641,1310,0,12
104163,102144,1,Presencial,4.51,7,Hombre,Linkedin,10,284793,95.0,85,Soltero,47,2022,8,high,102156,Presencial,2.13,8,Mujer,Portal Web,11,1616000,5.0,82,Viudo,58,2015,6,low,-2.38,1,1,1331207,-2616,1,11
103950,102099,1,Presencial,2.61,12,Mujer,Linkedin,9,300258,90.0,70,Soltero,45,2020,2,high,102080,Presencial,1.71,0,Hombre,Portal Web,11,1616000,76.0,80,Viudo,51,2021,10,low,-0.8999999999999999,-12,2,1315742,587,0,6
103941,102101,1,Presencial,2.33,11,Mujer,Linkedin,14,410600,89.0,78,Casado,43,2018,7,high,102089,Presencial,6.23,0,Hombre,Portal Web,26,1616000,92.0,68,Divorciado,55,2014,1,high,3.9000000000000004,-11,12,1205400,-1643,1,12
102987,102086,1,Presencial,2.565,8,Mujer,Portal Web,9,799339,90.0,74,Casado,47,2019,6,high,102085,Presencial,2.22,2,Mujer,Linkedin,7,1306940,87.0,68,Divorciado,39,2021,3,high,-0.34499999999999975,-6,-2,507601,628,0,-8
103919,102120,1,Presencial,2.845,2,Mujer,Portal Web,6,795483,84.0,79,Divorciado,50,2021,7,high,102171,Presencial,6.48,2,Hombre,Ferias & Networking,9,1616000,80.0,71,Casado,47,2023,8,high,3.6350000000000002,0,3,820517,755,0,-3
103960,102059,1,Presencial,3.165,8,Hombre,Referidos,8,881911,93.0,72,Casado,44,2015,4,high,102021,Presencial,2.55,2,Hombre,Portal Web,16,1616000,27.0,76,Viudo,50,2019,6,low,-0.6150000000000002,-6,8,734089,1526,0,6
102731,102146,1,Presencial,2.205,1,Mujer,Portal Web,13,714967,97.0,71,Casado,52,2021,9,high,102035,Presencial,2.66,0,Mujer,Portal Web,15,1616000,77.0,78,Casado,39,2013,10,low,0.45500000000000007,-1,2,901033,-2888,1,-13
104078,102054,1,Presencial,2.88,3,Mujer,Portal Web,8,702317,87.0,78,Viudo,46,2016,4,high,102044,Presencial,2.91,1,Hombre,Linkedin,17,1616000,85.0,74,Divorciado,41,2012,11,high,0.03000000000000025,-2,9,913683,-1269,1,-5
101941,102026,1,Presencial,2.03,3,Hombre,Referidos,2,213824,98.0,78,Soltero,18,2013,2,high,102101,Presencial,2.7,1,Mujer,Portal Web,15,1616000,97.0,79,Casado,58,2017,6,high,0.6700000000000004,-2,13,1402176,1586,0,40
102093,102139,2,Presencial,5.41,0,Mujer,Ferias & Networking,4,488000,89.0,62,Soltero,23,2021,6,high,102154,Presencial,6.48,1,Hombre,Ferias & Networking,5,590000,90.0,67,Casado,25,2021,6,high,1.0700000000000003,1,1,102000,6,0,2
102088,102139,2,Presencial,4.96,1,Mujer,Portal Web,3,488000,82.0,65,Soltero,20,2018,4,high,102154,Presencial,6.48,1,Hombre,Ferias & Networking,5,590000,90.0,67,Casado,25,2021,6,high,1.5200000000000005,0,2,102000,1167,0,5
102013,102139,2,Presencial,2.0,2,Mujer,Linkedin,4,743000,96.0,79,Casado,30,2022,11,high,102154,Presencial,6.48,1,Hombre,Ferias & Networking,5,590000,90.0,67,Casado,25,2021,6,high,4.48,-1,1,-153000,-511,1,-5
100642,102139,1,Presencial,2.165,5,Mujer,Linkedin,7,347865,92.0,88,Casado,32,2020,6,high,102154,Presencial,6.48,1,Hombre,Ferias & Networking,5,590000,90.0,67,Casado,25,2021,6,high,4.315,-4,-2,242135,370,0,-7
101924,102145,1,Presencial,2.45,3,Mujer,Portal Web,6,450484,93.0,69,Casado,37,2020,11,high,102116,Presencial,1.43,1,Mujer,Portal Web,3,692000,89.0,73,Viudo,23,2016,12,high,-1.0200000000000002,-2,-3,241516,-1438,1,-14
101349,102083,1,Presencial,2.48,9,Mujer,Portal Web,7,787647,95.0,70,Divorciado,34,2016,12,high,102147,Presencial,1.61,0,Mujer,Portal Web,5,1564490,83.0,71,Soltero,44,2021,2,high,-0.8699999999999999,-9,-2,776843,1533,0,10
100504,102072,1,Presencial,2.445,2,Mujer,Referidos,5,511137,91.0,75,Soltero,35,2015,4,high,102046,Presencial,2.61,2,Hombre,Ferias & Networking,3,947000,41.0,71,Soltero,30,2018,11,low,0.16500000000000004,0,-2,435863,1326,0,-5
101956,102022,1,Presencial,5.325,6,Mujer,Linkedin,7,267423,97.0,70,Divorciado,35,2012,5,high,102081,Presencial,2.07,0,Hombre,Portal Web,6,1616000,94.0,66,Viudo,47,2020,5,high,-3.2550000000000003,-6,-1,1348577,2933,0,12
100488,102114,1,Presencial,3.61,2,Hombre,Linkedin,5,277927,84.0,83,Casado,44,2020,12,high,102050,Presencial,1.44,1,Mujer,Portal Web,5,1616000,91.0,69,Divorciado,47,2021,5,high,-2.17,-1,0,1338073,155,0,3
101524,102116,1,Presencial,1.725,1,Mujer,Portal Web,10,451137,82.0,76,Soltero,43,2020,4,high,102021,Presencial,2.32,0,Mujer,Portal Web,22,1616000,94.0,76,Casado,59,2020,7,high,0.5949999999999998,-1,12,1164863,92,0,16
100575,102094,1,Presencial,2.98,3,Mujer,Referidos,15,294567,91.0,81,Casado,44,2019,5,high,102095,Presencial,1.32,1,Hombre,Portal Web,4,998000,90.0,85,Casado,28,2016,2,high,-1.66,-2,-11,703433,-1206,1,-16
100625,102086,1,Presencial,2.535,7,Mujer,Portal Web,9,799596,96.0,74,Casado,46,2019,6,high,102085,Presencial,2.22,2,Mujer,Linkedin,7,1306940,87.0,68,Divorciado,39,2021,3,high,-0.31499999999999995,-5,-2,507344,630,0,-7
101355,102120,1,Presencial,2.85,3,Mujer,Portal Web,6,796214,83.0,79,Divorciado,50,2021,7,high,102171,Presencial,6.48,2,Hombre,Ferias & Networking,9,1616000,80.0,71,Casado,47,2023,8,high,3.6300000000000003,-1,3,819786,758,0,-3
100256,102049,1,Presencial,1.51,7,Hombre,Linkedin,3,796074,82.0,72,Casado,45,2015,6,high,102029,Presencial,6.89,0,Mujer,Portal Web,9,1616000,19.0,77,Divorciado,49,2023,3,low,5.38,-7,6,819926,2818,0,4
100188,102124,1,Presencial,1.12,2,Mujer,Ferias & Networking,9,778277,85.0,75,Casado,53,2021,3,high,102099,Presencial,2.84,2,Mujer,Linkedin,4,947000,90.0,70,Soltero,24,2012,10,high,1.7199999999999998,0,-5,168723,-3071,1,-29
100218,102017,1,Presencial,1.81,9,Hombre,Linkedin,9,915728,95.0,63,Divorciado,45,2012,10,high,102035,Presencial,4.62,0,Mujer,Linkedin,2,641000,90.0,84,Casado,25,2019,11,high,2.81,-9,-7,-274728,2586,0,-20
102289,102116,1,Presencial,2.02,6,Mujer,Linkedin,3,188553,81.0,74,Casado,22,2019,7,high,102021,Presencial,2.32,0,Mujer,Portal Web,22,1616000,94.0,76,Casado,59,2020,7,high,0.2999999999999998,-6,19,1427447,381,0,37
102626,102137,1,Presencial,1.455,4,Mujer,Portal Web,3,223166,98.0,68,Casado,25,2020,5,high,102046,Presencial,1.18,0,Mujer,Portal Web,2,845000,37.0,79,Casado,27,2017,12,low,-0.27500000000000013,-4,-1,621834,-867,1,2
102825,102118,1,Presencial,3.44,5,Mujer,Portal Web,1,206662,91.0,85,Casado,26,2021,1,high,102171,Presencial,4.76,17,Mujer,Linkedin,4,1616000,86.0,74,Soltero,39,2023,8,high,1.3199999999999998,12,3,1409338,953,0,13
103138,102075,1,Presencial,7.89,0,Mujer,Referidos,2,232324,80.0,70,Soltero,23,2017,3,high,102047,Presencial,2.7,1,Hombre,Referidos,11,1255430,90.0,76,Casado,30,2013,3,high,-5.1899999999999995,1,9,1023106,-1441,1,7
103959,102125,1,Presencial,3.715,6,Hombre,Portal Web,1,271148,96.0,79,Soltero,30,2022,6,high,102096,Híbrida,4.0,2,Mujer,Referidos,5,692000,87.0,82,Casado,29,2022,7,high,0.28500000000000014,-4,4,420852,42,0,-1
102405,102086,1,Presencial,2.155,2,Mujer,Portal Web,3,266313,93.0,84,Casado,26,2018,1,high,102085,Presencial,2.22,2,Mujer,Linkedin,7,1306940,87.0,68,Divorciado,39,2021,3,high,0.06500000000000039,0,4,1040627,1136,0,13
104126,102084,1,Presencial,2.79,2,Hombre,Linkedin,3,346535,96.0,80,Soltero,31,2019,2,high,102171,Presencial,2.62,3,Mujer,Portal Web,14,1616000,89.0,76,Divorciado,50,2023,7,high,-0.16999999999999993,1,11,1269465,1616,0,19
102781,102083,1,Presencial,2.465,10,Mujer,Portal Web,7,790729,93.0,70,Divorciado,34,2016,12,high,102147,Presencial,1.61,0,Mujer,Portal Web,5,1564490,83.0,71,Soltero,44,2021,2,high,-0.8549999999999998,-10,-2,773761,1532,0,10
103186,102072,1,Presencial,2.455,1,Mujer,Referidos,5,507573,88.0,75,Soltero,35,2015,4,high,102046,Presencial,2.61,2,Hombre,Ferias & Networking,3,947000,41.0,71,Soltero,30,2018,11,low,0.1549999999999998,1,-2,439427,1327,0,-5
102654,102048,1,Presencial,3.84,2,Mujer,Ferias & Networking,8,261663,92.0,68,Casado,34,2013,12,high,102092,Presencial,3.99,0,Mujer,Portal Web,5,590000,59.0,76,Soltero,20,2015,8,low,0.15000000000000036,-2,-3,328337,616,0,-14
102584,102109,1,Presencial,3.345,0,Mujer,Portal Web,12,419029,88.0,69,Soltero,40,2018,8,high,102123,Presencial,3.86,1,Mujer,Portal Web,5,998000,97.0,82,Casado,32,2019,9,high,0.5149999999999997,1,-7,578971,410,0,-8
102756,102045,1,Presencial,2.435,0,Mujer,Referidos,5,277639,87.0,78,Casado,36,2013,10,high,102171,Presencial,3.19,3,Hombre,Portal Web,11,1616000,97.0,65,Casado,53,2023,9,high,0.7549999999999999,3,6,1338361,3645,0,17
103484,102159,1,Presencial,1.9,2,Mujer,Portal Web,4,279363,86.0,77,Casado,46,2022,11,high,102120,Híbrida,0.98,2,Hombre,Referidos,14,808000,90.0,86,Soltero,44,2022,8,high,-0.9199999999999999,0,10,528637,-97,1,-2
103252,102114,1,Presencial,3.595,2,Hombre,Linkedin,5,277256,95.0,83,Casado,44,2020,12,high,102050,Presencial,1.44,1,Mujer,Portal Web,5,1616000,91.0,69,Divorciado,47,2021,5,high,-2.1550000000000002,-1,0,1338744,155,0,3
102590,102131,1,Presencial,1.615,2,Hombre,Linkedin,13,290363,94.0,80,Soltero,47,2022,10,high,102109,Presencial,5.54,0,Hombre,Linkedin,3,998000,39.0,77,Soltero,34,2021,12,low,3.925,-2,-10,707637,-306,1,-13
104045,102112,1,Presencial,3.42,2,Mujer,Portal Web,8,298014,82.0,81,Casado,44,2019,12,high,102031,Presencial,2.27,7,Hombre,Linkedin,1,692000,83.0,74,Soltero,26,2020,6,high,-1.15,5,-7,393986,197,0,-18
103533,102156,1,Presencial,1.825,2,Mujer,Referidos,12,655545,93.0,70,Viudo,50,2022,8,high,102154,Presencial,4.23,2,Hombre,Portal Web,22,1616000,92.0,76,Soltero,63,2023,12,high,2.4050000000000002,0,10,960455,488,0,13
103985,102049,1,Presencial,1.515,8,Hombre,Linkedin,3,795917,97.0,72,Casado,45,2015,6,high,102029,Presencial,6.89,0,Mujer,Portal Web,9,1616000,19.0,77,Divorciado,49,2023,3,low,5.375,-8,6,820083,2818,0,4
103573,102017,1,Presencial,1.84,8,Hombre,Linkedin,9,919113,81.0,63,Divorciado,45,2012,10,high,102035,Presencial,4.62,0,Mujer,Linkedin,2,641000,90.0,84,Casado,25,2019,11,high,2.7800000000000002,-8,-7,-278113,2584,0,-20
101097,102120,1,Presencial,5.45,4,Mujer,Portal Web,2,140343,86.0,72,Soltero,20,2020,6,high,102171,Presencial,6.48,2,Hombre,Ferias & Networking,9,1616000,80.0,71,Casado,47,2023,8,high,1.0300000000000002,-2,7,1475657,1167,0,27
100026,102088,1,Presencial,1.73,1,Mujer,Portal Web,1,148328,87.0,66,Soltero,19,2017,12,high,102139,Presencial,4.96,1,Mujer,Portal Web,3,488000,82.0,65,Soltero,20,2018,4,high,3.23,0,2,339672,108,0,1
101717,102084,1,Presencial,3.08,3,Mujer,Ferias & Networking,1,163079,90.0,74,Soltero,21,2018,8,high,102171,Presencial,2.62,3,Mujer,Portal Web,14,1616000,89.0,76,Divorciado,50,2023,7,high,-0.45999999999999996,0,13,1452921,1787,0,29
100016,102146,1,Presencial,4.02,1,Hombre,Linkedin,5,203055,95.0,79,Casado,26,2021,12,high,102035,Presencial,2.66,0,Mujer,Portal Web,15,1616000,77.0,78,Casado,39,2013,10,low,-1.3599999999999994,-1,10,1412945,-2986,1,13
101421,102148,1,Presencial,4.665,2,Mujer,Portal Web,4,203226,87.0,78,Casado,26,2021,10,high,102116,Presencial,1.49,2,Mujer,Portal Web,2,539000,80.0,67,Soltero,26,2022,12,high,-3.175,0,-2,335774,410,0,0
101250,102038,1,Presencial,1.495,0,Mujer,Portal Web,5,186984,89.0,79,Divorciado,17,2013,7,high,102125,Presencial,2.06,1,Hombre,Portal Web,12,1616000,81.0,82,Casado,44,2018,1,high,0.565,1,7,1429016,1640,0,27
100915,102172,1,Presencial,5.88,1,Hombre,Portal Web,4,230418,86.0,80,Divorciado,29,2022,12,high,102020,Presencial,5.58,1,Hombre,Portal Web,7,1049000,57.0,70,Casado,29,2016,4,low,-0.2999999999999998,0,3,818582,-2414,1,0
100391,102151,1,Presencial,1.495,0,Mujer,Linkedin,5,286767,82.0,70,Soltero,31,2022,7,high,102105,Presencial,1.51,2,Hombre,Ferias & Networking,10,1616000,85.0,80,Divorciado,45,2021,11,high,0.014999999999999902,2,5,1329233,-252,1,14
100335,102131,1,Presencial,5.56,3,Mujer,Portal Web,5,330503,81.0,85,Soltero,34,2022,12,high,102109,Presencial,5.54,0,Hombre,Linkedin,3,998000,39.0,77,Soltero,34,2021,12,low,-0.019999999999999574,-3,-2,667497,-347,1,0
100570,102111,1,Presencial,7.51,4,Hombre,Portal Web,9,392729,91.0,71,Casado,32,2018,5,high,102097,Híbrida,2.04,1,Mujer,Referidos,15,1616000,94.0,67,Soltero,50,2021,5,high,-5.47,-3,6,1223271,1087,0,18
101116,102145,1,Presencial,2.05,1,Hombre,Portal Web,4,827088,87.0,75,Divorciado,38,2021,7,high,102116,Presencial,1.43,1,Mujer,Portal Web,3,692000,89.0,73,Viudo,23,2016,12,high,-0.6199999999999999,0,-1,-135088,-1686,1,-15
100472,102124,1,Presencial,2.09,1,Mujer,Referidos,5,420582,90.0,84,Soltero,42,2019,6,high,102099,Presencial,2.84,2,Mujer,Linkedin,4,947000,90.0,70,Soltero,24,2012,10,high,0.75,1,-1,526418,-2427,1,-18
100636,102015,1,Presencial,1.98,1,Mujer,Portal Web,11,269571,93.0,74,Divorciado,35,2013,1,high,102121,Presencial,6.18,1,Mujer,Referidos,10,1358450,74.0,82,Soltero,33,2014,6,low,4.199999999999999,0,-1,1088879,517,0,-2
101036,102138,1,Presencial,1.01,2,Mujer,Linkedin,4,279036,80.0,76,Casado,45,2022,7,high,102059,Presencial,3.26,1,Hombre,Linkedin,5,1616000,57.0,75,Soltero,44,2018,4,low,2.25,-1,1,1336964,-1571,1,-1
101909,102029,1,Presencial,2.715,2,Hombre,Linkedin,10,279687,90.0,72,Casado,37,2014,2,high,102132,Presencial,5.79,2,Hombre,Portal Web,16,1616000,80.0,84,Casado,49,2017,9,high,3.075,0,6,1336313,1307,0,12
100130,102028,1,Presencial,1.08,0,Hombre,Referidos,10,277124,84.0,75,Casado,37,2013,12,high,102085,Presencial,1.39,2,Mujer,Linkedin,12,1358450,97.0,72,Soltero,35,2016,12,high,0.30999999999999983,2,2,1081326,1123,0,-2
101109,102041,1,Presencial,7.145,10,Hombre,Portal Web,9,817157,88.0,75,Viudo,44,2015,6,high,102147,Presencial,1.29,0,Mujer,Portal Web,8,1616000,44.0,73,Casado,51,2014,5,low,-5.8549999999999995,-10,-1,798843,-399,1,7
100273,102054,1,Presencial,2.345,4,Mujer,Linkedin,8,694421,86.0,82,Soltero,45,2015,6,high,102044,Presencial,2.91,1,Hombre,Linkedin,17,1616000,85.0,74,Divorciado,41,2012,11,high,0.565,-3,9,921579,-938,1,-4
101912,102111,1,Presencial,2.635,1,Hombre,Referidos,19,877586,85.0,68,Soltero,50,2018,8,high,102097,Híbrida,2.04,1,Mujer,Referidos,15,1616000,94.0,67,Soltero,50,2021,5,high,-0.5949999999999998,0,-4,738414,1012,0,0
100416,102057,1,Presencial,2.15,2,Mujer,Referidos,12,738016,80.0,81,Divorciado,46,2013,11,high,102019,Presencial,1.97,4,Hombre,Portal Web,5,1616000,90.0,73,Viudo,59,2022,12,high,-0.17999999999999994,2,-7,877984,3325,0,13
100493,102078,1,Presencial,5.94,2,Hombre,Portal Web,3,834817,97.0,80,Viudo,51,2017,2,high,102143,Presencial,2.17,1,Hombre,Ferias & Networking,9,998000,83.0,76,Casado,29,2017,5,high,-3.7700000000000005,-1,6,163183,106,0,-22
101214,102089,1,Presencial,1.69,2,Hombre,Portal Web,14,893896,83.0,77,Casado,52,2016,5,high,102077,Presencial,2.75,1,Hombre,Ferias & Networking,6,1616000,96.0,69,Divorciado,60,2021,10,high,1.06,-1,-8,722104,1979,0,8
102715,102122,1,Presencial,1.18,2,Hombre,Referidos,1,163835,82.0,74,Soltero,23,2021,10,high,102075,Presencial,1.83,4,Hombre,Portal Web,6,1616000,90.0,66,Viudo,48,2019,3,high,0.6500000000000001,2,5,1452165,-930,1,25
102461,102148,1,Presencial,4.695,1,Mujer,Portal Web,4,200219,81.0,78,Casado,26,2021,10,high,102116,Presencial,1.49,2,Mujer,Portal Web,2,539000,80.0,67,Soltero,26,2022,12,high,-3.205,1,-2,338781,409,0,0
102344,102035,1,Presencial,5.765,3,Hombre,Linkedin,2,226036,81.0,64,Casado,19,2013,4,high,102041,Presencial,2.86,1,Hombre,Portal Web,23,1900000,83.0,72,Casado,57,2013,8,high,-2.905,-2,21,1673964,116,0,38
102400,102035,1,Presencial,1.515,2,Hombre,Portal Web,9,386412,90.0,70,Soltero,28,2014,4,high,102041,Presencial,2.86,1,Hombre,Portal Web,23,1900000,83.0,72,Casado,57,2013,8,high,1.345,-1,14,1513588,-259,1,29
103166,102153,1,Presencial,3.405,7,Mujer,Portal Web,7,428942,83.0,66,Soltero,39,2023,3,high,102143,Presencial,6.39,1,Mujer,Linkedin,5,1616000,90.0,68,Casado,41,2019,6,high,2.985,-6,-2,1187058,-1381,1,2
103998,102145,1,Presencial,2.06,2,Hombre,Portal Web,4,826522,82.0,75,Divorciado,38,2021,7,high,102116,Presencial,1.43,1,Mujer,Portal Web,3,692000,89.0,73,Viudo,23,2016,12,high,-0.6300000000000001,-1,-1,-134522,-1683,1,-15
102221,102124,1,Presencial,2.08,0,Mujer,Referidos,5,416042,80.0,84,Soltero,42,2019,6,high,102099,Presencial,2.84,2,Mujer,Linkedin,4,947000,90.0,70,Soltero,24,2012,10,high,0.7599999999999998,2,-1,530958,-2426,1,-18
102259,102015,1,Presencial,1.98,1,Mujer,Referidos,11,264237,81.0,74,Divorciado,35,2013,1,high,102121,Presencial,6.18,1,Mujer,Referidos,10,1358450,74.0,82,Soltero,33,2014,6,low,4.199999999999999,0,-1,1094213,516,0,-2
102749,102146,1,Presencial,4.23,1,Mujer,Ferias & Networking,9,640828,82.0,75,Viudo,50,2023,5,high,102035,Presencial,2.66,0,Mujer,Portal Web,15,1616000,77.0,78,Casado,39,2013,10,low,-1.5700000000000003,-1,6,975172,-3507,1,-11
103620,102041,1,Presencial,7.155,11,Hombre,Portal Web,9,818142,96.0,75,Viudo,44,2015,6,high,102147,Presencial,1.29,0,Mujer,Portal Web,8,1616000,44.0,73,Casado,51,2014,5,low,-5.865,-11,-1,797858,-402,1,7
103346,102115,1,Presencial,6.675,2,Hombre,Referidos,11,699410,96.0,81,Soltero,50,2020,5,high,102116,Presencial,2.0,2,Mujer,Portal Web,4,1616000,94.0,76,Soltero,35,2018,12,high,-4.675,0,-7,916590,-496,1,-15
101008,102107,1,Presencial,6.355,3,Mujer,Ferias & Networking,1,75517,90.0,80,Soltero,17,2019,12,high,102069,Presencial,2.4,1,Mujer,Linkedin,8,1616000,47.0,79,Casado,63,2023,6,low,-3.9550000000000005,-2,7,1540483,1288,0,46
100997,102143,1,Presencial,5.88,1,Hombre,Portal Web,1,119344,86.0,72,Soltero,20,2021,5,high,102142,Presencial,1.07,2,Hombre,Portal Web,2,590000,90.0,78,Casado,25,2022,2,high,-4.81,1,1,470656,251,0,5
100581,102137,1,Presencial,5.545,1,Mujer,Ferias & Networking,1,180275,96.0,85,Soltero,26,2023,3,high,102046,Presencial,1.18,0,Mujer,Portal Web,2,845000,37.0,79,Casado,27,2017,12,low,-4.365,-1,1,664725,-1901,1,1
101300,102089,1,Presencial,3.11,2,Mujer,Portal Web,5,325991,82.0,77,Casado,31,2019,9,high,102077,Presencial,2.75,1,Hombre,Ferias & Networking,6,1616000,96.0,69,Divorciado,60,2021,10,high,-0.3599999999999999,-1,1,1290009,761,0,29
101640,102029,1,Presencial,2.135,2,Mujer,Portal Web,7,388798,85.0,85,Casado,29,2014,9,high,102132,Presencial,5.79,2,Hombre,Portal Web,16,1616000,80.0,84,Casado,49,2017,9,high,3.6550000000000002,0,9,1227202,1105,0,20
100127,102035,1,Presencial,1.49,1,Hombre,Portal Web,9,386702,86.0,70,Soltero,28,2014,4,high,102041,Presencial,2.86,1,Hombre,Portal Web,23,1900000,83.0,72,Casado,57,2013,8,high,1.3699999999999999,0,14,1513298,-261,1,29
101132,102115,1,Presencial,6.035,2,Hombre,Linkedin,8,489279,93.0,70,Soltero,40,2020,8,high,102116,Presencial,2.0,2,Mujer,Portal Web,4,1616000,94.0,76,Soltero,35,2018,12,high,-4.035,0,-4,1126721,-597,1,-5
101725,102031,1,Presencial,2.12,2,Mujer,Portal Web,6,488016,80.0,81,Casado,33,2013,10,high,102111,Presencial,2.95,2,Hombre,Portal Web,8,1610000,76.0,87,Casado,31,2017,7,low,0.8300000000000001,0,2,1121984,1344,0,-2
100300,102041,1,Presencial,2.645,2,Mujer,Portal Web,13,269865,95.0,66,Casado,34,2012,9,high,102147,Presencial,1.29,0,Mujer,Portal Web,8,1616000,44.0,73,Casado,51,2014,5,low,-1.355,-2,-5,1346135,621,0,17
101598,102118,1,Presencial,6.32,2,Hombre,Ferias & Networking,5,266895,92.0,69,Soltero,41,2019,1,high,102171,Presencial,4.76,17,Mujer,Linkedin,4,1616000,86.0,74,Soltero,39,2023,8,high,-1.5600000000000005,15,-1,1349105,1682,0,-2
101110,102161,1,Presencial,5.04,2,Mujer,Referidos,5,449228,94.0,77,Soltero,45,2022,5,high,102039,Presencial,3.93,5,Mujer,Portal Web,4,1409960,85.0,77,Casado,36,2016,10,high,-1.1099999999999999,3,-1,960732,-2023,1,-9
102079,102146,2,Presencial,2.63,1,Mujer,Portal Web,4,1358450,80.0,81,Soltero,35,2016,3,high,102035,Presencial,2.66,0,Mujer,Portal Web,15,1616000,77.0,78,Casado,39,2013,10,low,0.03000000000000025,-1,11,257550,-879,1,4
101675,102146,1,Presencial,4.19,0,Mujer,Ferias & Networking,9,639218,87.0,75,Viudo,50,2023,5,high,102035,Presencial,2.66,0,Mujer,Portal Web,15,1616000,77.0,78,Casado,39,2013,10,low,-1.5300000000000002,0,6,976782,-3507,1,-11
101475,102075,1,Presencial,1.8,3,Hombre,Portal Web,10,433559,97.0,69,Casado,42,2015,2,high,102047,Presencial,2.7,1,Hombre,Referidos,11,1255430,90.0,76,Casado,30,2013,3,high,0.9000000000000001,-2,1,821871,-685,1,-12
100505,102044,1,Presencial,2.555,2,Mujer,Referidos,12,721934,94.0,78,Soltero,45,2013,12,high,102155,Presencial,1.54,1,Hombre,Ferias & Networking,14,1616000,56.0,68,Soltero,47,2023,3,low,-1.0150000000000001,-1,2,894066,3387,0,2
102158,102093,2,Presencial,1.79,1,Mujer,Referidos,27,1900000,87.0,74,Viudo,54,2013,9,high,102139,Presencial,5.41,0,Mujer,Ferias & Networking,4,488000,89.0,62,Soltero,23,2021,6,high,3.62,-1,-23,-1412000,2825,0,-31
103452,102093,1,Presencial,1.75,1,Hombre,Portal Web,1,99940,90.0,76,Soltero,15,2016,9,high,102139,Presencial,5.41,0,Mujer,Ferias & Networking,4,488000,89.0,62,Soltero,23,2021,6,high,3.66,-1,3,388060,1731,0,8
102627,102143,1,Presencial,5.875,0,Hombre,Portal Web,1,122573,80.0,72,Soltero,20,2021,5,high,102142,Presencial,1.07,2,Hombre,Portal Web,2,590000,90.0,78,Casado,25,2022,2,high,-4.805,2,1,467427,250,0,5
102272,102137,1,Presencial,5.52,0,Mujer,Ferias & Networking,1,187188,98.0,85,Soltero,25,2023,3,high,102046,Presencial,1.18,0,Mujer,Portal Web,2,845000,37.0,79,Casado,27,2017,12,low,-4.34,0,1,657812,-1900,1,2
103338,102035,1,Presencial,0.875,2,Mujer,Portal Web,4,181235,95.0,78,Soltero,17,2014,2,high,102041,Presencial,2.86,1,Hombre,Portal Web,23,1900000,83.0,72,Casado,57,2013,8,high,1.9849999999999999,-1,19,1718765,-198,1,40
103996,102172,1,Presencial,5.85,1,Hombre,Portal Web,4,227082,82.0,80,Divorciado,29,2022,12,high,102020,Presencial,5.58,1,Hombre,Portal Web,7,1049000,57.0,70,Casado,29,2016,4,low,-0.2699999999999996,0,3,821918,-2416,1,0
103595,102086,1,Presencial,4.76,2,Hombre,Ferias & Networking,6,492019,96.0,77,Casado,35,2016,3,high,102085,Presencial,2.22,2,Mujer,Linkedin,7,1306940,87.0,68,Divorciado,39,2021,3,high,-2.5399999999999996,0,1,814921,1828,0,4
102486,102039,1,Presencial,0.955,2,Hombre,Referidos,8,255595,95.0,72,Soltero,35,2014,4,high,102054,Presencial,3.66,0,Hombre,Referidos,5,1616000,93.0,75,Viudo,49,2018,6,high,2.705,-2,-3,1360405,1522,0,14
102188,102028,1,Presencial,5.825,0,Mujer,Ferias & Networking,3,374012,82.0,76,Divorciado,37,2012,8,high,102085,Presencial,1.39,2,Mujer,Linkedin,12,1358450,97.0,72,Soltero,35,2016,12,high,-4.4350000000000005,2,9,984438,1595,0,-2
102356,102075,1,Presencial,1.77,2,Hombre,Portal Web,10,434387,97.0,69,Casado,42,2015,2,high,102047,Presencial,2.7,1,Hombre,Referidos,11,1255430,90.0,76,Casado,30,2013,3,high,0.9300000000000002,-1,1,821043,-684,1,-12
102370,102055,1,Presencial,0.965,1,Mujer,Ferias & Networking,12,680450,82.0,67,Casado,43,2013,11,high,102129,Presencial,1.92,2,Hombre,Referidos,8,1616000,97.0,63,Casado,42,2013,2,high,0.955,1,-4,935550,-255,1,-1
103512,102044,1,Presencial,2.555,2,Mujer,Referidos,12,718187,80.0,78,Soltero,45,2013,12,high,102155,Presencial,1.54,1,Hombre,Ferias & Networking,14,1616000,56.0,68,Soltero,47,2023,3,low,-1.0150000000000001,-1,2,897813,3386,0,2
103190,102111,1,Presencial,2.635,2,Hombre,Referidos,19,875637,89.0,68,Soltero,51,2018,8,high,102097,Híbrida,2.04,1,Mujer,Referidos,15,1616000,94.0,67,Soltero,50,2021,5,high,-0.5949999999999998,-1,-4,740363,1013,0,-1
102958,102057,1,Presencial,2.155,2,Mujer,Referidos,12,736821,89.0,81,Divorciado,46,2013,11,high,102019,Presencial,1.97,4,Hombre,Portal Web,5,1616000,90.0,73,Viudo,59,2022,12,high,-0.18499999999999983,2,-7,879179,3324,0,13
102358,102111,1,Presencial,3.77,7,Mujer,Portal Web,1,100460,94.0,73,Soltero,16,2018,4,high,102097,Híbrida,2.04,1,Mujer,Referidos,15,1616000,94.0,67,Soltero,50,2021,5,high,-1.73,-6,14,1515540,1124,0,34
100434,102110,1,Presencial,3.115,1,Mujer,Ferias & Networking,5,286593,90.0,79,Soltero,42,2018,3,high,102045,Presencial,1.6,5,Mujer,Linkedin,2,998000,87.0,76,Soltero,29,2016,11,high,-1.5150000000000001,4,-3,711407,-487,1,-13
102164,102109,2,Presencial,3.78,2,Hombre,Linkedin,7,1461470,83.0,77,Casado,40,2018,9,high,102123,Presencial,3.86,1,Mujer,Portal Web,5,998000,97.0,82,Casado,32,2019,9,high,0.08000000000000007,-1,-2,-463470,363,0,-8
103680,102109,1,Presencial,3.03,1,Hombre,Ferias & Networking,7,492568,83.0,79,Soltero,38,2019,7,high,102123,Presencial,3.86,1,Mujer,Portal Web,5,998000,97.0,82,Casado,32,2019,9,high,0.8300000000000001,0,-2,505432,82,0,-6
101762,102146,1,Presencial,3.925,1,Mujer,Referidos,10,409810,94.0,80,Divorciado,37,2022,10,high,102035,Presencial,2.66,0,Mujer,Portal Web,15,1616000,77.0,78,Casado,39,2013,10,low,-1.2649999999999997,-1,5,1206190,-3280,1,2
101529,102006,1,Presencial,2.22,5,Hombre,Portal Web,1,250393,82.0,84,Soltero,19,2012,3,high,102084,Presencial,2.58,0,Hombre,Linkedin,16,1900000,87.0,77,Viudo,57,2019,4,high,0.3599999999999999,-5,15,1649607,2605,0,38
101971,102018,1,Presencial,1.955,3,Hombre,Linkedin,5,270353,95.0,89,Soltero,20,2012,8,high,102160,Presencial,5.57,5,Hombre,Portal Web,3,692000,90.0,69,Divorciado,28,2022,2,high,3.615,2,-2,421647,3494,0,8
101840,102160,1,Presencial,1.8,2,Hombre,Portal Web,13,287743,86.0,75,Divorciado,46,2022,11,high,102087,Presencial,2.21,0,Hombre,Portal Web,3,794000,83.0,78,Casado,28,2019,8,high,0.4099999999999999,-2,-10,506257,-1180,1,-18
102852,102006,1,Presencial,2.215,5,Hombre,Portal Web,1,252449,85.0,84,Soltero,19,2012,3,high,102084,Presencial,2.58,0,Hombre,Linkedin,16,1900000,87.0,77,Viudo,57,2019,4,high,0.3650000000000002,-5,15,1647551,2605,0,38
102209,102014,1,Presencial,5.41,1,Mujer,Portal Web,3,267540,80.0,84,Casado,22,2013,5,high,102096,Presencial,1.78,1,Mujer,Portal Web,2,488000,98.0,78,Soltero,25,2023,1,high,-3.63,0,-1,220460,3522,0,3
100272,102049,1,Presencial,2.16,3,Mujer,Linkedin,6,251460,80.0,75,Casado,19,2013,2,high,102029,Presencial,6.89,0,Mujer,Portal Web,9,1616000,19.0,77,Divorciado,49,2023,3,low,4.7299999999999995,-3,3,1364540,3685,0,30
100759,102110,1,Presencial,1.3,3,Mujer,Ferias & Networking,6,269059,86.0,75,Soltero,29,2021,5,high,102045,Presencial,1.6,5,Mujer,Linkedin,2,998000,87.0,76,Soltero,29,2016,11,high,0.30000000000000004,2,-4,728941,-1638,1,0
100186,102014,1,Presencial,5.435,1,Mujer,Portal Web,3,267708,83.0,84,Casado,22,2013,5,high,102096,Presencial,1.78,1,Mujer,Portal Web,2,488000,98.0,78,Soltero,25,2023,1,high,-3.6549999999999994,0,-1,220292,3522,0,3
100343,102125,1,Presencial,1.975,2,Mujer,Linkedin,5,285772,86.0,79,Soltero,30,2021,1,high,102096,Híbrida,4.0,2,Mujer,Referidos,5,692000,87.0,82,Casado,29,2022,7,high,2.025,0,0,406228,542,0,-1
101718,102080,1,Presencial,3.47,3,Hombre,Portal Web,2,391361,80.0,69,Soltero,30,2016,6,high,102035,Presencial,1.93,0,Mujer,Linkedin,18,1616000,94.0,75,Viudo,47,2016,8,high,-1.5400000000000003,-3,16,1224639,66,0,17
101069,102109,1,Presencial,4.66,1,Mujer,Portal Web,4,917058,96.0,75,Divorciado,50,2018,1,high,102123,Presencial,3.86,1,Mujer,Portal Web,5,998000,97.0,82,Casado,32,2019,9,high,-0.8000000000000003,0,1,80942,605,0,-18
103318,102049,1,Presencial,2.13,3,Mujer,Linkedin,6,249880,92.0,75,Casado,20,2013,2,high,102029,Presencial,6.89,0,Mujer,Portal Web,9,1616000,19.0,77,Divorciado,49,2023,3,low,4.76,-3,3,1366120,3687,0,29
103093,102039,1,Presencial,4.705,2,Mujer,Referidos,5,266305,92.0,70,Divorciado,21,2012,7,high,102054,Presencial,3.66,0,Hombre,Referidos,5,1616000,93.0,75,Viudo,49,2018,6,high,-1.045,-2,0,1349695,2167,0,28
102867,102089,1,Presencial,3.275,10,Hombre,Portal Web,8,367619,84.0,78,Soltero,32,2019,1,high,102077,Presencial,2.75,1,Hombre,Ferias & Networking,6,1616000,96.0,69,Divorciado,60,2021,10,high,-0.5249999999999999,-9,-2,1248381,1003,0,28
103131,102158,1,Presencial,2.28,1,Hombre,Ferias & Networking,9,280984,87.0,80,Casado,45,2022,3,high,102093,Presencial,1.79,1,Mujer,Referidos,27,1900000,87.0,74,Viudo,54,2013,9,high,-0.48999999999999977,0,18,1619016,-3101,1,9
103065,102172,1,Presencial,2.235,2,Hombre,Referidos,12,290605,85.0,68,Soltero,47,2023,3,high,102020,Presencial,5.58,1,Hombre,Portal Web,7,1049000,57.0,70,Casado,29,2016,4,low,3.345,-1,-5,758395,-2510,1,-18
103164,102160,1,Presencial,1.81,3,Hombre,Portal Web,13,290378,89.0,75,Divorciado,47,2022,11,high,102087,Presencial,2.21,0,Hombre,Portal Web,3,794000,83.0,78,Casado,28,2019,8,high,0.3999999999999999,-3,-10,503622,-1181,1,-19
103099,102123,1,Presencial,2.745,0,Hombre,Linkedin,4,289173,88.0,75,Casado,43,2019,4,high,102043,Presencial,5.5,1,Mujer,Linkedin,16,1616000,42.0,66,Soltero,51,2021,9,low,2.755,1,12,1326827,878,0,8
103342,102127,1,Presencial,4.81,11,Mujer,Linkedin,12,715281,94.0,73,Soltero,53,2022,7,high,102028,Presencial,4.03,2,Mujer,Linkedin,9,1306940,88.0,78,Divorciado,32,2014,5,high,-0.7799999999999994,-9,-3,591659,-2964,1,-21
102427,102059,1,Presencial,6.37,0,Hombre,Portal Web,18,713768,89.0,78,Casado,47,2015,9,high,102021,Presencial,2.55,2,Hombre,Portal Web,16,1616000,27.0,76,Viudo,50,2019,6,low,-3.8200000000000003,2,-2,902232,1359,0,3
103312,102109,1,Presencial,4.69,2,Mujer,Portal Web,4,914132,80.0,75,Divorciado,50,2018,2,high,102123,Presencial,3.86,1,Mujer,Portal Web,5,998000,97.0,82,Casado,32,2019,9,high,-0.8300000000000005,-1,1,83868,602,0,-18
100414,102152,1,Presencial,2.95,5,Hombre,Portal Web,7,297320,96.0,77,Divorciado,47,2022,12,high,102089,Presencial,2.75,5,Hombre,Portal Web,7,1616000,15.0,68,Soltero,47,2019,8,low,-0.20000000000000018,0,0,1318680,-1215,1,0
100228,102023,1,Presencial,1.385,7,Hombre,Portal Web,6,385064,95.0,69,Soltero,37,2013,10,high,102105,Híbrida,4.9,1,Hombre,Portal Web,4,539000,80.0,65,Casado,23,2019,12,high,3.5150000000000006,-6,-2,153936,2263,0,-14
101111,102109,1,Presencial,1.31,3,Mujer,Ferias & Networking,8,449826,94.0,74,Soltero,44,2018,4,high,102123,Presencial,3.86,1,Mujer,Portal Web,5,998000,97.0,82,Casado,32,2019,9,high,2.55,-2,-3,548174,537,0,-12
101835,102093,1,Presencial,5.835,6,Hombre,Linkedin,6,699720,91.0,63,Casado,47,2017,1,high,102139,Presencial,5.41,0,Mujer,Ferias & Networking,4,488000,89.0,62,Soltero,23,2021,6,high,-0.4249999999999998,-6,-2,-211720,1626,0,-24
100031,102127,1,Presencial,4.85,11,Mujer,Linkedin,12,720179,85.0,73,Soltero,53,2022,7,high,102028,Presencial,4.03,2,Mujer,Linkedin,9,1306940,88.0,78,Divorciado,32,2014,5,high,-0.8199999999999994,-9,-3,586761,-2967,1,-21
103116,102125,1,Presencial,2.0,2,Mujer,Linkedin,5,285905,97.0,79,Soltero,30,2021,1,high,102096,Híbrida,4.0,2,Mujer,Referidos,5,692000,87.0,82,Casado,29,2022,7,high,2.0,0,0,406095,543,0,-1
103169,102134,1,Presencial,5.565,2,Hombre,Portal Web,3,300917,87.0,81,Divorciado,48,2023,6,high,102135,Presencial,2.25,2,Hombre,Portal Web,5,1358450,90.0,69,Viudo,31,2012,7,high,-3.3150000000000004,0,2,1057533,-3989,1,-17
100123,102038,1,Presencial,1.89,2,Hombre,Ferias & Networking,5,212360,86.0,75,Casado,20,2014,10,high,102125,Presencial,2.06,1,Hombre,Portal Web,12,1616000,81.0,82,Casado,44,2018,1,high,0.17000000000000015,-1,7,1403640,1184,0,24
102112,102031,2,Presencial,2.27,7,Hombre,Linkedin,1,692000,83.0,74,Soltero,26,2020,6,high,102111,Presencial,2.95,2,Hombre,Portal Web,8,1610000,76.0,87,Casado,31,2017,7,low,0.6800000000000002,-5,7,918000,-1085,1,5
100174,102031,1,Presencial,2.68,23,Hombre,Headhunter,4,407694,82.0,63,Divorciado,36,2014,5,high,102111,Presencial,2.95,2,Hombre,Portal Web,8,1610000,76.0,87,Casado,31,2017,7,low,0.27,-21,4,1202306,1130,0,-5
101213,102141,1,Presencial,2.035,11,Mujer,Linkedin,15,438318,93.0,66,Soltero,48,2022,5,high,102134,Presencial,1.88,1,Mujer,Linkedin,3,1100900,64.0,69,Soltero,32,2018,5,low,-0.15500000000000025,-10,-12,662582,-1451,1,-16
102902,102135,1,Presencial,2.04,1,Mujer,Referidos,2,289409,83.0,70,Casado,31,2022,9,high,102028,Presencial,2.04,1,Hombre,Portal Web,2,1616000,82.0,75,Divorciado,49,2017,10,high,0.0,0,0,1326591,-1793,1,18
104007,102093,1,Presencial,1.71,1,Mujer,Portal Web,6,658181,96.0,70,Soltero,45,2017,1,high,102139,Presencial,5.41,0,Mujer,Ferias & Networking,4,488000,89.0,62,Soltero,23,2021,6,high,3.7,-1,-2,-170181,1615,0,-22
100203,102100,1,Presencial,3.865,10,Hombre,Linkedin,6,255003,86.0,86,Soltero,40,2018,7,high,102007,Presencial,3.3,1,Mujer,Portal Web,3,1255430,21.0,59,Casado,30,2013,2,low,-0.5650000000000004,-9,-3,1000427,-1974,1,-10
101696,102129,1,Presencial,7.595,1,Mujer,Ferias & Networking,5,391199,96.0,79,Divorciado,46,2019,11,high,102142,Presencial,2.1,2,Mujer,Linkedin,3,590000,41.0,74,Soltero,24,2020,1,low,-5.494999999999999,1,-2,198801,50,0,-22
100145,102118,1,Presencial,1.62,2,Mujer,Portal Web,16,697634,91.0,81,Divorciado,51,2021,4,high,102171,Presencial,4.76,17,Mujer,Linkedin,4,1616000,86.0,74,Soltero,39,2023,8,high,3.1399999999999997,15,-12,918366,857,0,-12
100444,102055,1,Presencial,1.4,6,Hombre,Linkedin,12,722063,94.0,76,Viudo,47,2016,7,high,102129,Presencial,1.92,2,Hombre,Referidos,8,1616000,97.0,63,Casado,42,2013,2,high,0.52,-4,-4,893937,-1225,1,-5
101980,102047,1,Presencial,2.56,1,Mujer,Portal Web,13,721014,90.0,70,Soltero,46,2014,10,high,102089,Presencial,2.67,1,Hombre,Linkedin,4,743000,14.0,70,Casado,22,2015,11,low,0.10999999999999988,0,-9,21986,418,0,-24
101578,102037,1,Presencial,3.53,8,Mujer,Portal Web,9,819490,92.0,86,Soltero,45,2013,8,high,102057,Presencial,1.12,1,Mujer,Linkedin,2,641000,50.0,76,Casado,21,2016,12,low,-2.4099999999999997,-7,-7,-178490,1200,0,-24
100969,102071,1,Presencial,2.36,6,Hombre,Linkedin,5,913006,85.0,79,Soltero,49,2017,4,high,102171,Presencial,0.87,1,Hombre,Portal Web,11,1616000,85.0,72,Viudo,51,2023,11,high,-1.4899999999999998,-5,6,702994,2410,0,2
101547,102085,1,Presencial,1.875,2,Hombre,Referidos,12,879943,86.0,77,Viudo,49,2016,12,high,102145,Presencial,6.59,4,Hombre,Portal Web,12,1616000,47.0,71,Casado,39,2015,8,low,4.715,2,0,736057,-496,1,-10
101533,102036,1,Presencial,1.925,0,Hombre,Portal Web,10,738048,93.0,79,Soltero,47,2015,5,high,102054,Presencial,1.68,8,Hombre,Portal Web,5,1616000,92.0,76,Viudo,54,2022,1,high,-0.2450000000000001,8,-5,877952,2442,0,7
103136,102083,1,Presencial,1.56,2,Hombre,Portal Web,5,271901,97.0,75,Casado,24,2016,6,high,102147,Presencial,1.61,0,Mujer,Portal Web,5,1564490,83.0,71,Soltero,44,2021,2,high,0.050000000000000044,-2,0,1292589,1716,0,20
103706,102111,1,Presencial,1.53,1,Hombre,Portal Web,6,391862,89.0,75,Viudo,35,2021,3,high,102097,Híbrida,2.04,1,Mujer,Referidos,15,1616000,94.0,67,Soltero,50,2021,5,high,0.51,0,9,1224138,67,0,15
103333,102031,1,Presencial,2.695,23,Hombre,Headhunter,4,406613,85.0,63,Divorciado,36,2014,5,high,102111,Presencial,2.95,2,Hombre,Portal Web,8,1610000,76.0,87,Casado,31,2017,7,low,0.25500000000000034,-21,4,1203387,1132,0,-5
102517,102053,1,Presencial,3.86,0,Hombre,Linkedin,4,280577,91.0,71,Casado,37,2014,3,high,102030,Presencial,1.29,0,Hombre,Portal Web,11,1616000,81.0,64,Soltero,36,2012,12,high,-2.57,0,7,1335423,-444,1,-1
102819,102129,1,Presencial,7.61,2,Mujer,Ferias & Networking,5,384166,94.0,79,Divorciado,46,2019,11,high,102142,Presencial,2.1,2,Mujer,Linkedin,3,590000,41.0,74,Soltero,24,2020,1,low,-5.51,0,-2,205834,52,0,-22
104101,102118,1,Presencial,2.295,2,Hombre,Ferias & Networking,4,654188,81.0,71,Divorciado,48,2020,3,high,102171,Presencial,4.76,17,Mujer,Linkedin,4,1616000,86.0,74,Soltero,39,2023,8,high,2.465,15,0,961812,1265,0,-9
102901,102069,1,Presencial,2.81,2,Hombre,Ferias & Networking,12,662326,87.0,70,Casado,45,2017,4,high,102069,Presencial,4.64,1,Mujer,Ferias & Networking,19,1616000,47.0,74,Casado,60,2021,10,low,1.8299999999999996,-1,7,953674,1663,0,15
103895,102037,1,Presencial,1.85,8,Hombre,Linkedin,14,777327,97.0,78,Soltero,43,2012,10,high,102057,Presencial,1.12,1,Mujer,Linkedin,2,641000,50.0,76,Casado,21,2016,12,low,-0.73,-7,-12,-136327,1518,0,-22
103042,102071,1,Presencial,2.39,6,Hombre,Linkedin,5,919140,96.0,79,Soltero,49,2017,4,high,102171,Presencial,0.87,1,Hombre,Portal Web,11,1616000,85.0,72,Viudo,51,2023,11,high,-1.52,-5,6,696860,2410,0,2
101707,102092,1,Presencial,2.19,2,Mujer,Portal Web,1,101968,96.0,71,Soltero,15,2017,1,high,102120,Presencial,1.23,6,Mujer,Linkedin,13,1616000,98.0,95,Viudo,41,2013,6,high,-0.96,4,12,1514032,-1315,1,26
100799,102096,1,Presencial,0.935,4,Mujer,Referidos,2,162553,90.0,74,Soltero,19,2017,3,high,102116,Presencial,5.11,8,Mujer,Linkedin,13,1461470,90.0,74,Soltero,42,2021,5,high,4.175000000000001,4,11,1298917,1521,0,23
101845,102060,1,Presencial,6.205,2,Mujer,Linkedin,10,391574,87.0,76,Soltero,39,2015,4,high,102041,Presencial,4.42,3,Hombre,Referidos,16,1616000,82.0,62,Casado,45,2013,10,high,-1.7850000000000001,1,6,1224426,-537,1,6
100011,102037,1,Presencial,1.865,8,Hombre,Portal Web,14,780391,95.0,78,Soltero,43,2012,10,high,102057,Presencial,1.12,1,Mujer,Linkedin,2,641000,50.0,76,Casado,21,2016,12,low,-0.7449999999999999,-7,-12,-139391,1516,0,-22
101990,102023,1,Presencial,5.305,2,Mujer,Portal Web,9,916188,86.0,79,Viudo,48,2012,4,high,102105,Híbrida,4.9,1,Hombre,Portal Web,4,539000,80.0,65,Casado,23,2019,12,high,-0.40499999999999936,-1,-5,-377188,2805,0,-25
103619,102092,1,Presencial,2.18,1,Mujer,Portal Web,1,100471,96.0,71,Viudo,15,2017,1,high,102120,Presencial,1.23,6,Mujer,Linkedin,13,1616000,98.0,95,Viudo,41,2013,6,high,-0.9500000000000002,5,12,1515529,-1316,1,26
103497,102075,1,Presencial,6.39,3,Mujer,Linkedin,2,286217,88.0,83,Casado,24,2015,4,high,102047,Presencial,2.7,1,Hombre,Referidos,11,1255430,90.0,76,Casado,30,2013,3,high,-3.6899999999999995,-2,9,969213,-760,1,6
102348,102091,1,Presencial,2.045,2,Mujer,Portal Web,7,388735,80.0,76,Casado,32,2017,5,high,102149,Presencial,1.54,1,Mujer,Portal Web,4,1616000,73.0,77,Casado,39,2014,12,low,-0.5049999999999999,-1,-3,1227265,-868,1,7
103610,102118,1,Presencial,1.64,3,Mujer,Portal Web,16,694357,81.0,81,Divorciado,51,2021,4,high,102171,Presencial,4.76,17,Mujer,Linkedin,4,1616000,86.0,74,Soltero,39,2023,8,high,3.12,14,-12,921643,855,0,-12
103016,102023,1,Presencial,5.285,2,Mujer,Portal Web,9,916404,87.0,79,Viudo,48,2012,4,high,102105,Híbrida,4.9,1,Hombre,Portal Web,4,539000,80.0,65,Casado,23,2019,12,high,-0.3849999999999998,-1,-5,-377404,2807,0,-25
101572,102103,1,Presencial,1.89,3,Mujer,Portal Web,2,251612,81.0,69,Casado,27,2020,3,high,102023,Presencial,1.69,6,Hombre,Portal Web,3,1616000,90.0,74,Casado,45,2013,5,high,-0.19999999999999996,3,1,1364388,-2485,1,18
100190,102044,1,Presencial,1.3,2,Hombre,Linkedin,2,350478,86.0,78,Casado,28,2016,1,high,102155,Presencial,1.54,1,Hombre,Ferias & Networking,14,1616000,56.0,68,Soltero,47,2023,3,low,0.24,-1,12,1265522,2628,0,19
100560,102084,1,Presencial,5.515,3,Hombre,Portal Web,14,419722,89.0,74,Casado,38,2016,8,high,102171,Presencial,2.62,3,Mujer,Portal Web,14,1616000,89.0,76,Divorciado,50,2023,7,high,-2.8949999999999996,0,0,1196278,2518,0,12
103437,102103,1,Presencial,1.85,2,Mujer,Portal Web,2,247573,94.0,69,Casado,27,2020,3,high,102023,Presencial,1.69,6,Hombre,Portal Web,3,1616000,90.0,74,Casado,45,2013,5,high,-0.16000000000000014,4,1,1368427,-2487,1,18
104136,102172,1,Presencial,1.615,0,Mujer,Portal Web,3,408487,87.0,84,Soltero,38,2023,1,high,102020,Presencial,5.58,1,Hombre,Portal Web,7,1049000,57.0,70,Casado,29,2016,4,low,3.965,1,4,640513,-2467,1,-9
101024,102043,1,Presencial,5.725,1,Mujer,Ferias & Networking,4,311881,90.0,75,Soltero,24,2014,2,high,102051,Presencial,1.03,0,Hombre,Portal Web,5,1616000,60.0,76,Casado,44,2019,5,low,-4.694999999999999,-1,1,1304119,1918,0,20
101807,102086,1,Presencial,0.955,9,Hombre,Portal Web,8,366827,84.0,75,Casado,31,2018,1,high,102085,Presencial,2.22,2,Mujer,Linkedin,7,1306940,87.0,68,Divorciado,39,2021,3,high,1.2650000000000001,-7,-1,940113,1148,0,8
101442,102172,1,Presencial,1.585,1,Mujer,Portal Web,3,405606,96.0,84,Soltero,38,2023,1,high,102020,Presencial,5.58,1,Hombre,Portal Web,7,1049000,57.0,70,Casado,29,2016,4,low,3.995,0,4,643394,-2469,1,-9
100876,102096,1,Presencial,1.935,3,Mujer,Linkedin,5,829120,91.0,72,Soltero,39,2020,4,high,102116,Presencial,5.11,8,Mujer,Linkedin,13,1461470,90.0,74,Soltero,42,2021,5,high,3.1750000000000003,5,8,632350,379,0,3
100988,102049,1,Presencial,1.64,1,Mujer,Ferias & Networking,12,489218,86.0,74,Casado,34,2014,12,high,102029,Presencial,6.89,0,Mujer,Portal Web,9,1616000,19.0,77,Divorciado,49,2023,3,low,5.25,-1,-3,1126782,3003,0,15
100909,102100,1,Presencial,1.53,0,Mujer,Headhunter,11,284211,98.0,74,Casado,43,2019,2,high,102007,Presencial,3.3,1,Mujer,Portal Web,3,1255430,21.0,59,Casado,30,2013,2,low,1.7699999999999998,1,-8,971219,-2209,1,-13
100069,102074,1,Presencial,1.72,2,Hombre,Portal Web,14,277795,90.0,86,Casado,41,2018,4,high,102028,Presencial,1.35,0,Hombre,Ferias & Networking,4,1616000,80.0,83,Viudo,43,2015,12,high,-0.3699999999999999,-2,-10,1338205,-827,1,2
102501,102096,1,Presencial,1.96,3,Mujer,Linkedin,5,829523,87.0,72,Soltero,39,2020,4,high,102116,Presencial,5.11,8,Mujer,Linkedin,13,1461470,90.0,74,Soltero,42,2021,5,high,3.1500000000000004,5,8,631947,381,0,3
103451,102030,1,Presencial,1.93,2,Hombre,Portal Web,6,758197,89.0,79,Soltero,43,2013,11,high,102058,Presencial,6.34,0,Mujer,Referidos,14,1616000,90.0,76,Viudo,41,2015,4,high,4.41,-2,8,857803,525,0,-2
103250,102007,1,Presencial,5.04,5,Mujer,Portal Web,5,678275,83.0,88,Divorciado,42,2012,9,high,102070,Presencial,5.11,2,Mujer,Portal Web,6,1358450,96.0,62,Soltero,41,2022,4,high,0.07000000000000028,-3,1,680175,3501,0,-1
101335,102141,1,Presencial,3.1,2,Hombre,Ferias & Networking,3,512138,96.0,75,Casado,42,2022,4,high,102134,Presencial,1.88,1,Mujer,Linkedin,3,1100900,64.0,69,Soltero,32,2018,5,low,-1.2200000000000002,-1,0,588762,-1418,1,-10
100941,102130,1,Presencial,4.075,10,Hombre,Portal Web,8,266869,84.0,68,Casado,42,2020,9,high,102068,Presencial,1.97,6,Hombre,Linkedin,5,1616000,84.0,73,Soltero,31,2014,4,high,-2.1050000000000004,-4,-3,1349131,-2336,1,-11
101641,102063,1,Presencial,1.68,3,Mujer,Portal Web,15,640218,84.0,71,Viudo,44,2017,4,high,102135,Presencial,2.73,0,Mujer,Linkedin,1,539000,26.0,75,Soltero,24,2021,4,low,1.05,-3,-14,-101218,1465,0,-20
100771,102030,1,Presencial,8.11,1,Hombre,Ferias & Networking,8,675162,90.0,82,Soltero,42,2013,10,high,102058,Presencial,6.34,0,Mujer,Referidos,14,1616000,90.0,76,Viudo,41,2015,4,high,-1.7699999999999996,-1,6,940838,557,0,-1
103886,102077,1,Presencial,1.555,3,Hombre,Portal Web,8,247272,90.0,78,Soltero,24,2016,12,high,102146,Presencial,2.27,0,Hombre,Ferias & Networking,11,1306940,31.0,64,Soltero,39,2021,6,low,0.7150000000000001,-3,3,1059668,1661,0,15
103407,102141,1,Presencial,3.135,2,Hombre,Ferias & Networking,3,509216,84.0,75,Casado,43,2022,4,high,102134,Presencial,1.88,1,Mujer,Linkedin,3,1100900,64.0,69,Soltero,32,2018,5,low,-1.255,-1,0,591684,-1418,1,-11
103958,102007,1,Presencial,6.01,7,Hombre,Portal Web,9,268659,96.0,82,Soltero,34,2012,2,high,102070,Presencial,5.11,2,Mujer,Portal Web,6,1358450,96.0,62,Soltero,41,2022,4,high,-0.8999999999999995,-5,-3,1089791,3711,0,7
103056,102051,1,Presencial,1.95,1,Hombre,Portal Web,9,280623,94.0,75,Soltero,36,2013,4,high,102075,Híbrida,1.39,1,Hombre,Portal Web,11,1616000,83.0,76,Casado,46,2019,11,high,-0.56,0,2,1335377,2410,0,10
102611,102063,1,Presencial,1.66,2,Mujer,Portal Web,15,639862,90.0,71,Viudo,44,2017,4,high,102135,Presencial,2.73,0,Mujer,Linkedin,1,539000,26.0,75,Soltero,24,2021,4,low,1.07,-2,-14,-100862,1466,0,-20
102212,102069,1,Presencial,1.485,2,Mujer,Referidos,5,674922,92.0,79,Casado,44,2015,2,high,102069,Presencial,4.64,1,Mujer,Ferias & Networking,19,1616000,47.0,74,Casado,60,2021,10,low,3.1549999999999994,-1,14,941078,2432,0,16
102966,102067,1,Presencial,3.93,2,Hombre,Portal Web,8,819437,88.0,65,Viudo,43,2014,10,high,102058,Presencial,0.92,1,Mujer,Portal Web,5,1616000,90.0,70,Divorciado,46,2020,8,high,-3.0100000000000002,-1,-3,796563,2140,0,3
100587,102067,1,Presencial,3.965,2,Hombre,Portal Web,8,822117,89.0,65,Viudo,43,2014,10,high,102058,Presencial,0.92,1,Mujer,Portal Web,5,1616000,90.0,70,Divorciado,46,2020,8,high,-3.045,-1,-3,793883,2141,0,3
101672,102069,1,Presencial,1.48,2,Mujer,Referidos,5,674425,95.0,79,Casado,44,2015,2,high,102069,Presencial,4.64,1,Mujer,Ferias & Networking,19,1616000,47.0,74,Casado,60,2021,10,low,3.1599999999999997,-1,14,941575,2431,0,16
102278,102025,1,Presencial,4.335,3,Hombre,Ferias & Networking,6,246938,89.0,77,Casado,20,2012,12,high,102132,Presencial,1.6,0,Hombre,Portal Web,9,1616000,90.0,81,Viudo,56,2018,4,high,-2.735,-3,3,1369062,1946,0,36
103632,102130,1,Presencial,4.055,10,Hombre,Portal Web,8,270389,82.0,68,Casado,42,2020,9,high,102068,Presencial,1.97,6,Hombre,Linkedin,5,1616000,84.0,73,Soltero,31,2014,4,high,-2.085,-4,-3,1345611,-2337,1,-11
100542,102029,1,Presencial,3.27,3,Mujer,Linkedin,2,143382,91.0,82,Soltero,12,2012,12,high,102132,Presencial,5.79,2,Hombre,Portal Web,16,1616000,80.0,84,Casado,49,2017,9,high,2.52,-1,14,1472618,1738,0,37
101274,102129,1,Presencial,4.47,4,Hombre,Portal Web,2,253108,98.0,78,Soltero,28,2021,10,high,102142,Presencial,2.1,2,Mujer,Linkedin,3,590000,41.0,74,Soltero,24,2020,1,low,-2.3699999999999997,-2,1,336892,-639,1,-4
100728,102050,1,Presencial,3.335,1,Mujer,Portal Web,3,390279,98.0,75,Soltero,27,2013,7,high,102069,Presencial,3.7,0,Mujer,Linkedin,11,1512980,90.0,88,Soltero,40,2017,10,high,0.3650000000000002,-1,8,1122701,1533,0,13
102643,102136,1,Presencial,3.14,2,Hombre,Referidos,1,100689,89.0,78,Soltero,18,2020,5,high,102034,Presencial,1.78,2,Hombre,Portal Web,3,1616000,89.0,78,Casado,35,2013,1,high,-1.36,0,2,1515311,-2683,1,17
102769,102050,1,Presencial,3.35,1,Mujer,Portal Web,3,389484,83.0,75,Soltero,27,2013,7,high,102069,Presencial,3.7,0,Mujer,Linkedin,11,1512980,90.0,88,Soltero,40,2017,10,high,0.3500000000000001,-1,8,1123496,1536,0,13
103820,102062,1,Presencial,5.41,2,Hombre,Linkedin,3,486742,84.0,77,Divorciado,36,2017,5,high,102149,Presencial,0.92,2,Mujer,Referidos,6,692000,38.0,72,Soltero,21,2014,10,low,-4.49,0,3,205258,-944,1,-15
100980,102065,1,Presencial,3.685,7,Hombre,Linkedin,3,390474,81.0,80,Divorciado,31,2017,1,high,102026,Presencial,2.44,2,Hombre,Ferias & Networking,13,1616000,45.0,60,Divorciado,35,2014,10,low,-1.245,-5,10,1225526,-844,1,4
100388,102136,1,Presencial,4.015,1,Mujer,Headhunter,3,471808,81.0,77,Casado,40,2021,6,high,102034,Presencial,1.78,2,Hombre,Portal Web,3,1616000,89.0,78,Casado,35,2013,1,high,-2.2349999999999994,1,0,1144192,-3073,1,-5
103516,102136,1,Presencial,4.03,1,Mujer,Headhunter,3,467505,89.0,77,Casado,40,2021,6,high,102034,Presencial,1.78,2,Hombre,Portal Web,3,1616000,89.0,78,Casado,35,2013,1,high,-2.25,1,0,1148495,-3073,1,-5
103460,102015,1,Presencial,1.5,1,Hombre,Linkedin,12,512305,85.0,84,Casado,33,2012,11,high,102121,Presencial,6.18,1,Mujer,Referidos,10,1358450,74.0,82,Soltero,33,2014,6,low,4.68,0,-2,846145,575,0,0
101854,102037,1,Presencial,3.43,1,Mujer,Portal Web,4,206319,87.0,76,Casado,16,2012,4,high,102057,Presencial,1.12,1,Mujer,Linkedin,2,641000,50.0,76,Casado,21,2016,12,low,-2.31,0,-2,434681,1700,0,5
101169,102015,1,Presencial,1.495,1,Hombre,Linkedin,12,504558,98.0,84,Casado,32,2012,11,high,102121,Presencial,6.18,1,Mujer,Referidos,10,1358450,74.0,82,Soltero,33,2014,6,low,4.685,0,-2,853892,572,0,1
102127,102028,2,Presencial,4.03,2,Mujer,Linkedin,9,1306940,88.0,78,Divorciado,32,2014,5,high,102085,Presencial,1.39,2,Mujer,Linkedin,12,1358450,97.0,72,Soltero,35,2016,12,high,-2.6400000000000006,0,3,51510,949,0,3
101988,102028,1,Presencial,2.075,2,Hombre,Portal Web,4,276849,82.0,82,Soltero,37,2013,4,high,102085,Presencial,1.39,2,Mujer,Linkedin,12,1358450,97.0,72,Soltero,35,2016,12,high,-0.6850000000000003,0,8,1081601,1343,0,-2
102218,102037,1,Presencial,3.435,2,Mujer,Portal Web,4,201128,94.0,76,Casado,16,2012,4,high,102057,Presencial,1.12,1,Mujer,Linkedin,2,641000,50.0,76,Casado,21,2016,12,low,-2.315,-1,-2,439872,1700,0,5
102473,102144,1,Presencial,3.215,0,Mujer,Linkedin,5,425517,95.0,75,Casado,46,2022,10,high,102156,Presencial,2.13,8,Mujer,Portal Web,11,1616000,5.0,82,Viudo,58,2015,6,low,-1.085,8,6,1190483,-2659,1,12
100848,102044,1,Presencial,1.945,2,Hombre,Referidos,3,653783,87.0,86,Casado,43,2015,2,high,102155,Presencial,1.54,1,Hombre,Ferias & Networking,14,1616000,56.0,68,Soltero,47,2023,3,low,-0.405,-1,11,962217,2963,0,4
102054,102044,2,Presencial,2.91,1,Hombre,Linkedin,17,1616000,85.0,74,Divorciado,41,2012,11,high,102155,Presencial,1.54,1,Hombre,Ferias & Networking,14,1616000,56.0,68,Soltero,47,2023,3,low,-1.37,0,-3,0,3788,0,6
102695,102044,1,Presencial,1.95,2,Hombre,Referidos,3,658682,81.0,86,Casado,43,2015,2,high,102155,Presencial,1.54,1,Hombre,Ferias & Networking,14,1616000,56.0,68,Soltero,47,2023,3,low,-0.4099999999999999,-1,11,957318,2965,0,4
101039,102154,1,Presencial,1.16,1,Hombre,Portal Web,6,739483,82.0,77,Divorciado,55,2023,5,high,102172,Presencial,5.45,1,Hombre,Portal Web,7,1512980,93.0,69,Soltero,39,2017,10,high,4.29,0,1,773497,-2038,1,-16
101729,102089,1,Presencial,1.85,1,Mujer,Referidos,8,288676,86.0,81,Casado,26,2016,8,high,102077,Presencial,2.75,1,Hombre,Ferias & Networking,6,1616000,96.0,69,Divorciado,60,2021,10,high,0.8999999999999999,0,-2,1327324,1889,0,34
100114,102077,1,Presencial,1.71,1,Mujer,Ferias & Networking,1,146775,92.0,63,Soltero,18,2017,9,high,102146,Presencial,2.27,0,Hombre,Ferias & Networking,11,1306940,31.0,64,Soltero,39,2021,6,low,0.56,-1,10,1160165,1382,0,21
103966,102077,1,Presencial,1.735,1,Mujer,Ferias & Networking,1,146460,98.0,63,Soltero,18,2017,9,high,102146,Presencial,2.27,0,Hombre,Ferias & Networking,11,1306940,31.0,64,Soltero,39,2021,6,low,0.5349999999999999,-1,10,1160480,1380,0,21
101513,102157,1,Presencial,4.74,2,Mujer,Linkedin,12,718690,84.0,81,Soltero,53,2022,6,high,102130,Presencial,0.73,1,Mujer,Portal Web,6,1616000,85.0,66,Viudo,44,2015,8,high,-4.01,-1,-6,897310,-2494,1,-9
102964,102109,1,Presencial,2.46,0,Mujer,Portal Web,18,716730,96.0,75,Viudo,52,2021,4,high,102123,Presencial,3.86,1,Mujer,Portal Web,5,998000,97.0,82,Casado,32,2019,9,high,1.4,1,-13,281270,-569,1,-20
100349,102162,1,Presencial,5.91,6,Mujer,Portal Web,1,78566,80.0,76,Soltero,20,2023,10,high,102146,Presencial,1.12,0,Mujer,Referidos,9,1616000,31.0,74,Casado,41,2022,11,low,-4.79,-6,8,1537434,-324,1,21
101714,102154,1,Presencial,3.96,3,Mujer,Portal Web,2,137930,86.0,64,Soltero,23,2023,9,high,102172,Presencial,5.45,1,Hombre,Portal Web,7,1512980,93.0,69,Soltero,39,2017,10,high,1.4900000000000002,-2,5,1375050,-2159,1,16
100842,102135,1,Presencial,1.77,11,Hombre,Linkedin,3,138489,81.0,78,Soltero,24,2023,8,high,102028,Presencial,2.04,1,Hombre,Portal Web,2,1616000,82.0,75,Divorciado,49,2017,10,high,0.27,-10,-1,1477511,-2124,1,25
100101,102171,1,Presencial,6.275,6,Hombre,Portal Web,4,162042,86.0,69,Soltero,26,2023,9,high,102088,Presencial,2.57,4,Hombre,Linkedin,8,1616000,80.0,69,Casado,43,2017,10,high,-3.7050000000000005,-2,4,1453958,-2172,1,17
100385,102171,1,Presencial,2.82,12,Mujer,Portal Web,4,184788,96.0,69,Casado,26,2023,7,high,102088,Presencial,2.57,4,Hombre,Linkedin,8,1616000,80.0,69,Casado,43,2017,10,high,-0.25,-8,4,1431212,-2096,1,17
101930,102142,1,Presencial,2.65,1,Hombre,Portal Web,1,205952,98.0,71,Casado,29,2023,11,high,102047,Presencial,2.48,2,Hombre,Portal Web,3,1255430,90.0,66,Soltero,36,2019,7,high,-0.16999999999999993,1,2,1049478,-1599,1,7
100854,102142,1,Presencial,1.795,1,Mujer,Linkedin,3,227327,82.0,77,Soltero,29,2023,11,high,102047,Presencial,2.48,2,Hombre,Portal Web,3,1255430,90.0,66,Soltero,36,2019,7,high,0.685,1,0,1028103,-1600,1,7
100368,102172,1,Presencial,5.25,7,Mujer,Portal Web,5,228406,80.0,70,Casado,30,2023,8,high,102020,Presencial,5.58,1,Hombre,Portal Web,7,1049000,57.0,70,Casado,29,2016,4,low,0.33000000000000007,-6,2,820594,-2679,1,-1
101149,102170,1,Presencial,3.185,0,Hombre,Linkedin,1,246055,84.0,79,Soltero,31,2023,8,high,102055,Presencial,1.62,0,Mujer,Portal Web,8,1616000,78.0,72,Viudo,48,2013,2,low,-1.565,0,7,1369945,-3827,1,17
100088,102150,1,Presencial,1.985,2,Hombre,Portal Web,5,293544,87.0,66,Casado,32,2023,8,high,102085,Presencial,3.9,8,Mujer,Portal Web,10,1358450,85.0,75,Casado,32,2012,12,high,1.9149999999999998,6,5,1064906,-3903,1,0
101929,102142,1,Presencial,3.885,3,Hombre,Portal Web,2,307230,92.0,78,Casado,34,2023,12,high,102047,Presencial,2.48,2,Hombre,Portal Web,3,1255430,90.0,66,Soltero,36,2019,7,high,-1.4049999999999998,-1,1,948200,-1629,1,2
101553,102169,1,Presencial,1.865,2,Hombre,Referidos,3,307517,97.0,84,Soltero,34,2023,12,high,102115,Presencial,2.24,7,Mujer,Linkedin,11,1616000,93.0,74,Soltero,55,2021,4,high,0.3750000000000002,5,8,1308483,-989,1,21
100168,102162,1,Presencial,3.295,3,Hombre,Referidos,2,352914,86.0,83,Casado,35,2023,10,high,102146,Presencial,1.12,0,Mujer,Referidos,9,1616000,31.0,74,Casado,41,2022,11,low,-2.175,-3,7,1263086,-322,1,6
101902,102165,1,Presencial,4.035,1,Hombre,Portal Web,10,404855,87.0,83,Casado,39,2023,9,high,102132,Presencial,1.99,2,Hombre,Portal Web,10,1616000,90.0,82,Viudo,60,2023,1,high,-2.045,1,0,1211145,-228,1,21
101945,102171,1,Presencial,1.44,1,Mujer,Headhunter,11,407545,84.0,85,Soltero,38,2023,8,high,102088,Presencial,2.57,4,Hombre,Linkedin,8,1616000,80.0,69,Casado,43,2017,10,high,1.13,3,-3,1208455,-2153,1,5
100024,102158,1,Presencial,0.85,3,Hombre,Portal Web,6,424966,87.0,74,Casado,40,2023,9,high,102093,Presencial,1.79,1,Mujer,Referidos,27,1900000,87.0,74,Viudo,54,2013,9,high,0.9400000000000001,-2,21,1475034,-3640,1,14
101867,102171,1,Presencial,1.86,7,Mujer,Linkedin,10,487421,80.0,75,Soltero,43,2023,9,high,102088,Presencial,2.57,4,Hombre,Linkedin,8,1616000,80.0,69,Casado,43,2017,10,high,0.7099999999999997,-3,-2,1128579,-2177,1,0
101136,102172,1,Presencial,6.155,3,Mujer,Referidos,9,888997,89.0,79,Casado,43,2023,9,high,102020,Presencial,5.58,1,Hombre,Portal Web,7,1049000,57.0,70,Casado,29,2016,4,low,-0.5750000000000002,-2,-2,160003,-2701,1,-14
102118,102171,2,Presencial,4.76,17,Mujer,Linkedin,4,1616000,86.0,74,Soltero,39,2023,8,high,102088,Presencial,2.57,4,Hombre,Linkedin,8,1616000,80.0,69,Casado,43,2017,10,high,-2.19,-13,4,0,-2149,1,4
101770,102171,1,Presencial,1.65,1,Hombre,Portal Web,5,381314,95.0,74,Casado,46,2023,10,high,102088,Presencial,2.57,4,Hombre,Linkedin,8,1616000,80.0,69,Casado,43,2017,10,high,0.9199999999999999,3,3,1234686,-2214,1,-3
101405,102172,1,Presencial,1.99,0,Hombre,Portal Web,3,272212,81.0,79,Casado,46,2023,7,high,102020,Presencial,5.58,1,Hombre,Portal Web,7,1049000,57.0,70,Casado,29,2016,4,low,3.59,1,4,776788,-2627,1,-17
100109,102147,1,Presencial,1.86,1,Mujer,Ferias & Networking,12,279346,94.0,75,Soltero,47,2023,11,high,102057,Presencial,1.58,2,Hombre,Portal Web,4,1616000,90.0,80,Casado,49,2022,12,high,-0.28,1,-8,1336654,-314,1,2
100355,102157,1,Presencial,1.855,2,Hombre,Linkedin,8,298691,97.0,69,Casado,49,2023,8,high,102130,Presencial,0.73,1,Mujer,Portal Web,6,1616000,85.0,66,Viudo,44,2015,8,high,-1.125,-1,-2,1317309,-2923,1,-5
100940,102143,1,Presencial,2.43,0,Mujer,Referidos,7,425192,98.0,75,Casado,50,2023,10,high,102142,Presencial,1.07,2,Hombre,Portal Web,2,590000,90.0,78,Casado,25,2022,2,high,-1.36,2,-5,164808,-614,1,-25
101679,102141,1,Presencial,5.68,3,Hombre,Portal Web,6,800918,89.0,80,Casado,52,2023,9,high,102134,Presencial,1.88,1,Mujer,Linkedin,3,1100900,64.0,69,Soltero,32,2018,5,low,-3.8,-2,-3,299982,-1925,1,-20
102002,102144,2,Presencial,2.16,12,Hombre,Linkedin,10,1616000,97.0,69,Divorciado,48,2023,9,high,102156,Presencial,2.13,8,Mujer,Portal Web,11,1616000,5.0,82,Viudo,58,2015,6,low,-0.03000000000000025,-4,1,0,-2997,1,10
101646,102144,1,Presencial,4.0,0,Hombre,Portal Web,7,873149,81.0,69,Soltero,53,2023,9,high,102156,Presencial,2.13,8,Mujer,Portal Web,11,1616000,5.0,82,Viudo,58,2015,6,low,-1.87,8,4,742851,-2996,1,5
100261,102152,1,Presencial,7.105,2,Mujer,Linkedin,8,720776,86.0,75,Soltero,55,2023,11,high,102089,Presencial,2.75,5,Hombre,Portal Web,7,1616000,15.0,68,Soltero,47,2019,8,low,-4.355,3,-1,895224,-1529,1,-8
102084,102171,2,Presencial,2.62,3,Mujer,Portal Web,14,1616000,89.0,76,Divorciado,50,2023,7,high,102088,Presencial,2.57,4,Hombre,Linkedin,8,1616000,80.0,69,Casado,43,2017,10,high,-0.050000000000000266,1,-6,0,-2117,1,-7
102071,102171,2,Presencial,0.87,1,Hombre,Portal Web,11,1616000,85.0,72,Viudo,51,2023,11,high,102088,Presencial,2.57,4,Hombre,Linkedin,8,1616000,80.0,69,Casado,43,2017,10,high,1.6999999999999997,3,-3,0,-2229,1,-8
102045,102171,2,Presencial,3.19,3,Hombre,Portal Web,11,1616000,97.0,65,Casado,53,2023,9,high,102088,Presencial,2.57,4,Hombre,Linkedin,8,1616000,80.0,69,Casado,43,2017,10,high,-0.6200000000000001,1,-3,0,-2183,1,-10
102066,102171,2,Presencial,3.62,3,Hombre,Referidos,5,1616000,97.0,84,Casado,55,2023,12,high,102088,Presencial,2.57,4,Hombre,Linkedin,8,1616000,80.0,69,Casado,43,2017,10,high,-1.0500000000000003,1,3,0,-2254,1,-12
100462,102171,1,Presencial,2.675,2,Mujer,Referidos,18,899631,83.0,82,Casado,60,2023,8,high,102088,Presencial,2.57,4,Hombre,Linkedin,8,1616000,80.0,69,Casado,43,2017,10,high,-0.10499999999999998,2,-10,716369,-2149,1,-17
102156,102154,2,Presencial,4.23,2,Hombre,Portal Web,22,1616000,92.0,76,Soltero,63,2023,12,high,102172,Presencial,5.45,1,Hombre,Portal Web,7,1512980,93.0,69,Soltero,39,2017,10,high,1.2199999999999998,-1,-15,-103020,-2265,1,-24
104060,102154,1,Presencial,3.975,3,Mujer,Portal Web,2,143225,98.0,64,Soltero,23,2023,9,high,102172,Presencial,5.45,1,Hombre,Portal Web,7,1512980,93.0,69,Soltero,39,2017,10,high,1.475,-2,5,1369755,-2160,1,16
103028,102135,1,Presencial,1.765,10,Hombre,Linkedin,3,136659,94.0,78,Soltero,24,2023,8,high,102028,Presencial,2.04,1,Hombre,Portal Web,2,1616000,82.0,75,Divorciado,49,2017,10,high,0.27500000000000013,-9,-1,1479341,-2127,1,25
102828,102150,1,Presencial,2.55,3,Mujer,Linkedin,2,163644,91.0,76,Soltero,24,2023,7,high,102085,Presencial,3.9,8,Mujer,Portal Web,10,1358450,85.0,75,Casado,32,2012,12,high,1.35,5,8,1194806,-3865,1,8
104056,102167,1,Presencial,1.97,2,Mujer,Portal Web,2,162075,92.0,67,Soltero,26,2023,9,high,102092,Presencial,5.7,2,Hombre,Ferias & Networking,2,794000,59.0,64,Casado,27,2019,3,low,3.7300000000000004,0,0,631925,-1639,1,1
103821,102136,1,Presencial,5.63,6,Hombre,Linkedin,1,188328,93.0,76,Soltero,26,2023,7,high,102034,Presencial,1.78,2,Hombre,Portal Web,3,1616000,89.0,78,Casado,35,2013,1,high,-3.8499999999999996,-4,2,1427672,-3843,1,9
103790,102142,1,Presencial,1.79,2,Mujer,Linkedin,3,226542,84.0,77,Soltero,29,2023,11,high,102047,Presencial,2.48,2,Hombre,Portal Web,3,1255430,90.0,66,Soltero,36,2019,7,high,0.69,0,0,1028888,-1599,1,7
103389,102172,1,Presencial,5.24,8,Mujer,Portal Web,5,230498,97.0,70,Casado,30,2023,8,high,102020,Presencial,5.58,1,Hombre,Portal Web,7,1049000,57.0,70,Casado,29,2016,4,low,0.33999999999999986,-7,2,818502,-2678,1,-1
102585,102142,1,Presencial,3.9,3,Hombre,Portal Web,2,313355,91.0,78,Casado,34,2023,12,high,102047,Presencial,2.48,2,Hombre,Portal Web,3,1255430,90.0,66,Soltero,36,2019,7,high,-1.42,-1,1,942075,-1627,1,2
104086,102169,1,Presencial,1.895,2,Hombre,Referidos,3,313049,96.0,84,Soltero,34,2023,12,high,102115,Presencial,2.24,7,Mujer,Linkedin,11,1616000,93.0,74,Soltero,55,2021,4,high,0.3450000000000002,5,8,1302951,-990,1,21
102778,102139,1,Presencial,6.45,4,Hombre,Linkedin,4,411337,80.0,77,Casado,38,2023,9,high,102154,Presencial,6.48,1,Hombre,Ferias & Networking,5,590000,90.0,67,Casado,25,2021,6,high,0.03000000000000025,-3,1,178663,-831,1,-13
102432,102165,1,Presencial,4.005,2,Hombre,Linkedin,10,411363,96.0,83,Casado,39,2023,9,high,102132,Presencial,1.99,2,Hombre,Portal Web,10,1616000,90.0,82,Viudo,60,2023,1,high,-2.0149999999999997,0,0,1204637,-230,1,21
102990,102172,1,Presencial,6.13,4,Mujer,Referidos,9,890608,91.0,79,Casado,43,2023,9,high,102020,Presencial,5.58,1,Hombre,Portal Web,7,1049000,57.0,70,Casado,29,2016,4,low,-0.5499999999999998,-3,-2,158392,-2701,1,-14
102423,102171,1,Presencial,1.605,2,Hombre,Portal Web,5,378845,93.0,74,Soltero,46,2023,10,high,102088,Presencial,2.57,4,Hombre,Linkedin,8,1616000,80.0,69,Casado,43,2017,10,high,0.9649999999999999,2,3,1237155,-2211,1,-3
103289,102147,1,Presencial,1.885,1,Mujer,Ferias & Networking,12,274387,84.0,75,Soltero,47,2023,11,high,102057,Presencial,1.58,2,Hombre,Portal Web,4,1616000,90.0,80,Casado,49,2022,12,high,-0.30499999999999994,1,-8,1341613,-316,1,2
102386,102171,1,Presencial,1.18,1,Hombre,Referidos,11,286394,97.0,74,Divorciado,48,2023,10,high,102088,Presencial,2.57,4,Hombre,Linkedin,8,1616000,80.0,69,Casado,43,2017,10,high,1.39,3,-3,1329606,-2214,1,-5
103154,102171,1,Presencial,5.915,3,Hombre,Linkedin,5,308396,90.0,77,Divorciado,49,2023,8,high,102088,Presencial,2.57,4,Hombre,Linkedin,8,1616000,80.0,69,Casado,43,2017,10,high,-3.345,1,3,1307604,-2151,1,-6
103727,102157,1,Presencial,1.82,2,Hombre,Linkedin,8,297922,97.0,69,Casado,49,2023,8,high,102130,Presencial,0.73,1,Mujer,Portal Web,6,1616000,85.0,66,Viudo,44,2015,8,high,-1.09,-1,-2,1318078,-2922,1,-5
103332,102143,1,Presencial,2.43,1,Mujer,Referidos,7,424714,92.0,75,Viudo,50,2023,10,high,102142,Presencial,1.07,2,Hombre,Portal Web,2,590000,90.0,78,Casado,25,2022,2,high,-1.36,1,-5,165286,-615,1,-25
103839,102139,1,Presencial,3.42,4,Mujer,Portal Web,3,642391,98.0,71,Casado,50,2023,7,high,102154,Presencial,6.48,1,Hombre,Ferias & Networking,5,590000,90.0,67,Casado,25,2021,6,high,3.0600000000000005,-3,2,-52391,-749,1,-25
103755,102161,1,Presencial,2.995,2,Mujer,Portal Web,16,700814,90.0,69,Soltero,53,2023,11,high,102039,Presencial,3.93,5,Mujer,Portal Web,4,1409960,85.0,77,Casado,36,2016,10,high,0.935,3,-12,709146,-2582,1,-17
103976,102171,1,Presencial,2.775,0,Mujer,Portal Web,5,677071,93.0,66,Divorciado,53,2023,9,high,102088,Presencial,2.57,4,Hombre,Linkedin,8,1616000,80.0,69,Casado,43,2017,10,high,-0.20500000000000007,4,3,938929,-2181,1,-10
104115,102144,1,Presencial,3.99,1,Hombre,Portal Web,7,876285,84.0,69,Soltero,53,2023,9,high,102156,Presencial,2.13,8,Mujer,Portal Web,11,1616000,5.0,82,Viudo,58,2015,6,low,-1.8600000000000003,7,4,739715,-2996,1,5
103920,102152,1,Presencial,7.1,1,Mujer,Linkedin,8,719102,91.0,75,Soltero,55,2023,11,high,102089,Presencial,2.75,5,Hombre,Portal Web,7,1616000,15.0,68,Soltero,47,2019,8,low,-4.35,4,-1,896898,-1530,1,-8
103151,102171,1,Presencial,2.695,3,Mujer,Referidos,18,898994,89.0,82,Casado,60,2023,8,high,102088,Presencial,2.57,4,Hombre,Linkedin,8,1616000,80.0,69,Casado,43,2017,10,high,-0.125,1,-10,717006,-2150,1,-17
