id_employee_employee,id_last_boss_employee,seniority_employee,work_modality_employee,office_distance_employee,low_health_days_employee,gender_employee,recruitment_channel_employee,average_permanence_employee,salary_employee,performance_score_employee,psi_score_employee,marital_estatus_employee,join_age_employee,join_year_employee,join_month_employee,performance_employee,id_last_boss_boss,work_modality_boss,office_distance_boss,low_health_days_boss,gender_boss,recruitment_channel_boss,average_permanence_boss,salary_boss,performance_score_boss,psi_score_boss,marital_estatus_boss,join_age_boss,join_year_boss,join_month_boss,performance_boss,office_distance_diff,low_health_days_diff,average_permanence_diff,salary_diff,join_days_diff,joined_after_boss,age_diff,resign
100247,102074,1,Híbrida,1.76,1,Mujer,Ferias & Networking,1,140011,99.0,75,Soltero,18,2018,1,high,102028,Presencial,1.35,0,Hombre,Ferias & Networking,4,1616000,80.0,83,Viudo,43,2015,12,high,-0.4099999999999999,-1,3,1475989,-757,1,25,0
103355,102115,1,Híbrida,0.76,2,Hombre,Ferias & Networking,2,182774,99.0,81,Soltero,24,2021,7,high,102116,Presencial,2.0,2,Mujer,Portal Web,4,1616000,94.0,76,Soltero,35,2018,12,high,1.24,0,2,1433226,-940,1,11,1
100669,102060,1,Híbrida,4.95,3,Mujer,Referidos,11,682106,96.0,74,Viudo,45,2016,7,high,102041,Presencial,4.42,3,Hombre,Referidos,16,1616000,82.0,62,Casado,45,2013,10,high,-0.5300000000000002,0,5,933894,-990,1,0,0
103760,102062,1,Híbrida,13.03,2,Hombre,Linkedin,2,270232,96.0,82,Soltero,22,2014,7,high,102149,Presencial,0.92,2,Mujer,Referidos,6,692000,38.0,72,Soltero,21,2014,10,low,-12.11,0,4,421768,72,0,-1,1
100965,102062,1,Híbrida,13.045,2,Hombre,Linkedin,2,266804,95.0,82,Soltero,22,2014,7,high,102149,Presencial,0.92,2,Mujer,Referidos,6,692000,38.0,72,Soltero,21,2014,10,low,-12.125,0,4,425196,71,0,-1,0
101777,102078,1,Híbrida,0.94,2,Mujer,Portal Web,3,366317,95.0,70,Soltero,30,2017,3,high,102143,Presencial,2.17,1,Hombre,Ferias & Networking,9,998000,83.0,76,Casado,29,2017,5,high,1.23,-1,6,631683,55,0,-1,1
101793,102150,1,Híbrida,2.35,2,Hombre,Portal Web,6,407557,95.0,69,Soltero,37,2022,4,high,102085,Presencial,3.9,8,Mujer,Portal Web,10,1358450,85.0,75,Casado,32,2012,12,high,1.5499999999999998,6,4,950893,-3414,1,-5,1
101302,102088,1,Híbrida,2.095,1,Mujer,Portal Web,4,851731,95.0,75,Soltero,36,2018,3,high,102139,Presencial,4.96,1,Mujer,Portal Web,3,488000,82.0,65,Soltero,20,2018,4,high,2.8649999999999998,0,-1,-363731,23,0,-16,0
102687,102088,1,Híbrida,2.13,2,Mujer,Portal Web,4,849922,95.0,75,Soltero,36,2018,3,high,102139,Presencial,4.96,1,Mujer,Portal Web,3,488000,82.0,65,Soltero,20,2018,4,high,2.83,-1,-1,-361922,20,0,-16,0
100846,102172,1,Híbrida,1.535,1,Hombre,Linkedin,25,836766,93.0,86,Divorciado,53,2023,3,high,102020,Presencial,5.58,1,Hombre,Portal Web,7,1049000,57.0,70,Casado,29,2016,4,low,4.045,0,-18,212234,-2521,1,-24,0
104000,102061,1,Híbrida,5.21,8,Mujer,Linkedin,10,678511,93.0,87,Divorciado,45,2016,7,high,102115,Presencial,2.14,2,Hombre,Ferias & Networking,10,1203920,37.0,80,Casado,29,2012,11,low,-3.07,-6,0,525409,-1343,1,-16,1
103983,102140,1,Híbrida,4.335,10,Hombre,Portal Web,9,859108,93.0,75,Viudo,54,2022,8,high,102040,Presencial,2.55,0,Mujer,Portal Web,16,1616000,46.0,69,Casado,39,2012,2,low,-1.7850000000000001,-10,7,756892,-3850,1,-15,1
101482,102070,1,Híbrida,1.545,3,Hombre,Ferias & Networking,2,230871,92.0,76,Soltero,23,2017,2,high,102035,Presencial,1.7,1,Mujer,Referidos,4,1616000,77.0,73,Viudo,38,2013,3,low,0.15500000000000003,-2,2,1385129,-1450,1,15,0
102481,102172,1,Híbrida,1.52,2,Hombre,Linkedin,25,835941,92.0,86,Divorciado,53,2023,3,high,102020,Presencial,5.58,1,Hombre,Portal Web,7,1049000,57.0,70,Casado,29,2016,4,low,4.0600000000000005,-1,-18,213059,-2520,1,-24,0
101068,102161,1,Híbrida,1.1,2,Mujer,Linkedin,2,98281,91.0,74,Soltero,21,2023,3,high,102039,Presencial,3.93,5,Mujer,Portal Web,4,1409960,85.0,77,Casado,36,2016,10,high,2.83,3,2,1311679,-2332,1,15,0
101004,102026,1,Híbrida,1.865,5,Hombre,Portal Web,3,116069,91.0,76,Soltero,11,2012,7,high,102101,Presencial,2.7,1,Mujer,Portal Web,15,1616000,97.0,79,Casado,58,2017,6,high,0.8350000000000002,-4,12,1499931,1805,0,47,1
101846,102021,1,Híbrida,1.065,6,Mujer,Portal Web,1,117243,91.0,69,Soltero,13,2013,6,high,102069,Presencial,2.25,1,Hombre,Linkedin,8,1616000,47.0,80,Casado,52,2017,3,low,1.185,-5,7,1498757,1383,0,39,1
100452,102133,1,Híbrida,5.105,0,Mujer,Ferias & Networking,1,141964,91.0,77,Soltero,21,2020,12,high,102151,Híbrida,2.61,2,Hombre,Linkedin,4,1255430,98.0,65,Soltero,35,2018,2,high,-2.4950000000000006,2,3,1113466,-1008,1,14,0
100662,102132,1,Híbrida,3.415,1,Mujer,Portal Web,3,140486,91.0,85,Soltero,22,2021,4,high,102138,Presencial,4.51,1,Hombre,Linkedin,16,1616000,25.0,80,Viudo,45,2014,3,low,1.0949999999999998,0,13,1475514,-2597,1,23,1
100173,102105,1,Híbrida,1.44,3,Hombre,Portal Web,4,165504,91.0,64,Soltero,22,2020,7,high,102113,Híbrida,2.07,0,Hombre,Linkedin,8,1616000,85.0,71,Viudo,45,2017,3,high,0.6299999999999999,-3,4,1450496,-1198,1,23,0
101766,102142,1,Híbrida,3.13,6,Hombre,Portal Web,4,208877,91.0,74,Casado,28,2023,3,high,102047,Presencial,2.48,2,Hombre,Portal Web,3,1255430,90.0,66,Soltero,36,2019,7,high,-0.6499999999999999,-4,-1,1046553,-1357,1,8,0
101871,102153,1,Híbrida,2.37,1,Hombre,Portal Web,2,213892,91.0,73,Casado,27,2021,8,high,102143,Presencial,6.39,1,Mujer,Linkedin,5,1616000,90.0,68,Casado,41,2019,6,high,4.02,0,3,1402108,-806,1,14,0
100195,102065,1,Híbrida,2.135,2,Mujer,Portal Web,5,245440,91.0,77,Casado,23,2016,9,high,102026,Presencial,2.44,2,Hombre,Ferias & Networking,13,1616000,45.0,60,Divorciado,35,2014,10,low,0.30500000000000016,0,8,1370560,-720,1,12,1
100865,102102,1,Híbrida,1.47,2,Mujer,Referidos,7,266340,91.0,86,Divorciado,27,2019,10,high,102018,Presencial,2.48,0,Hombre,Portal Web,5,1616000,92.0,63,Viudo,49,2019,4,high,1.01,-2,-2,1349660,-167,1,22,0
101236,102025,1,Híbrida,4.69,3,Hombre,Portal Web,3,291412,91.0,76,Casado,22,2013,1,high,102132,Presencial,1.6,0,Hombre,Portal Web,9,1616000,90.0,81,Viudo,56,2018,4,high,-3.0900000000000003,-3,6,1324588,1910,0,34,0
101866,102090,1,Híbrida,3.715,1,Hombre,Linkedin,7,327254,91.0,89,Soltero,29,2018,11,high,102171,Presencial,6.83,0,Hombre,Linkedin,4,488000,92.0,76,Soltero,19,2017,2,high,3.115,-1,-3,160746,-641,1,-10,0
100142,102100,1,Híbrida,2.84,1,Mujer,Linkedin,6,309121,91.0,74,Casado,27,2017,6,high,102007,Presencial,3.3,1,Mujer,Portal Web,3,1255430,21.0,59,Casado,30,2013,2,low,0.45999999999999996,0,-3,946309,-1582,1,3,0
100750,102068,1,Híbrida,3.975,0,Mujer,Linkedin,4,306936,91.0,73,Soltero,27,2016,12,high,102043,Híbrida,2.17,3,Mujer,Referidos,4,896000,41.0,81,Soltero,23,2012,8,low,-1.8050000000000002,3,0,589064,-1562,1,-4,0
100055,102069,1,Híbrida,3.25,9,Mujer,Portal Web,5,310925,91.0,77,Divorciado,27,2016,10,high,102069,Presencial,4.64,1,Mujer,Ferias & Networking,19,1616000,47.0,74,Casado,60,2021,10,low,1.3899999999999997,-8,14,1305075,1831,0,33,0
100042,102091,1,Híbrida,0.75,2,Mujer,Portal Web,6,345283,91.0,73,Soltero,29,2017,2,high,102149,Presencial,1.54,1,Mujer,Portal Web,4,1616000,73.0,77,Casado,39,2014,12,low,0.79,-1,-2,1270717,-789,1,10,1
100730,102123,1,Híbrida,2.47,2,Mujer,Portal Web,6,344891,91.0,73,Viudo,32,2020,4,high,102043,Presencial,5.5,1,Mujer,Linkedin,16,1616000,42.0,66,Soltero,51,2021,9,low,3.03,-1,10,1271109,513,0,19,0
101926,102064,1,Híbrida,5.785,0,Hombre,Referidos,8,345740,91.0,73,Casado,27,2014,11,high,102067,Presencial,1.34,0,Hombre,Portal Web,6,1616000,92.0,92,Casado,43,2018,2,high,-4.445,0,-2,1270260,1178,0,16,0
101088,102040,1,Híbrida,1.165,1,Hombre,Portal Web,9,425196,91.0,81,Soltero,30,2014,2,high,102106,Presencial,3.21,1,Hombre,Linkedin,15,1616000,91.0,84,Soltero,45,2016,7,high,2.045,0,6,1190804,886,0,15,1
100285,102025,1,Híbrida,2.665,2,Mujer,Referidos,12,491270,91.0,78,Viudo,32,2013,7,high,102132,Presencial,1.6,0,Hombre,Portal Web,9,1616000,90.0,81,Viudo,56,2018,4,high,-1.065,-2,-3,1124730,1727,0,24,0
100870,102132,1,Híbrida,1.585,0,Hombre,Referidos,4,248686,91.0,78,Soltero,41,2021,11,high,102138,Presencial,4.51,1,Hombre,Linkedin,16,1616000,25.0,80,Viudo,45,2014,3,low,2.925,1,12,1367314,-2801,1,4,0
100839,102119,1,Híbrida,1.25,1,Mujer,Portal Web,14,261262,91.0,81,Divorciado,43,2022,1,high,102107,Presencial,2.22,2,Hombre,Portal Web,12,1616000,38.0,70,Divorciado,52,2021,1,low,0.9700000000000002,1,-2,1354738,-356,1,9,1
101418,102049,1,Híbrida,5.09,2,Mujer,Linkedin,5,257412,91.0,72,Casado,35,2014,9,high,102029,Presencial,6.89,0,Mujer,Portal Web,9,1616000,19.0,77,Divorciado,49,2023,3,low,1.7999999999999998,-2,4,1358588,3107,0,14,0
101850,102054,1,Híbrida,5.825,1,Hombre,Referidos,5,285511,91.0,79,Casado,39,2015,11,high,102044,Presencial,2.91,1,Hombre,Linkedin,17,1616000,85.0,74,Divorciado,41,2012,11,high,-2.915,0,12,1330489,-1113,1,2,0
101593,102016,1,Híbrida,5.67,2,Hombre,Referidos,6,293996,91.0,76,Soltero,37,2012,10,high,102008,Híbrida,2.51,2,Mujer,Portal Web,6,1616000,40.0,80,Casado,44,2017,8,low,-3.16,0,0,1322004,1780,0,7,0
100140,102133,1,Híbrida,5.445,2,Hombre,Portal Web,14,297717,91.0,76,Casado,47,2022,4,high,102151,Híbrida,2.61,2,Hombre,Linkedin,4,1255430,98.0,65,Soltero,35,2018,2,high,-2.8350000000000004,0,-10,957713,-1506,1,-12,0
101134,102057,1,Híbrida,3.125,1,Hombre,Portal Web,7,634099,91.0,70,Viudo,42,2015,4,high,102019,Presencial,1.97,4,Hombre,Portal Web,5,1616000,90.0,73,Viudo,59,2022,12,high,-1.155,3,-2,981901,2796,0,17,0
100324,102082,1,Híbrida,1.67,2,Hombre,Portal Web,7,775708,91.0,65,Divorciado,46,2017,12,high,102050,Presencial,5.5,2,Mujer,Linkedin,7,1616000,81.0,70,Casado,36,2018,8,high,3.83,0,0,840292,232,0,-10,1
100620,102112,1,Híbrida,0.88,0,Hombre,Portal Web,10,701751,91.0,72,Soltero,51,2021,2,high,102031,Presencial,2.27,7,Hombre,Linkedin,1,692000,83.0,74,Soltero,26,2020,6,high,1.3900000000000001,7,-9,-9751,-240,1,-25,0
100248,102001,1,Híbrida,5.19,1,Hombre,Referidos,13,698680,91.0,75,Divorciado,42,2012,1,high,102018,Presencial,1.58,1,Mujer,Linkedin,8,1616000,81.0,76,Casado,51,2023,2,high,-3.6100000000000003,0,-5,917320,4056,0,9,0
101054,102068,1,Híbrida,1.2,3,Hombre,Ferias & Networking,6,735061,91.0,80,Casado,48,2015,5,high,102043,Híbrida,2.17,3,Mujer,Referidos,4,896000,41.0,81,Soltero,23,2012,8,low,0.97,0,-2,160939,-1003,1,-25,0
100338,102052,1,Híbrida,4.77,5,Hombre,Portal Web,5,919540,91.0,71,Casado,47,2013,2,high,102093,Presencial,4.45,0,Hombre,Linkedin,5,641000,84.0,76,Divorciado,17,2012,4,high,-0.3199999999999994,-5,0,-278540,-317,1,-30,0
100998,102119,1,Híbrida,3.93,1,Hombre,Portal Web,20,920681,91.0,74,Casado,57,2022,2,high,102107,Presencial,2.22,2,Hombre,Portal Web,12,1616000,38.0,70,Divorciado,52,2021,1,low,-1.71,1,-8,695319,-385,1,-5,0
101120,102047,1,Híbrida,6.075,1,Mujer,Portal Web,9,901271,91.0,79,Soltero,50,2014,11,high,102089,Presencial,2.67,1,Hombre,Linkedin,4,743000,14.0,70,Casado,22,2015,11,low,-3.4050000000000002,0,-5,-158271,383,0,-28,1
102989,102161,1,Híbrida,1.105,1,Mujer,Linkedin,2,102061,91.0,74,Soltero,21,2023,3,high,102039,Presencial,3.93,5,Mujer,Portal Web,4,1409960,85.0,77,Casado,36,2016,10,high,2.825,4,2,1307899,-2333,1,15,0
103343,102140,1,Híbrida,3.95,1,Hombre,Referidos,1,77856,91.0,75,Soltero,19,2022,4,high,102040,Presencial,2.55,0,Mujer,Portal Web,16,1616000,46.0,69,Casado,39,2012,2,low,-1.4000000000000004,-1,15,1538144,-3723,1,20,0
104103,102021,1,Híbrida,1.045,6,Mujer,Portal Web,1,124172,91.0,69,Soltero,13,2013,6,high,102069,Presencial,2.25,1,Hombre,Linkedin,8,1616000,47.0,80,Casado,52,2017,3,low,1.205,-5,7,1491828,1381,0,39,1
103012,102118,1,Híbrida,1.71,1,Mujer,Referidos,3,143012,91.0,77,Soltero,21,2020,8,high,102171,Presencial,4.76,17,Mujer,Linkedin,4,1616000,86.0,74,Soltero,39,2023,8,high,3.05,16,1,1472988,1110,0,18,0
102957,102044,1,Híbrida,5.15,2,Hombre,Portal Web,2,141388,91.0,72,Casado,14,2013,2,high,102155,Presencial,1.54,1,Hombre,Ferias & Networking,14,1616000,56.0,68,Soltero,47,2023,3,low,-3.6100000000000003,-1,12,1474612,3689,0,33,0
103989,102105,1,Híbrida,1.425,3,Hombre,Portal Web,4,162463,91.0,64,Soltero,22,2020,7,high,102113,Híbrida,2.07,0,Hombre,Linkedin,8,1616000,85.0,71,Viudo,45,2017,3,high,0.6449999999999998,-3,4,1453537,-1197,1,23,1
103893,102156,1,Híbrida,2.135,0,Mujer,Portal Web,3,182100,91.0,87,Soltero,26,2022,8,high,102154,Presencial,4.23,2,Hombre,Portal Web,22,1616000,92.0,76,Soltero,63,2023,12,high,2.0950000000000006,2,19,1433900,474,0,37,1
102514,102171,1,Híbrida,2.295,0,Hombre,Portal Web,5,208134,91.0,66,Soltero,29,2023,6,high,102088,Presencial,2.57,4,Hombre,Linkedin,8,1616000,80.0,69,Casado,43,2017,10,high,0.2749999999999999,4,3,1407866,-2090,1,14,0
103692,102126,1,Híbrida,3.505,2,Hombre,Ferias & Networking,3,206256,91.0,86,Soltero,26,2021,6,high,102141,Presencial,2.5,1,Mujer,Referidos,2,1049000,94.0,79,Casado,34,2021,1,high,-1.005,-1,-1,842744,-152,1,8,0
103228,102156,1,Híbrida,1.345,0,Hombre,Referidos,5,332717,91.0,75,Soltero,33,2022,9,high,102154,Presencial,4.23,2,Hombre,Portal Web,22,1616000,92.0,76,Soltero,63,2023,12,high,2.8850000000000007,2,17,1283283,444,0,30,0
103524,102091,1,Híbrida,0.71,3,Mujer,Portal Web,6,351497,91.0,73,Soltero,29,2017,2,high,102149,Presencial,1.54,1,Mujer,Portal Web,4,1616000,73.0,77,Casado,39,2014,12,low,0.8300000000000001,-2,-2,1264503,-788,1,10,0
102708,102123,1,Híbrida,2.49,1,Mujer,Portal Web,6,348568,91.0,73,Viudo,32,2020,4,high,102043,Presencial,5.5,1,Mujer,Linkedin,16,1616000,42.0,66,Soltero,51,2021,9,low,3.01,0,10,1267432,511,0,19,0
102239,102064,1,Híbrida,5.785,0,Hombre,Referidos,8,345385,91.0,73,Casado,27,2014,11,high,102067,Presencial,1.34,0,Hombre,Portal Web,6,1616000,92.0,92,Casado,43,2018,2,high,-4.445,0,-2,1270615,1177,0,16,0
103319,102129,1,Híbrida,1.825,3,Hombre,Ferias & Networking,2,386314,91.0,66,Soltero,36,2022,1,high,102142,Presencial,2.1,2,Mujer,Linkedin,3,590000,41.0,74,Soltero,24,2020,1,low,0.27500000000000013,-1,1,203686,-736,1,-12,1
103054,102021,1,Híbrida,2.335,2,Mujer,Linkedin,4,407156,91.0,74,Casado,27,2012,9,high,102069,Presencial,2.25,1,Hombre,Linkedin,8,1616000,47.0,80,Casado,52,2017,3,low,-0.08499999999999996,-1,4,1208844,1639,0,25,0
102597,102042,1,Híbrida,6.63,9,Hombre,Linkedin,11,425198,91.0,65,Casado,28,2012,9,high,102107,Presencial,2.19,2,Hombre,Ferias & Networking,8,1616000,38.0,78,Divorciado,57,2018,6,low,-4.4399999999999995,-7,-3,1190802,2117,0,29,0
103454,102090,1,Híbrida,1.985,1,Mujer,Linkedin,3,867018,91.0,75,Casado,37,2018,12,high,102171,Presencial,6.83,0,Hombre,Linkedin,4,488000,92.0,76,Soltero,19,2017,2,high,4.845,-1,1,-379018,-676,1,-18,0
102889,102025,1,Híbrida,2.71,2,Mujer,Referidos,12,485490,91.0,78,Viudo,32,2013,7,high,102132,Presencial,1.6,0,Hombre,Portal Web,9,1616000,90.0,81,Viudo,56,2018,4,high,-1.1099999999999999,-2,-3,1130510,1729,0,24,0
103857,102045,1,Híbrida,1.54,1,Mujer,Linkedin,5,256642,91.0,81,Soltero,37,2015,7,high,102171,Presencial,3.19,3,Hombre,Portal Web,11,1616000,97.0,65,Casado,53,2023,9,high,1.65,2,6,1359358,2979,0,16,0
103361,102049,1,Híbrida,5.085,2,Mujer,Linkedin,5,254243,91.0,72,Casado,35,2014,9,high,102029,Presencial,6.89,0,Mujer,Portal Web,9,1616000,19.0,77,Divorciado,49,2023,3,low,1.8049999999999997,-2,4,1361757,3107,0,14,0
103395,102042,1,Híbrida,2.67,2,Mujer,Ferias & Networking,8,374624,91.0,64,Casado,36,2014,5,high,102107,Presencial,2.19,2,Hombre,Ferias & Networking,8,1616000,38.0,78,Divorciado,57,2018,6,low,-0.48,0,0,1241376,1509,0,21,0
102851,102042,1,Híbrida,6.465,1,Mujer,Portal Web,13,265523,91.0,73,Casado,35,2013,5,high,102107,Presencial,2.19,2,Hombre,Ferias & Networking,8,1616000,38.0,78,Divorciado,57,2018,6,low,-4.275,1,-5,1350477,1857,0,22,0
104162,102119,1,Híbrida,4.66,0,Mujer,Portal Web,6,461479,91.0,74,Soltero,45,2021,3,high,102107,Presencial,2.22,2,Hombre,Portal Web,12,1616000,38.0,70,Divorciado,52,2021,1,low,-2.44,2,6,1154521,-72,1,7,0
103125,102159,1,Híbrida,2.335,2,Mujer,Linkedin,11,294705,91.0,70,Viudo,48,2023,4,high,102120,Híbrida,0.98,2,Hombre,Referidos,14,808000,90.0,86,Soltero,44,2022,8,high,-1.355,0,3,513295,-249,1,-4,1
103202,102016,1,Híbrida,5.645,3,Hombre,Referidos,6,301384,91.0,76,Soltero,37,2012,10,high,102008,Híbrida,2.51,2,Mujer,Portal Web,6,1616000,40.0,80,Casado,44,2017,8,low,-3.135,-1,0,1314616,1778,0,7,1
103473,102143,1,Híbrida,1.535,6,Hombre,Portal Web,11,635064,91.0,75,Viudo,50,2023,3,high,102142,Presencial,1.07,2,Hombre,Portal Web,2,590000,90.0,78,Casado,25,2022,2,high,-0.46499999999999986,-4,-9,-45064,-422,1,-25,0
104088,102120,1,Híbrida,3.27,0,Mujer,Portal Web,13,657510,91.0,64,Divorciado,50,2022,4,high,102171,Presencial,6.48,2,Hombre,Ferias & Networking,9,1616000,80.0,71,Casado,47,2023,8,high,3.2100000000000004,2,-4,958490,476,0,-3,0
104022,102110,1,Híbrida,2.425,5,Hombre,Portal Web,7,660549,91.0,72,Viudo,48,2019,6,high,102045,Presencial,1.6,5,Mujer,Linkedin,2,998000,87.0,76,Soltero,29,2016,11,high,-0.8249999999999997,0,-5,337451,-921,1,-19,1
102387,102073,1,Híbrida,0.84,1,Hombre,Referidos,8,676398,91.0,82,Viudo,44,2015,4,high,102139,Presencial,1.98,2,Hombre,Portal Web,11,1306940,95.0,86,Soltero,37,2019,7,high,1.1400000000000001,1,3,630542,1541,0,-7,0
102524,102001,1,Híbrida,5.175,1,Hombre,Referidos,13,696350,91.0,75,Divorciado,42,2012,1,high,102018,Presencial,1.58,1,Mujer,Linkedin,8,1616000,81.0,76,Casado,51,2023,2,high,-3.5949999999999998,0,-5,919650,4056,0,9,0
102672,102139,1,Híbrida,6.39,7,Hombre,Portal Web,5,740155,91.0,67,Casado,55,2023,3,high,102154,Presencial,6.48,1,Hombre,Ferias & Networking,5,590000,90.0,67,Casado,25,2021,6,high,0.09000000000000075,-6,0,-150155,-628,1,-30,0
103321,102114,1,Híbrida,6.405,12,Mujer,Linkedin,7,919363,91.0,74,Viudo,50,2018,9,high,102050,Presencial,1.44,1,Mujer,Portal Web,5,1616000,91.0,69,Divorciado,47,2021,5,high,-4.965,-11,-2,696637,986,0,-3,0
103804,102119,1,Híbrida,3.965,1,Hombre,Portal Web,20,919874,91.0,74,Casado,57,2022,2,high,102107,Presencial,2.22,2,Hombre,Portal Web,12,1616000,38.0,70,Divorciado,52,2021,1,low,-1.7449999999999997,1,-8,696126,-385,1,-5,1
103537,102129,1,Híbrida,2.76,2,Hombre,Portal Web,4,898019,91.0,68,Viudo,57,2020,5,high,102142,Presencial,2.1,2,Mujer,Linkedin,3,590000,41.0,74,Soltero,24,2020,1,low,-0.6599999999999997,0,-1,-308019,-115,1,-33,0
100364,102040,1,Híbrida,2.005,6,Hombre,Portal Web,2,118012,90.0,72,Soltero,11,2012,8,high,102106,Presencial,3.21,1,Hombre,Linkedin,15,1616000,91.0,84,Soltero,45,2016,7,high,1.205,-5,13,1497988,1421,0,34,0
100610,102069,1,Híbrida,2.185,1,Hombre,Linkedin,3,147812,90.0,81,Soltero,16,2014,11,high,102069,Presencial,4.64,1,Mujer,Ferias & Networking,19,1616000,47.0,74,Casado,60,2021,10,low,2.4549999999999996,0,16,1468188,2543,0,44,1
100049,102027,1,Híbrida,2.06,1,Hombre,Portal Web,2,142895,90.0,62,Soltero,14,2013,6,high,102065,Presencial,3.27,1,Mujer,Linkedin,8,1306940,80.0,80,Casado,32,2014,2,high,1.21,0,6,1164045,247,0,18,0
100596,102124,1,Híbrida,0.985,1,Mujer,Referidos,2,181845,90.0,66,Casado,23,2019,7,high,102099,Presencial,2.84,2,Mujer,Linkedin,4,947000,90.0,70,Soltero,24,2012,10,high,1.855,1,2,765155,-2444,1,1,0
101501,102084,1,Híbrida,1.53,2,Hombre,Ferias & Networking,3,180818,90.0,74,Soltero,19,2016,7,high,102171,Presencial,2.62,3,Mujer,Portal Web,14,1616000,89.0,76,Divorciado,50,2023,7,high,1.09,1,11,1435182,2562,0,31,0
100403,102049,1,Híbrida,1.67,1,Hombre,Ferias & Networking,4,186063,90.0,83,Casado,16,2013,3,high,102029,Presencial,6.89,0,Mujer,Portal Web,9,1616000,19.0,77,Divorciado,49,2023,3,low,5.22,-1,5,1429937,3651,0,33,0
100999,102156,1,Híbrida,1.34,0,Hombre,Referidos,5,330628,90.0,75,Soltero,33,2022,10,high,102154,Presencial,4.23,2,Hombre,Portal Web,22,1616000,92.0,76,Soltero,63,2023,12,high,2.8900000000000006,2,17,1285372,441,0,30,0
100684,102080,1,Híbrida,5.205,3,Hombre,Portal Web,2,325874,90.0,79,Casado,27,2016,8,high,102035,Presencial,1.93,0,Mujer,Linkedin,18,1616000,94.0,75,Viudo,47,2016,8,high,-3.2750000000000004,-3,16,1290126,13,0,20,1
101130,102111,1,Híbrida,3.17,1,Hombre,Ferias & Networking,2,371048,90.0,67,Soltero,32,2019,7,high,102097,Híbrida,2.04,1,Mujer,Referidos,15,1616000,94.0,67,Soltero,50,2021,5,high,-1.13,0,13,1244952,659,0,18,1
100117,102044,1,Híbrida,2.305,1,Mujer,Linkedin,6,385656,90.0,61,Soltero,28,2013,8,high,102155,Presencial,1.54,1,Hombre,Ferias & Networking,14,1616000,56.0,68,Soltero,47,2023,3,low,-0.7650000000000001,0,8,1230344,3506,0,19,0
100810,102021,1,Híbrida,2.35,2,Mujer,Linkedin,4,404582,90.0,74,Casado,28,2012,9,high,102069,Presencial,2.25,1,Hombre,Linkedin,8,1616000,47.0,80,Casado,52,2017,3,low,-0.10000000000000009,-1,4,1211418,1639,0,24,0
101940,102042,1,Híbrida,6.67,8,Hombre,Linkedin,11,432492,90.0,65,Casado,29,2012,9,high,102107,Presencial,2.19,2,Hombre,Ferias & Networking,8,1616000,38.0,78,Divorciado,57,2018,6,low,-4.48,-6,-3,1183508,2119,0,28,0
101617,102067,1,Híbrida,3.92,3,Hombre,Linkedin,5,825544,90.0,73,Soltero,32,2014,9,high,102058,Presencial,0.92,1,Mujer,Portal Web,5,1616000,90.0,70,Divorciado,46,2020,8,high,-3.0,-2,0,790456,2188,0,14,1
101309,102090,1,Híbrida,2.0,1,Mujer,Linkedin,3,864639,90.0,75,Casado,37,2018,12,high,102171,Presencial,6.83,0,Hombre,Linkedin,4,488000,92.0,76,Soltero,19,2017,2,high,4.83,-1,1,-376639,-676,1,-18,1
101560,102113,1,Híbrida,5.015,5,Hombre,Linkedin,3,469101,90.0,69,Soltero,36,2018,5,high,102041,Presencial,2.96,2,Hombre,Portal Web,6,1152410,46.0,75,Casado,27,2012,1,low,-2.0549999999999997,-3,3,683309,-2302,1,-9,0
101782,102056,1,Híbrida,2.5,4,Mujer,Portal Web,7,910297,90.0,73,Casado,34,2013,11,high,102014,Presencial,5.24,1,Hombre,Ferias & Networking,16,1616000,70.0,63,Viudo,65,2023,3,low,2.74,-3,9,705703,3411,0,31,1
100922,102133,1,Híbrida,3.59,3,Hombre,Portal Web,13,255757,90.0,65,Soltero,41,2020,1,high,102151,Híbrida,2.61,2,Hombre,Linkedin,4,1255430,98.0,65,Soltero,35,2018,2,high,-0.98,-1,-9,999673,-696,1,-6,0
101255,102099,1,Híbrida,4.13,6,Hombre,Portal Web,3,265912,90.0,65,Divorciado,39,2017,2,high,102080,Presencial,1.71,0,Hombre,Portal Web,11,1616000,76.0,80,Viudo,51,2021,10,low,-2.42,-6,8,1350088,1705,0,12,0
101939,102020,1,Híbrida,1.265,0,Hombre,Referidos,11,422093,90.0,70,Casado,35,2012,5,high,102134,Presencial,6.63,1,Mujer,Linkedin,11,1203920,90.0,78,Casado,35,2018,12,high,5.365,1,0,781827,2391,0,0,0
101848,102119,1,Híbrida,4.675,1,Mujer,Portal Web,6,459275,90.0,74,Soltero,45,2021,3,high,102107,Presencial,2.22,2,Hombre,Portal Web,12,1616000,38.0,70,Divorciado,52,2021,1,low,-2.4549999999999996,1,6,1156725,-73,1,7,1
101757,102112,1,Híbrida,1.35,2,Hombre,Referidos,5,311994,90.0,76,Divorciado,46,2021,2,high,102031,Presencial,2.27,7,Hombre,Linkedin,1,692000,83.0,74,Soltero,26,2020,6,high,0.9199999999999999,5,-4,380006,-227,1,-20,0
100046,102103,1,Híbrida,4.52,2,Mujer,Linkedin,15,299129,90.0,66,Divorciado,44,2019,6,high,102023,Presencial,1.69,6,Hombre,Portal Web,3,1616000,90.0,74,Casado,45,2013,5,high,-2.8299999999999996,4,-12,1316871,-2216,1,1,1
100381,102034,1,Híbrida,2.02,6,Hombre,Linkedin,5,299497,90.0,80,Casado,37,2012,1,high,102113,Presencial,7.84,7,Hombre,Linkedin,5,1564490,90.0,70,Casado,35,2012,9,high,5.82,1,0,1264993,259,0,-2,0
102159,102120,2,Híbrida,0.98,2,Hombre,Referidos,14,808000,90.0,86,Soltero,44,2022,8,high,102171,Presencial,6.48,2,Hombre,Ferias & Networking,9,1616000,80.0,71,Casado,47,2023,8,high,5.5,0,-5,808000,362,0,3,1
101430,102120,1,Híbrida,3.265,1,Mujer,Portal Web,13,660103,90.0,64,Divorciado,50,2022,4,high,102171,Presencial,6.48,2,Hombre,Ferias & Networking,9,1616000,80.0,71,Casado,47,2023,8,high,3.2150000000000003,1,-4,955897,477,0,-3,1
100840,102110,1,Híbrida,2.415,5,Hombre,Portal Web,7,657264,90.0,72,Viudo,48,2019,6,high,102045,Presencial,1.6,5,Mujer,Linkedin,2,998000,87.0,76,Soltero,29,2016,11,high,-0.815,0,-5,340736,-921,1,-19,1
100925,102084,1,Híbrida,2.27,10,Hombre,Linkedin,16,679779,90.0,80,Divorciado,47,2018,10,high,102171,Presencial,2.62,3,Mujer,Portal Web,14,1616000,89.0,76,Divorciado,50,2023,7,high,0.3500000000000001,-7,-2,936221,1752,0,3,1
101154,102064,1,Híbrida,4.77,2,Hombre,Ferias & Networking,10,779531,90.0,73,Viudo,45,2017,4,high,102067,Presencial,1.34,0,Hombre,Portal Web,6,1616000,92.0,92,Casado,43,2018,2,high,-3.4299999999999997,-2,-4,836469,294,0,-2,0
101458,102079,1,Híbrida,2.33,1,Mujer,Portal Web,15,821808,90.0,70,Casado,44,2016,4,high,102146,Presencial,2.63,1,Mujer,Portal Web,4,1358450,80.0,81,Soltero,35,2016,3,high,0.2999999999999998,0,-11,536642,-39,1,-9,0
100724,102031,1,Híbrida,4.42,9,Mujer,Portal Web,11,774599,90.0,73,Viudo,44,2013,1,high,102111,Presencial,2.95,2,Hombre,Portal Web,8,1610000,76.0,87,Casado,31,2017,7,low,-1.4699999999999998,-7,-3,835401,1637,0,-13,1
101065,102139,1,Híbrida,6.4,8,Hombre,Portal Web,5,735919,90.0,67,Casado,55,2023,3,high,102154,Presencial,6.48,1,Hombre,Ferias & Networking,5,590000,90.0,67,Casado,25,2021,6,high,0.08000000000000007,-7,0,-145919,-625,1,-30,0
101525,102068,1,Híbrida,3.04,2,Hombre,Ferias & Networking,18,734211,90.0,71,Divorciado,49,2017,2,high,102043,Híbrida,2.17,3,Mujer,Referidos,4,896000,41.0,81,Soltero,23,2012,8,low,-0.8700000000000001,1,-14,161789,-1639,1,-26,1
102894,102082,1,Híbrida,1.405,2,Mujer,Referidos,1,83588,90.0,89,Soltero,14,2016,8,high,102050,Presencial,5.5,2,Mujer,Linkedin,7,1616000,81.0,70,Casado,36,2018,8,high,4.095,0,6,1532412,726,0,22,0
102379,102015,1,Híbrida,5.935,3,Mujer,Referidos,1,99663,90.0,80,Casado,11,2012,9,high,102121,Presencial,6.18,1,Mujer,Referidos,10,1358450,74.0,82,Soltero,33,2014,6,low,0.2450000000000001,-2,9,1258787,636,0,22,0
104137,102107,1,Híbrida,1.92,3,Hombre,Portal Web,2,144752,90.0,80,Soltero,22,2020,12,high,102069,Presencial,2.4,1,Mujer,Linkedin,8,1616000,47.0,79,Casado,63,2023,6,low,0.48,-2,6,1471248,926,0,41,1
102972,102027,1,Híbrida,2.105,1,Hombre,Referidos,2,148178,90.0,62,Soltero,14,2013,6,high,102065,Presencial,3.27,1,Mujer,Linkedin,8,1306940,80.0,80,Casado,32,2014,2,high,1.165,0,6,1158762,247,0,18,0
103195,102083,1,Híbrida,1.085,3,Mujer,Referidos,4,163871,90.0,73,Soltero,19,2017,7,high,102147,Presencial,1.61,0,Mujer,Portal Web,5,1564490,83.0,71,Soltero,44,2021,2,high,0.5250000000000001,-3,1,1400619,1315,0,25,0
103722,102153,1,Híbrida,2.37,1,Hombre,Portal Web,2,205076,90.0,73,Casado,27,2021,8,high,102143,Presencial,6.39,1,Mujer,Linkedin,5,1616000,90.0,68,Casado,41,2019,6,high,4.02,0,3,1410924,-807,1,14,0
103020,102141,1,Híbrida,1.58,1,Hombre,Referidos,3,245041,90.0,73,Casado,29,2022,6,high,102134,Presencial,1.88,1,Mujer,Linkedin,3,1100900,64.0,69,Soltero,32,2018,5,low,0.2999999999999998,0,0,855859,-1474,1,3,1
103977,102102,1,Híbrida,1.45,2,Mujer,Referidos,7,272773,90.0,86,Divorciado,27,2019,10,high,102018,Presencial,2.48,0,Hombre,Portal Web,5,1616000,92.0,63,Viudo,49,2019,4,high,1.03,-2,-2,1343227,-167,1,22,1
103143,102036,1,Híbrida,2.71,1,Mujer,Portal Web,5,271243,90.0,74,Casado,21,2013,12,high,102054,Presencial,1.68,8,Hombre,Portal Web,5,1616000,92.0,76,Viudo,54,2022,1,high,-1.03,7,0,1344757,2934,0,33,1
103498,102125,1,Híbrida,2.215,1,Hombre,Ferias & Networking,5,307301,90.0,79,Soltero,31,2020,12,high,102096,Híbrida,4.0,2,Mujer,Referidos,5,692000,87.0,82,Casado,29,2022,7,high,1.7850000000000001,1,0,384699,584,0,-2,1
102879,102090,1,Híbrida,3.715,1,Hombre,Linkedin,7,329037,90.0,89,Soltero,29,2018,11,high,102171,Presencial,6.83,0,Hombre,Linkedin,4,488000,92.0,76,Soltero,19,2017,2,high,3.115,-1,-3,158963,-640,1,-10,0
103429,102100,1,Híbrida,2.86,1,Mujer,Linkedin,6,307843,90.0,74,Casado,27,2017,6,high,102007,Presencial,3.3,1,Mujer,Portal Web,3,1255430,21.0,59,Casado,30,2013,2,low,0.43999999999999995,0,-3,947587,-1582,1,3,0
102837,102024,1,Híbrida,4.555,1,Mujer,Portal Web,4,310948,90.0,59,Soltero,23,2012,7,high,102074,Presencial,2.28,0,Hombre,Headhunter,9,1616000,84.0,70,Casado,48,2018,3,high,-2.275,-1,5,1305052,2070,0,25,1
103815,102134,1,Híbrida,5.65,3,Hombre,Referidos,4,426674,90.0,72,Soltero,38,2022,10,high,102135,Presencial,2.25,2,Hombre,Portal Web,5,1358450,90.0,69,Viudo,31,2012,7,high,-3.4000000000000004,-1,1,931776,-3747,1,-7,0
102848,102113,1,Híbrida,3.37,2,Hombre,Linkedin,5,452080,90.0,70,Casado,37,2020,12,high,102041,Presencial,2.96,2,Hombre,Portal Web,6,1152410,46.0,75,Casado,27,2012,1,low,-0.41000000000000014,0,1,700330,-3255,1,-10,0
104139,102104,1,Híbrida,3.735,5,Hombre,Linkedin,10,426754,90.0,77,Soltero,37,2020,11,high,102129,Híbrida,6.72,1,Mujer,Portal Web,6,743000,91.0,61,Soltero,30,2023,4,high,2.985,-4,-4,316246,875,0,-7,1
102664,102071,1,Híbrida,3.4,0,Hombre,Referidos,11,431910,90.0,76,Casado,32,2016,6,high,102171,Presencial,0.87,1,Hombre,Portal Web,11,1616000,85.0,72,Viudo,51,2023,11,high,-2.53,1,0,1184090,2714,0,19,0
103624,102113,1,Híbrida,5.02,5,Hombre,Linkedin,3,468623,90.0,69,Soltero,36,2018,5,high,102041,Presencial,2.96,2,Hombre,Portal Web,6,1152410,46.0,75,Casado,27,2012,1,low,-2.0599999999999996,-3,3,683787,-2304,1,-9,1
103118,102062,1,Híbrida,5.05,1,Hombre,Referidos,4,484549,90.0,86,Casado,33,2013,12,high,102149,Presencial,0.92,2,Mujer,Referidos,6,692000,38.0,72,Soltero,21,2014,10,low,-4.13,1,2,207451,277,0,-12,1
102497,102132,1,Híbrida,1.55,1,Hombre,Referidos,4,251479,90.0,78,Soltero,41,2021,11,high,102138,Presencial,4.51,1,Hombre,Linkedin,16,1616000,25.0,80,Viudo,45,2014,3,low,2.96,0,12,1364521,-2801,1,4,0
104041,102123,1,Híbrida,7.18,1,Hombre,Portal Web,4,279576,90.0,89,Casado,44,2021,4,high,102043,Presencial,5.5,1,Mujer,Linkedin,16,1616000,42.0,66,Soltero,51,2021,9,low,-1.6799999999999997,0,12,1336424,156,0,7,1
102605,102054,1,Híbrida,5.87,1,Hombre,Referidos,5,291144,90.0,79,Casado,39,2015,11,high,102044,Presencial,2.91,1,Hombre,Linkedin,17,1616000,85.0,74,Divorciado,41,2012,11,high,-2.96,0,12,1324856,-1116,1,2,0
102203,102020,1,Híbrida,1.27,0,Hombre,Portal Web,11,421740,90.0,70,Casado,35,2012,5,high,102134,Presencial,6.63,1,Mujer,Linkedin,11,1203920,90.0,78,Casado,35,2018,12,high,5.359999999999999,1,0,782180,2393,0,0,0
102323,102085,1,Híbrida,5.18,3,Hombre,Portal Web,13,287291,90.0,81,Divorciado,41,2017,5,high,102145,Presencial,6.59,4,Hombre,Portal Web,12,1616000,47.0,71,Casado,39,2015,8,low,1.4100000000000001,1,-1,1328709,-657,1,-2,0
103172,102133,1,Híbrida,5.47,3,Hombre,Portal Web,14,293626,90.0,76,Casado,47,2022,4,high,102151,Híbrida,2.61,2,Hombre,Linkedin,4,1255430,98.0,65,Soltero,35,2018,2,high,-2.86,-1,-10,961804,-1506,1,-12,0
103526,102028,1,Híbrida,1.495,2,Hombre,Portal Web,13,385172,90.0,71,Soltero,40,2014,8,high,102085,Presencial,1.39,2,Mujer,Linkedin,12,1358450,97.0,72,Soltero,35,2016,12,high,-0.1050000000000002,0,-1,973278,862,0,-5,1
102771,102112,1,Híbrida,1.32,3,Hombre,Referidos,5,304335,90.0,76,Divorciado,47,2021,2,high,102031,Presencial,2.27,7,Hombre,Linkedin,1,692000,83.0,74,Soltero,26,2020,6,high,0.95,4,-4,387665,-227,1,-21,0
102970,102057,1,Híbrida,3.115,2,Hombre,Portal Web,7,639511,90.0,70,Viudo,42,2015,4,high,102019,Presencial,1.97,4,Hombre,Portal Web,5,1616000,90.0,73,Viudo,59,2022,12,high,-1.1450000000000002,2,-2,976489,2797,0,17,0
103856,102106,1,Híbrida,1.49,5,Hombre,Portal Web,4,682429,90.0,74,Soltero,48,2019,6,high,102081,Presencial,1.39,1,Mujer,Ferias & Networking,5,1049000,86.0,86,Soltero,32,2019,6,high,-0.10000000000000009,-4,1,366571,-12,1,-16,1
104024,102043,1,Híbrida,1.59,5,Mujer,Portal Web,11,758724,90.0,74,Divorciado,43,2014,4,high,102051,Presencial,1.03,0,Hombre,Portal Web,5,1616000,60.0,76,Casado,44,2019,5,low,-0.56,-5,-6,857276,1864,0,1,1
103945,102031,1,Híbrida,4.42,9,Mujer,Portal Web,11,776059,90.0,73,Viudo,44,2013,1,high,102111,Presencial,2.95,2,Hombre,Portal Web,8,1610000,76.0,87,Casado,31,2017,7,low,-1.4699999999999998,-7,-3,833941,1638,0,-13,1
102315,102052,1,Híbrida,4.755,6,Hombre,Portal Web,5,921529,90.0,71,Casado,47,2013,2,high,102093,Presencial,4.45,0,Hombre,Linkedin,5,641000,84.0,76,Divorciado,17,2012,4,high,-0.3049999999999997,-6,0,-280529,-317,1,-30,0
103763,102047,1,Híbrida,6.065,2,Mujer,Portal Web,9,893413,90.0,79,Soltero,50,2014,11,high,102089,Presencial,2.67,1,Hombre,Linkedin,4,743000,14.0,70,Casado,22,2015,11,low,-3.3950000000000005,-1,-5,-150413,385,0,-28,1
101461,102062,1,Híbrida,5.045,1,Hombre,Referidos,4,491005,89.0,86,Casado,33,2013,12,high,102149,Presencial,0.92,2,Mujer,Referidos,6,692000,38.0,72,Soltero,21,2014,10,low,-4.125,1,2,200995,279,0,-12,1
101812,102123,1,Híbrida,7.17,1,Hombre,Portal Web,4,280650,89.0,89,Casado,44,2021,4,high,102043,Presencial,5.5,1,Mujer,Linkedin,16,1616000,42.0,66,Soltero,51,2021,9,low,-1.67,0,12,1335350,157,0,7,1
102639,102040,1,Híbrida,1.995,7,Hombre,Portal Web,2,122797,89.0,72,Soltero,11,2012,9,high,102106,Presencial,3.21,1,Hombre,Linkedin,15,1616000,91.0,84,Soltero,45,2016,7,high,1.2149999999999999,-6,13,1493203,1419,0,34,0
103776,102049,1,Híbrida,1.645,1,Hombre,Ferias & Networking,4,182149,89.0,83,Casado,16,2013,3,high,102029,Presencial,6.89,0,Mujer,Portal Web,9,1616000,19.0,77,Divorciado,49,2023,3,low,5.244999999999999,-1,5,1433851,3650,0,33,0
103673,102125,1,Híbrida,1.905,6,Mujer,Portal Web,2,208227,89.0,62,Casado,27,2021,7,high,102096,Híbrida,4.0,2,Mujer,Referidos,5,692000,87.0,82,Casado,29,2022,7,high,2.0949999999999998,-4,3,483773,360,0,2,1
102174,102068,1,Híbrida,1.475,0,Mujer,Ferias & Networking,5,429359,89.0,68,Casado,31,2015,8,high,102043,Híbrida,2.17,3,Mujer,Referidos,4,896000,41.0,81,Soltero,23,2012,8,low,0.6949999999999998,3,-1,466641,-1077,1,-8,0
103599,102105,1,Híbrida,1.47,1,Hombre,Referidos,3,529355,89.0,77,Casado,41,2020,4,high,102113,Híbrida,2.07,0,Hombre,Linkedin,8,1616000,85.0,71,Viudo,45,2017,3,high,0.5999999999999999,-1,5,1086645,-1107,1,4,0
100266,102092,1,Híbrida,5.155,1,Mujer,Ferias & Networking,1,164871,88.0,68,Soltero,21,2019,2,high,102120,Presencial,1.23,6,Mujer,Linkedin,13,1616000,98.0,95,Viudo,41,2013,6,high,-3.9250000000000003,5,12,1451129,-2070,1,20,0
100483,102121,1,Híbrida,3.11,3,Mujer,Portal Web,6,325130,87.0,72,Casado,30,2019,7,high,102127,Híbrida,1.63,2,Hombre,Portal Web,4,1616000,90.0,77,Divorciado,44,2012,2,high,-1.48,-1,-2,1290870,-2689,1,14,0
101499,102106,1,Híbrida,1.51,2,Mujer,Portal Web,6,787447,87.0,62,Soltero,36,2021,2,high,102081,Presencial,1.39,1,Mujer,Ferias & Networking,5,1049000,86.0,86,Soltero,32,2019,6,high,-0.1200000000000001,-1,-1,261553,-604,1,-4,0
103385,102092,1,Híbrida,5.14,1,Mujer,Ferias & Networking,1,161194,87.0,68,Soltero,21,2019,2,high,102120,Presencial,1.23,6,Mujer,Linkedin,13,1616000,98.0,95,Viudo,41,2013,6,high,-3.9099999999999997,5,12,1454806,-2071,1,20,1
103153,102082,1,Híbrida,3.26,0,Hombre,Portal Web,7,293344,87.0,73,Casado,25,2015,8,high,102050,Presencial,5.5,2,Mujer,Linkedin,7,1616000,81.0,70,Casado,36,2018,8,high,2.24,2,0,1322656,1091,0,11,1
103584,102121,1,Híbrida,3.11,2,Mujer,Portal Web,6,327492,87.0,72,Casado,30,2019,7,high,102127,Híbrida,1.63,2,Hombre,Portal Web,4,1616000,90.0,77,Divorciado,44,2012,2,high,-1.48,0,-2,1288508,-2686,1,14,0
101483,102082,1,Híbrida,3.225,1,Hombre,Portal Web,7,288860,86.0,73,Casado,25,2015,8,high,102050,Presencial,5.5,2,Mujer,Linkedin,7,1616000,81.0,70,Casado,36,2018,8,high,2.275,1,0,1327140,1089,0,11,1
102397,102092,1,Híbrida,5.275,1,Mujer,Ferias & Networking,1,118928,86.0,90,Soltero,18,2018,8,high,102120,Presencial,1.23,6,Mujer,Linkedin,13,1616000,98.0,95,Viudo,41,2013,6,high,-4.045,5,12,1497072,-1867,1,23,1
100344,102059,1,Híbrida,1.98,1,Mujer,Linkedin,1,185710,85.0,88,Soltero,18,2014,5,high,102021,Presencial,2.55,2,Hombre,Portal Web,16,1616000,27.0,76,Viudo,50,2019,6,low,0.5699999999999998,1,15,1430290,1845,0,32,1
101257,102064,1,Híbrida,2.305,2,Hombre,Ferias & Networking,6,312988,85.0,78,Casado,24,2014,10,high,102067,Presencial,1.34,0,Hombre,Portal Web,6,1616000,92.0,92,Casado,43,2018,2,high,-0.9650000000000001,-2,0,1303012,1210,0,19,0
101597,102017,1,Híbrida,5.425,3,Mujer,Portal Web,13,279971,85.0,86,Casado,36,2012,10,high,102035,Presencial,4.62,0,Mujer,Linkedin,2,641000,90.0,84,Casado,25,2019,11,high,-0.8049999999999997,-3,-11,361029,2567,0,-11,0
101084,102065,1,Híbrida,4.45,1,Mujer,Referidos,4,655294,85.0,76,Soltero,45,2017,8,high,102026,Presencial,2.44,2,Hombre,Ferias & Networking,13,1616000,45.0,60,Divorciado,35,2014,10,low,-2.0100000000000002,1,9,960706,-1041,1,-10,0
102764,102087,1,Híbrida,2.435,1,Mujer,Referidos,4,145826,85.0,77,Soltero,17,2016,11,high,102111,Presencial,7.16,9,Mujer,Linkedin,10,1616000,98.0,79,Casado,42,2012,5,high,4.725,8,6,1470174,-1663,1,25,0
102464,102091,1,Híbrida,5.25,1,Mujer,Portal Web,5,432157,85.0,73,Soltero,34,2017,11,high,102149,Presencial,1.54,1,Mujer,Portal Web,4,1616000,73.0,77,Casado,39,2014,12,low,-3.71,0,-1,1183843,-1065,1,5,0
102554,102117,1,Híbrida,2.93,0,Mujer,Referidos,6,247075,85.0,73,Soltero,40,2020,3,high,102154,Presencial,4.05,1,Mujer,Linkedin,10,1616000,90.0,80,Divorciado,48,2021,1,high,1.1199999999999997,1,4,1368925,313,0,8,0
103492,102059,1,Híbrida,1.985,1,Mujer,Linkedin,1,192368,84.0,88,Soltero,18,2014,5,high,102021,Presencial,2.55,2,Hombre,Portal Web,16,1616000,27.0,76,Viudo,50,2019,6,low,0.5649999999999997,1,15,1423632,1842,0,32,1
102856,102142,1,Híbrida,3.395,11,Hombre,Portal Web,8,294775,84.0,74,Divorciado,47,2022,3,high,102047,Presencial,2.48,2,Hombre,Portal Web,3,1255430,90.0,66,Soltero,36,2019,7,high,-0.915,-9,-5,960655,-995,1,-11,0
103282,102065,1,Híbrida,4.445,1,Mujer,Referidos,4,661443,84.0,76,Soltero,45,2017,8,high,102026,Presencial,2.44,2,Hombre,Ferias & Networking,13,1616000,45.0,60,Divorciado,35,2014,10,low,-2.0050000000000003,1,9,954557,-1041,1,-10,1
101140,102108,1,Híbrida,1.77,1,Hombre,Portal Web,4,272512,83.0,73,Soltero,27,2019,1,high,102040,Presencial,2.92,1,Mujer,Portal Web,5,1616000,46.0,75,Casado,50,2023,5,low,1.15,0,1,1343488,1605,0,23,1
103961,102086,1,Híbrida,2.67,14,Hombre,Ferias & Networking,6,424725,83.0,86,Soltero,35,2018,8,high,102085,Presencial,2.22,2,Mujer,Linkedin,7,1306940,87.0,68,Divorciado,39,2021,3,high,-0.44999999999999973,-12,1,882215,938,0,4,1
102442,102131,1,Híbrida,0.915,6,Hombre,Linkedin,16,877120,83.0,85,Casado,52,2023,2,high,102109,Presencial,5.54,0,Hombre,Linkedin,3,998000,39.0,77,Soltero,34,2021,12,low,4.625,-6,-13,120880,-425,1,-18,0
102718,102061,1,Híbrida,1.855,3,Hombre,Portal Web,16,776515,83.0,78,Soltero,43,2014,3,high,102115,Presencial,2.14,2,Hombre,Ferias & Networking,10,1203920,37.0,80,Casado,29,2012,11,low,0.28500000000000014,-1,-6,427405,-483,1,-14,0
100314,102041,1,Híbrida,0.795,3,Hombre,Portal Web,3,245947,82.0,69,Casado,22,2015,7,high,102147,Presencial,1.29,0,Mujer,Portal Web,8,1616000,44.0,73,Casado,51,2014,5,low,0.495,-3,5,1370053,-418,1,29,1
100921,102131,1,Híbrida,0.95,7,Hombre,Linkedin,16,874739,82.0,85,Casado,52,2023,2,high,102109,Presencial,5.54,0,Hombre,Linkedin,3,998000,39.0,77,Soltero,34,2021,12,low,4.59,-7,-13,123261,-425,1,-18,1
103616,102041,1,Híbrida,0.79,3,Hombre,Portal Web,3,251419,82.0,69,Casado,22,2015,7,high,102147,Presencial,1.29,0,Mujer,Portal Web,8,1616000,44.0,73,Casado,51,2014,5,low,0.5,-3,5,1364581,-420,1,29,1
101144,102010,1,Híbrida,1.55,1,Hombre,Referidos,2,159568,81.0,84,Soltero,13,2012,5,high,102035,Presencial,2.02,0,Mujer,Linkedin,5,1564490,77.0,73,Casado,44,2021,8,low,0.47,-1,3,1404922,3383,0,31,1
101587,102085,1,Híbrida,3.505,1,Mujer,Referidos,3,148314,81.0,63,Soltero,17,2016,3,high,102145,Presencial,6.59,4,Hombre,Portal Web,12,1616000,47.0,71,Casado,39,2015,8,low,3.085,3,9,1467686,-223,1,22,1
100628,102081,1,Híbrida,4.155,3,Mujer,Portal Web,7,290832,81.0,71,Casado,25,2016,9,high,102135,Presencial,2.5,2,Hombre,Portal Web,4,488000,26.0,64,Soltero,18,2015,8,low,-1.6550000000000002,-1,-3,197168,-404,1,-7,0
101536,102042,1,Híbrida,6.375,3,Hombre,Linkedin,3,641367,81.0,74,Divorciado,41,2014,10,high,102107,Presencial,2.19,2,Hombre,Ferias & Networking,8,1616000,38.0,78,Divorciado,57,2018,6,low,-4.1850000000000005,-1,5,974633,1340,0,16,0
102924,102010,1,Híbrida,1.505,2,Hombre,Referidos,2,156060,81.0,84,Soltero,13,2012,5,high,102035,Presencial,2.02,0,Mujer,Linkedin,5,1564490,77.0,73,Casado,44,2021,8,low,0.5150000000000001,-2,3,1408430,3382,0,31,0
103094,102038,1,Híbrida,3.425,2,Mujer,Portal Web,9,507562,81.0,79,Casado,35,2014,9,high,102125,Presencial,2.06,1,Hombre,Portal Web,12,1616000,81.0,82,Casado,44,2018,1,high,-1.3649999999999998,-1,3,1108438,1222,0,9,1
101402,102133,1,Híbrida,1.86,1,Mujer,Ferias & Networking,1,118306,80.0,75,Soltero,22,2022,9,high,102151,Híbrida,2.61,2,Hombre,Linkedin,4,1255430,98.0,65,Soltero,35,2018,2,high,0.7499999999999998,1,3,1137124,-1670,1,13,1
102023,102105,2,Híbrida,4.9,1,Hombre,Portal Web,4,539000,80.0,65,Casado,23,2019,12,high,102113,Híbrida,2.07,0,Hombre,Linkedin,8,1616000,85.0,71,Viudo,45,2017,3,high,-2.8300000000000005,-1,4,1077000,-1008,1,22,1
101539,102105,1,Híbrida,7.235,2,Mujer,Ferias & Networking,13,255797,80.0,74,Casado,40,2018,11,high,102113,Híbrida,2.07,0,Hombre,Linkedin,8,1616000,85.0,71,Viudo,45,2017,3,high,-5.165000000000001,-2,-5,1360203,-602,1,5,0
103988,102081,1,Híbrida,4.12,3,Mujer,Portal Web,5,288616,80.0,71,Casado,25,2016,9,high,102135,Presencial,2.5,2,Hombre,Portal Web,4,488000,26.0,64,Soltero,18,2015,8,low,-1.62,-1,-1,199384,-402,1,-7,1
103311,102144,1,Híbrida,2.235,0,Mujer,Portal Web,8,493105,80.0,79,Casado,42,2023,1,high,102156,Presencial,2.13,8,Mujer,Portal Web,11,1616000,5.0,82,Viudo,58,2015,6,low,-0.10499999999999998,8,3,1122895,-2777,1,16,0
103246,102105,1,Híbrida,7.265,2,Mujer,Ferias & Networking,13,255768,80.0,74,Casado,40,2018,11,high,102113,Híbrida,2.07,0,Hombre,Linkedin,8,1616000,85.0,71,Viudo,45,2017,3,high,-5.195,-2,-5,1360232,-605,1,5,0
100507,102039,1,Híbrida,6.92,1,Hombre,Portal Web,4,208020,79.0,64,Casado,17,2012,11,low,102054,Presencial,3.66,0,Hombre,Referidos,5,1616000,93.0,75,Viudo,49,2018,6,high,-3.26,-1,1,1407980,2040,0,32,0
101379,102103,1,Híbrida,2.98,0,Hombre,Portal Web,3,384716,79.0,82,Casado,33,2019,2,low,102023,Presencial,1.69,6,Hombre,Portal Web,3,1616000,90.0,74,Casado,45,2013,5,high,-1.29,6,0,1231284,-2091,1,12,0
101720,102129,1,Híbrida,1.24,1,Hombre,Referidos,8,471585,79.0,67,Soltero,40,2022,5,low,102142,Presencial,2.1,2,Mujer,Linkedin,3,590000,41.0,74,Soltero,24,2020,1,low,0.8600000000000001,1,-5,118415,-847,1,-16,1
100239,102052,1,Híbrida,2.09,3,Mujer,Linkedin,6,504341,79.0,75,Casado,36,2015,9,low,102093,Presencial,4.45,0,Hombre,Linkedin,5,641000,84.0,76,Divorciado,17,2012,4,high,2.3600000000000003,-3,-1,136659,-1268,1,-19,1
100231,102042,1,Híbrida,5.725,10,Mujer,Linkedin,3,289954,79.0,79,Soltero,36,2012,7,low,102107,Presencial,2.19,2,Hombre,Ferias & Networking,8,1616000,38.0,78,Divorciado,57,2018,6,low,-3.5349999999999997,-8,5,1326046,2177,0,21,1
101612,102094,1,Híbrida,3.12,3,Mujer,Portal Web,14,633855,79.0,87,Casado,44,2017,8,low,102095,Presencial,1.32,1,Hombre,Portal Web,4,998000,90.0,85,Casado,28,2016,2,high,-1.8,-2,-10,364145,-561,1,-16,0
101828,102154,1,Híbrida,1.72,1,Hombre,Linkedin,1,893868,79.0,76,Viudo,55,2023,2,low,102172,Presencial,5.45,1,Hombre,Portal Web,7,1512980,93.0,69,Soltero,39,2017,10,high,3.7300000000000004,0,6,619112,-1973,1,-16,0
102347,102143,1,Híbrida,2.11,8,Hombre,Linkedin,5,261929,79.0,89,Soltero,42,2021,1,low,102142,Presencial,1.07,2,Hombre,Portal Web,2,590000,90.0,78,Casado,25,2022,2,high,-1.0399999999999998,-6,-3,328071,371,0,-17,1
100544,102064,1,Híbrida,1.99,1,Hombre,Linkedin,1,103345,78.0,69,Soltero,15,2016,9,low,102067,Presencial,1.34,0,Hombre,Portal Web,6,1616000,92.0,92,Casado,43,2018,2,high,-0.6499999999999999,-1,5,1512655,507,0,28,0
101872,102105,1,Híbrida,2.33,1,Hombre,Portal Web,2,185934,78.0,71,Soltero,24,2020,11,low,102113,Híbrida,2.07,0,Hombre,Linkedin,8,1616000,85.0,71,Viudo,45,2017,3,high,-0.26000000000000023,-1,6,1430066,-1319,1,21,0
101869,102075,1,Híbrida,3.115,1,Hombre,Linkedin,9,324737,78.0,77,Soltero,29,2017,7,low,102047,Presencial,2.7,1,Hombre,Referidos,11,1255430,90.0,76,Casado,30,2013,3,high,-0.41500000000000004,0,2,930693,-1560,1,1,0
101789,102122,1,Híbrida,2.12,3,Mujer,Portal Web,7,386862,78.0,65,Soltero,33,2019,3,low,102075,Presencial,1.83,4,Hombre,Portal Web,6,1616000,90.0,66,Viudo,48,2019,3,high,-0.29000000000000004,1,-1,1229138,-7,1,15,1
101431,102134,1,Híbrida,1.795,2,Hombre,Linkedin,7,491303,78.0,78,Casado,39,2020,2,low,102135,Presencial,2.25,2,Hombre,Portal Web,5,1358450,90.0,69,Viudo,31,2012,7,high,0.45500000000000007,0,-2,867147,-2772,1,-8,0
101557,102063,1,Híbrida,2.275,8,Mujer,Portal Web,11,251575,78.0,83,Soltero,34,2014,4,low,102135,Presencial,2.73,0,Mujer,Linkedin,1,539000,26.0,75,Soltero,24,2021,4,low,0.45500000000000007,-8,-10,287425,2565,0,-10,0
100010,102011,1,Híbrida,2.435,2,Mujer,Linkedin,15,311664,78.0,73,Viudo,38,2012,6,low,102048,Presencial,5.37,1,Hombre,Ferias & Networking,7,845000,52.0,74,Casado,22,2012,11,low,2.935,-1,-8,533336,172,0,-16,0
103021,102064,1,Híbrida,1.94,1,Hombre,Linkedin,1,100723,78.0,69,Soltero,15,2016,9,low,102067,Presencial,1.34,0,Hombre,Portal Web,6,1616000,92.0,92,Casado,43,2018,2,high,-0.5999999999999999,-1,5,1515277,505,0,28,0
103557,102050,1,Híbrida,2.29,2,Hombre,Linkedin,2,167538,78.0,74,Soltero,18,2015,8,low,102069,Presencial,3.7,0,Mujer,Linkedin,11,1512980,90.0,88,Soltero,40,2017,10,high,1.4100000000000001,-2,9,1345442,792,0,22,0
103898,102134,1,Híbrida,3.85,10,Mujer,Linkedin,4,470457,78.0,59,Divorciado,41,2022,12,low,102135,Presencial,2.25,2,Hombre,Portal Web,5,1358450,90.0,69,Viudo,31,2012,7,high,-1.6,-8,1,887993,-3795,1,-10,1
102777,102107,1,Híbrida,2.74,9,Mujer,Portal Web,14,307086,78.0,73,Casado,45,2019,4,low,102069,Presencial,2.4,1,Mujer,Linkedin,8,1616000,47.0,79,Casado,63,2023,6,low,-0.3400000000000003,-8,-6,1308914,1538,0,18,0
102823,102113,1,Híbrida,3.87,5,Hombre,Portal Web,13,916562,78.0,79,Casado,47,2019,8,low,102041,Presencial,2.96,2,Hombre,Portal Web,6,1152410,46.0,75,Casado,27,2012,1,low,-0.9100000000000001,-3,-7,235848,-2766,1,-20,1
103911,102028,1,Híbrida,5.7,5,Hombre,Linkedin,15,639599,78.0,76,Casado,40,2013,4,low,102085,Presencial,1.39,2,Mujer,Linkedin,12,1358450,97.0,72,Soltero,35,2016,12,high,-4.3100000000000005,-3,-3,718851,1338,0,-5,1
101761,102096,1,Híbrida,2.125,4,Hombre,Linkedin,2,160729,77.0,80,Soltero,22,2019,12,low,102116,Presencial,5.11,8,Mujer,Linkedin,13,1461470,90.0,74,Soltero,42,2021,5,high,2.9850000000000003,4,11,1300741,499,0,20,1
101860,102050,1,Híbrida,2.3,3,Hombre,Linkedin,2,166829,77.0,74,Soltero,18,2015,8,low,102069,Presencial,3.7,0,Mujer,Linkedin,11,1512980,90.0,88,Soltero,40,2017,10,high,1.4000000000000004,-3,9,1346151,789,0,22,0
100220,102170,1,Híbrida,3.775,2,Mujer,Portal Web,7,792326,77.0,78,Casado,39,2023,6,low,102055,Presencial,1.62,0,Mujer,Portal Web,8,1616000,78.0,72,Viudo,48,2013,2,low,-2.155,-2,1,823674,-3764,1,9,0
100157,102060,1,Híbrida,2.06,1,Mujer,Ferias & Networking,5,428549,77.0,65,Soltero,31,2015,3,low,102041,Presencial,4.42,3,Hombre,Referidos,16,1616000,82.0,62,Casado,45,2013,10,high,2.36,2,11,1187451,-491,1,14,0
100274,102130,1,Híbrida,5.64,0,Mujer,Portal Web,4,449637,77.0,77,Soltero,37,2020,8,low,102068,Presencial,1.97,6,Hombre,Linkedin,5,1616000,84.0,73,Soltero,31,2014,4,high,-3.67,6,1,1166363,-2295,1,-6,0
100951,102134,1,Híbrida,1.945,1,Hombre,Linkedin,7,451633,77.0,83,Casado,37,2020,1,low,102135,Presencial,2.25,2,Hombre,Portal Web,5,1358450,90.0,69,Viudo,31,2012,7,high,0.30499999999999994,1,-2,906817,-2753,1,-6,0
100377,102160,1,Híbrida,7.13,2,Hombre,Portal Web,10,487113,77.0,87,Soltero,41,2022,6,low,102087,Presencial,2.21,0,Hombre,Portal Web,3,794000,83.0,78,Casado,28,2019,8,high,-4.92,-2,-7,306887,-1027,1,-13,0
101497,102146,1,Híbrida,5.18,5,Mujer,Portal Web,8,280985,77.0,77,Soltero,44,2021,8,low,102035,Presencial,2.66,0,Mujer,Portal Web,15,1616000,77.0,78,Casado,39,2013,10,low,-2.5199999999999996,-5,7,1335015,-2871,1,-5,0
100340,102041,1,Híbrida,2.325,1,Hombre,Referidos,12,296091,77.0,76,Divorciado,38,2013,3,low,102147,Presencial,1.29,0,Mujer,Portal Web,8,1616000,44.0,73,Casado,51,2014,5,low,-1.0350000000000001,-1,-4,1319909,431,0,13,0
101665,102113,1,Híbrida,3.855,4,Hombre,Portal Web,13,914274,77.0,79,Casado,46,2019,8,low,102041,Presencial,2.96,2,Hombre,Portal Web,6,1152410,46.0,75,Casado,27,2012,1,low,-0.895,-2,-7,238136,-2765,1,-19,1
102489,102040,1,Híbrida,1.74,8,Hombre,Portal Web,1,119990,77.0,63,Soltero,14,2015,4,low,102106,Presencial,3.21,1,Hombre,Linkedin,15,1616000,91.0,84,Soltero,45,2016,7,high,1.47,-7,14,1496010,476,0,31,0
102338,102160,1,Híbrida,2.305,2,Hombre,Referidos,4,162544,77.0,65,Soltero,25,2022,6,low,102087,Presencial,2.21,0,Hombre,Portal Web,3,794000,83.0,78,Casado,28,2019,8,high,-0.0950000000000002,-2,-1,631456,-1033,1,3,0
102917,102067,1,Híbrida,1.63,1,Mujer,Referidos,3,373544,77.0,73,Soltero,28,2014,12,low,102058,Presencial,0.92,1,Mujer,Portal Web,5,1616000,90.0,70,Divorciado,46,2020,8,high,-0.7099999999999999,0,2,1242456,2071,0,18,0
102821,102055,1,Híbrida,2.165,1,Hombre,Referidos,4,405924,77.0,73,Soltero,29,2014,6,low,102129,Presencial,1.92,2,Hombre,Referidos,8,1616000,97.0,63,Casado,42,2013,2,high,-0.2450000000000001,1,4,1210076,-463,1,13,0
102849,102063,1,Híbrida,2.3,8,Mujer,Portal Web,11,251667,77.0,83,Soltero,34,2014,4,low,102135,Presencial,2.73,0,Mujer,Linkedin,1,539000,26.0,75,Soltero,24,2021,4,low,0.43000000000000016,-8,-10,287333,2566,0,-10,0
102796,102026,1,Híbrida,6.765,1,Mujer,Linkedin,5,255813,77.0,81,Casado,35,2014,4,low,102101,Presencial,2.7,1,Mujer,Portal Web,15,1616000,97.0,79,Casado,58,2017,6,high,-4.0649999999999995,0,10,1360187,1174,0,23,0
102381,102151,1,Híbrida,2.94,8,Hombre,Linkedin,15,280617,77.0,73,Casado,46,2023,2,low,102105,Presencial,1.51,2,Hombre,Ferias & Networking,10,1616000,85.0,80,Divorciado,45,2021,11,high,-1.43,-6,-5,1335383,-454,1,-1,0
102976,102041,1,Híbrida,2.35,2,Hombre,Referidos,12,299181,77.0,76,Divorciado,38,2013,3,low,102147,Presencial,1.29,0,Mujer,Portal Web,8,1616000,44.0,73,Casado,51,2014,5,low,-1.06,-2,-4,1316819,429,0,13,1
100532,102076,1,Híbrida,2.285,2,Hombre,Referidos,1,249816,76.0,72,Soltero,24,2016,9,low,102168,Híbrida,1.95,1,Hombre,Referidos,9,1616000,95.0,82,Soltero,53,2023,9,high,-0.3350000000000002,-1,8,1366184,2545,0,29,1
100981,102098,1,Híbrida,2.48,8,Hombre,Linkedin,7,366800,76.0,73,Casado,29,2017,1,low,102049,Presencial,1.8,1,Mujer,Portal Web,16,1616000,90.0,86,Casado,46,2021,1,high,-0.6799999999999999,-7,9,1249200,1474,0,17,0
101226,102070,1,Híbrida,5.195,0,Mujer,Referidos,4,366983,76.0,79,Soltero,30,2016,9,low,102035,Presencial,1.7,1,Mujer,Referidos,4,1616000,77.0,73,Viudo,38,2013,3,low,-3.495,1,0,1249017,-1298,1,8,0
100194,102055,1,Híbrida,2.14,2,Hombre,Referidos,4,409502,76.0,73,Soltero,29,2014,6,low,102129,Presencial,1.92,2,Hombre,Referidos,8,1616000,97.0,63,Casado,42,2013,2,high,-0.2200000000000002,0,4,1206498,-461,1,13,1
100609,102139,1,Híbrida,4.98,2,Hombre,Portal Web,10,447432,76.0,71,Soltero,40,2022,10,low,102154,Presencial,6.48,1,Hombre,Ferias & Networking,5,590000,90.0,67,Casado,25,2021,6,high,1.5,-1,-5,142568,-495,1,-15,1
101676,102162,1,Híbrida,1.59,1,Hombre,Linkedin,10,467308,76.0,69,Casado,41,2023,4,low,102146,Presencial,1.12,0,Mujer,Referidos,9,1616000,31.0,74,Casado,41,2022,11,low,-0.47,-1,-1,1148692,-140,1,0,0
100094,102151,1,Híbrida,5.305,6,Hombre,Linkedin,7,275816,76.0,85,Soltero,45,2022,3,low,102105,Presencial,1.51,2,Hombre,Ferias & Networking,10,1616000,85.0,80,Divorciado,45,2021,11,high,-3.795,-4,3,1340184,-108,1,0,0
100134,102143,1,Híbrida,2.53,8,Hombre,Linkedin,5,280607,76.0,87,Soltero,44,2021,6,low,102142,Presencial,1.07,2,Hombre,Portal Web,2,590000,90.0,78,Casado,25,2022,2,high,-1.4599999999999997,-6,-3,309393,225,0,-19,0
100827,102042,1,Híbrida,2.395,1,Mujer,Ferias & Networking,16,404860,76.0,68,Viudo,41,2014,5,low,102107,Presencial,2.19,2,Hombre,Ferias & Networking,8,1616000,38.0,78,Divorciado,57,2018,6,low,-0.20500000000000007,1,-8,1211140,1517,0,16,0
101621,102131,1,Híbrida,2.78,1,Hombre,Ferias & Networking,10,775586,76.0,73,Divorciado,47,2020,2,low,102109,Presencial,5.54,0,Hombre,Linkedin,3,998000,39.0,77,Soltero,34,2021,12,low,2.7600000000000002,-1,-7,222414,664,0,-13,0
101416,102140,1,Híbrida,6.9,1,Hombre,Referidos,10,682117,76.0,76,Casado,51,2022,4,low,102040,Presencial,2.55,0,Mujer,Portal Web,16,1616000,46.0,69,Casado,39,2012,2,low,-4.3500000000000005,-1,6,933883,-3735,1,-12,1
101147,102106,1,Híbrida,1.755,0,Hombre,Ferias & Networking,20,798249,76.0,80,Soltero,47,2018,10,low,102081,Presencial,1.39,1,Mujer,Ferias & Networking,5,1049000,86.0,86,Soltero,32,2019,6,high,-0.365,1,-15,250751,247,0,-15,1
100956,102143,1,Híbrida,3.49,3,Mujer,Linkedin,10,714623,76.0,91,Casado,54,2022,12,low,102142,Presencial,1.07,2,Hombre,Portal Web,2,590000,90.0,78,Casado,25,2022,2,high,-2.42,-1,-8,-124623,-306,1,-29,0
101122,102083,1,Híbrida,2.27,2,Mujer,Linkedin,4,877333,76.0,76,Divorciado,53,2018,1,low,102147,Presencial,1.61,0,Mujer,Portal Web,5,1564490,83.0,71,Soltero,44,2021,2,high,-0.6599999999999999,-2,1,687157,1138,0,-9,0
103926,102097,1,Híbrida,2.96,0,Mujer,Portal Web,3,118219,76.0,61,Soltero,18,2019,8,low,102024,Presencial,1.95,6,Hombre,Portal Web,4,1100900,57.0,77,Soltero,31,2016,10,low,-1.01,6,1,982681,-1035,1,13,1
102485,102076,1,Híbrida,2.27,2,Hombre,Referidos,1,247754,76.0,72,Soltero,24,2016,9,low,102168,Híbrida,1.95,1,Hombre,Referidos,9,1616000,95.0,82,Soltero,53,2023,9,high,-0.32000000000000006,-1,8,1368246,2547,0,29,0
103618,102098,1,Híbrida,2.485,9,Hombre,Linkedin,7,371700,76.0,73,Casado,29,2017,1,low,102049,Presencial,1.8,1,Mujer,Portal Web,16,1616000,90.0,86,Casado,46,2021,1,high,-0.6849999999999998,-8,9,1244300,1475,0,17,0
102509,102070,1,Híbrida,5.18,0,Mujer,Referidos,4,367248,76.0,79,Soltero,30,2016,9,low,102035,Presencial,1.7,1,Mujer,Referidos,4,1616000,77.0,73,Viudo,38,2013,3,low,-3.4799999999999995,1,0,1248752,-1300,1,8,0
103529,102139,1,Híbrida,4.99,2,Hombre,Portal Web,10,452931,76.0,71,Soltero,40,2022,10,low,102154,Presencial,6.48,1,Hombre,Ferias & Networking,5,590000,90.0,67,Casado,25,2021,6,high,1.4900000000000002,-1,-5,137069,-494,1,-15,0
103199,102090,1,Híbrida,3.6,1,Mujer,Linkedin,13,305771,76.0,81,Viudo,43,2016,10,low,102171,Presencial,6.83,0,Hombre,Linkedin,4,488000,92.0,76,Soltero,19,2017,2,high,3.23,-1,-9,182229,121,0,-24,0
103870,102130,1,Híbrida,1.24,2,Mujer,Portal Web,12,636759,76.0,74,Viudo,48,2020,12,low,102068,Presencial,1.97,6,Hombre,Linkedin,5,1616000,84.0,73,Soltero,31,2014,4,high,0.73,4,-7,979241,-2436,1,-17,1
103636,102143,1,Híbrida,3.47,3,Mujer,Linkedin,10,718674,76.0,91,Casado,54,2022,12,low,102142,Presencial,1.07,2,Hombre,Portal Web,2,590000,90.0,78,Casado,25,2022,2,high,-2.4000000000000004,-1,-8,-128674,-308,1,-29,1
102202,102096,1,Híbrida,4.425,2,Mujer,Linkedin,18,915683,76.0,76,Viudo,48,2017,9,low,102116,Presencial,5.11,8,Mujer,Linkedin,13,1461470,90.0,74,Soltero,42,2021,5,high,0.6850000000000005,6,-5,545787,1322,0,-6,0
102570,102051,1,Híbrida,3.94,2,Hombre,Referidos,12,914513,76.0,76,Casado,46,2014,5,low,102075,Híbrida,1.39,1,Hombre,Portal Web,11,1616000,83.0,76,Casado,46,2019,11,high,-2.55,-1,-1,701487,1995,0,0,0
101076,102136,1,Híbrida,2.5,1,Mujer,Referidos,2,101639,75.0,76,Soltero,20,2021,6,low,102034,Presencial,1.78,2,Hombre,Portal Web,3,1616000,89.0,78,Casado,35,2013,1,high,-0.72,1,1,1514361,-3087,1,15,1
101993,102046,1,Híbrida,3.71,3,Mujer,Portal Web,6,268794,75.0,79,Casado,24,2015,12,low,102007,Presencial,1.68,0,Mujer,Portal Web,8,1616000,41.0,71,Soltero,50,2015,10,low,-2.0300000000000002,-3,2,1347206,-42,1,26,1
100723,102070,1,Híbrida,1.71,2,Mujer,Portal Web,11,251868,75.0,77,Soltero,38,2017,10,low,102035,Presencial,1.7,1,Mujer,Referidos,4,1616000,77.0,73,Viudo,38,2013,3,low,-0.010000000000000009,-1,-7,1364132,-1685,1,0,0
101281,102012,1,Híbrida,4.15,0,Hombre,Portal Web,12,378654,75.0,70,Soltero,34,2012,6,low,102122,Presencial,2.09,1,Mujer,Portal Web,7,1100000,90.0,80,Casado,34,2019,7,high,-2.0600000000000005,1,-5,721346,2589,0,0,0
100790,102054,1,Híbrida,7.56,1,Mujer,Portal Web,4,288939,75.0,70,Casado,38,2013,6,low,102044,Presencial,2.91,1,Hombre,Linkedin,17,1616000,85.0,74,Divorciado,41,2012,11,high,-4.6499999999999995,0,13,1327061,-214,1,3,0
101500,102096,1,Híbrida,4.43,3,Mujer,Linkedin,16,914314,75.0,76,Viudo,49,2017,9,low,102116,Presencial,5.11,8,Mujer,Linkedin,13,1461470,90.0,74,Soltero,42,2021,5,high,0.6800000000000006,5,-3,547156,1320,0,-7,0
103235,102136,1,Híbrida,2.495,1,Mujer,Referidos,2,100720,75.0,76,Soltero,20,2021,6,low,102034,Presencial,1.78,2,Hombre,Portal Web,3,1616000,89.0,78,Casado,35,2013,1,high,-0.7150000000000001,1,1,1515280,-3085,1,15,0
103393,102068,1,Híbrida,1.95,3,Mujer,Ferias & Networking,1,101533,75.0,83,Soltero,16,2017,12,low,102043,Híbrida,2.17,3,Mujer,Referidos,4,896000,41.0,81,Soltero,23,2012,8,low,0.21999999999999997,0,3,794467,-1952,1,7,0
102504,102088,1,Híbrida,5.17,1,Mujer,Portal Web,2,205987,75.0,71,Soltero,24,2019,4,low,102139,Presencial,4.96,1,Mujer,Portal Web,3,488000,82.0,65,Soltero,20,2018,4,high,-0.20999999999999996,0,1,282013,-366,1,-4,1
102895,102012,1,Híbrida,4.12,1,Hombre,Portal Web,12,373843,75.0,70,Soltero,34,2012,6,low,102122,Presencial,2.09,1,Mujer,Portal Web,7,1100000,90.0,80,Casado,34,2019,7,high,-2.0300000000000002,0,-5,726157,2591,0,0,0
102431,102151,1,Híbrida,5.325,7,Hombre,Linkedin,7,281246,75.0,85,Soltero,45,2022,3,low,102105,Presencial,1.51,2,Hombre,Ferias & Networking,10,1616000,85.0,80,Divorciado,45,2021,11,high,-3.8150000000000004,-5,3,1334754,-106,1,0,0
103805,102013,1,Híbrida,6.73,7,Hombre,Portal Web,7,294876,75.0,74,Casado,38,2012,9,low,102139,Presencial,2.0,2,Mujer,Linkedin,4,743000,96.0,79,Casado,30,2022,11,high,-4.73,-5,-3,448124,3719,0,-8,1
103555,102042,1,Híbrida,2.39,2,Mujer,Ferias & Networking,16,410232,75.0,68,Viudo,41,2014,5,low,102107,Presencial,2.19,2,Hombre,Ferias & Networking,8,1616000,38.0,78,Divorciado,57,2018,6,low,-0.20000000000000018,0,-8,1205768,1516,0,16,1
103916,102152,1,Híbrida,2.575,1,Mujer,Portal Web,8,721049,75.0,63,Casado,53,2021,9,low,102089,Presencial,2.75,5,Hombre,Portal Web,7,1616000,15.0,68,Soltero,47,2019,8,low,0.17499999999999982,4,-1,894951,-734,1,-6,1
102449,102083,1,Híbrida,2.275,1,Mujer,Linkedin,4,874004,75.0,76,Divorciado,53,2018,1,low,102147,Presencial,1.61,0,Mujer,Portal Web,5,1564490,83.0,71,Soltero,44,2021,2,high,-0.6649999999999998,-1,1,690486,1138,0,-9,0
100569,102047,1,Híbrida,1.655,3,Hombre,Ferias & Networking,3,508781,74.0,80,Soltero,35,2015,5,low,102089,Presencial,2.67,1,Hombre,Linkedin,4,743000,14.0,70,Casado,22,2015,11,low,1.015,-2,1,234219,189,0,-13,0
100561,102013,1,Híbrida,6.77,7,Hombre,Portal Web,7,297610,74.0,74,Casado,38,2012,9,low,102139,Presencial,2.0,2,Mujer,Linkedin,4,743000,96.0,79,Casado,30,2022,11,high,-4.77,-5,-3,445390,3719,0,-8,0
103366,102113,1,Híbrida,1.95,2,Mujer,Linkedin,2,212711,74.0,77,Casado,23,2018,8,low,102041,Presencial,2.96,2,Hombre,Portal Web,6,1152410,46.0,75,Casado,27,2012,1,low,1.01,0,4,939699,-2410,1,4,0
102237,102122,1,Híbrida,5.14,0,Hombre,Referidos,5,807751,74.0,87,Casado,38,2018,12,low,102075,Presencial,1.83,4,Hombre,Portal Web,6,1616000,90.0,66,Viudo,48,2019,3,high,-3.3099999999999996,4,1,808249,83,0,10,0
102762,102083,1,Híbrida,4.425,1,Hombre,Portal Web,4,512103,74.0,82,Casado,38,2018,3,low,102147,Presencial,1.61,0,Mujer,Portal Web,5,1564490,83.0,71,Soltero,44,2021,2,high,-2.8149999999999995,-1,1,1052387,1092,0,6,0
103373,102070,1,Híbrida,1.675,3,Mujer,Portal Web,11,244241,74.0,77,Soltero,38,2017,10,low,102035,Presencial,1.7,1,Mujer,Referidos,4,1616000,77.0,73,Viudo,38,2013,3,low,0.02499999999999991,-2,-7,1371759,-1684,1,0,0
100373,102083,1,Híbrida,4.45,1,Hombre,Portal Web,4,507516,73.0,82,Casado,38,2018,3,low,102147,Presencial,1.61,0,Mujer,Portal Web,5,1564490,83.0,71,Soltero,44,2021,2,high,-2.84,-1,1,1056974,1093,0,6,0
101489,102123,1,Híbrida,3.135,1,Mujer,Ferias & Networking,8,489401,72.0,76,Soltero,39,2019,12,low,102043,Presencial,5.5,1,Mujer,Linkedin,16,1616000,42.0,66,Soltero,51,2021,9,low,2.365,0,8,1126599,634,0,12,0
103909,102123,1,Híbrida,3.165,1,Mujer,Ferias & Networking,8,488462,71.0,76,Soltero,39,2019,12,low,102043,Presencial,5.5,1,Mujer,Linkedin,16,1616000,42.0,66,Soltero,51,2021,9,low,2.335,0,8,1127538,632,0,12,0
101627,102023,1,Híbrida,1.94,0,Hombre,Portal Web,2,101341,70.0,66,Casado,12,2013,5,low,102105,Híbrida,4.9,1,Hombre,Portal Web,4,539000,80.0,65,Casado,23,2019,12,high,2.9600000000000004,1,2,437659,2414,0,11,0
100102,102038,1,Híbrida,2.47,0,Mujer,Linkedin,1,160720,70.0,77,Soltero,17,2014,11,low,102125,Presencial,2.06,1,Hombre,Portal Web,12,1616000,81.0,82,Casado,44,2018,1,high,-0.41000000000000014,1,11,1455280,1148,0,27,0
100328,102036,1,Híbrida,5.01,2,Mujer,Portal Web,6,249722,70.0,61,Soltero,33,2012,12,low,102054,Presencial,1.68,8,Hombre,Portal Web,5,1616000,92.0,76,Viudo,54,2022,1,high,-3.33,6,-1,1366278,3326,0,21,1
101266,102150,1,Híbrida,3.205,1,Mujer,Referidos,7,275056,70.0,83,Soltero,44,2021,12,low,102085,Presencial,3.9,8,Mujer,Portal Web,10,1358450,85.0,75,Casado,32,2012,12,high,0.6949999999999998,7,3,1083394,-3290,1,-12,0
101023,102011,1,Híbrida,2.7,2,Mujer,Portal Web,8,437525,70.0,78,Casado,37,2012,10,low,102048,Presencial,5.37,1,Hombre,Ferias & Networking,7,845000,52.0,74,Casado,22,2012,11,low,2.67,-1,-1,407475,28,0,-15,1
102979,102038,1,Híbrida,2.42,1,Mujer,Linkedin,1,163446,70.0,77,Soltero,17,2014,11,low,102125,Presencial,2.06,1,Hombre,Portal Web,12,1616000,81.0,82,Casado,44,2018,1,high,-0.3599999999999999,0,11,1452554,1148,0,27,1
103943,102099,1,Híbrida,1.81,9,Mujer,Portal Web,5,293493,70.0,83,Soltero,28,2019,6,low,102080,Presencial,1.71,0,Hombre,Portal Web,11,1616000,76.0,80,Viudo,51,2021,10,low,-0.10000000000000009,-9,6,1322507,858,0,23,1
103932,102036,1,Híbrida,4.985,3,Mujer,Portal Web,6,245857,70.0,61,Soltero,33,2012,12,low,102054,Presencial,1.68,8,Hombre,Portal Web,5,1616000,92.0,76,Viudo,54,2022,1,high,-3.3050000000000006,5,-1,1370143,3326,0,21,1
102375,102113,1,Híbrida,1.525,3,Hombre,Linkedin,13,310130,70.0,91,Viudo,45,2019,1,low,102041,Presencial,2.96,2,Hombre,Portal Web,6,1152410,46.0,75,Casado,27,2012,1,low,1.435,-1,-7,842280,-2551,1,-18,0
100432,102134,1,Híbrida,2.865,0,Mujer,Portal Web,12,504390,69.0,67,Casado,42,2022,11,low,102135,Presencial,2.25,2,Hombre,Portal Web,5,1358450,90.0,69,Viudo,31,2012,7,high,-0.6150000000000002,2,-7,854060,-3790,1,-11,1
103341,102134,1,Híbrida,1.345,1,Mujer,Portal Web,12,814350,69.0,64,Casado,49,2021,9,low,102135,Presencial,2.25,2,Hombre,Portal Web,5,1358450,90.0,69,Viudo,31,2012,7,high,0.905,1,-7,544100,-3356,1,-18,1
100673,102049,1,Híbrida,6.77,1,Mujer,Linkedin,1,191691,68.0,84,Casado,16,2012,11,low,102029,Presencial,6.89,0,Mujer,Portal Web,9,1616000,19.0,77,Divorciado,49,2023,3,low,0.1200000000000001,-1,8,1424309,3770,0,33,0
100413,102066,1,Híbrida,4.745,0,Mujer,Portal Web,6,265283,68.0,82,Casado,38,2015,12,low,102171,Presencial,3.62,3,Hombre,Referidos,5,1616000,97.0,84,Casado,55,2023,12,high,-1.125,3,-1,1350717,2922,0,17,0
103818,102131,1,Híbrida,2.93,1,Hombre,Ferias & Networking,2,122117,68.0,74,Soltero,22,2022,8,low,102109,Presencial,5.54,0,Hombre,Linkedin,3,998000,39.0,77,Soltero,34,2021,12,low,2.61,-1,1,875883,-239,1,12,0
102885,102054,1,Híbrida,2.305,2,Mujer,Referidos,3,412006,68.0,79,Casado,29,2014,6,low,102044,Presencial,2.91,1,Hombre,Linkedin,17,1616000,85.0,74,Divorciado,41,2012,11,high,0.605,-1,14,1203994,-577,1,12,1
101856,102064,1,Híbrida,1.94,0,Mujer,Referidos,1,147646,67.0,74,Soltero,18,2017,3,low,102067,Presencial,1.34,0,Hombre,Portal Web,6,1616000,92.0,92,Casado,43,2018,2,high,-0.5999999999999999,0,5,1468354,321,0,25,1
101752,102064,1,Híbrida,6.09,0,Hombre,Ferias & Networking,8,352578,67.0,71,Soltero,27,2015,3,low,102067,Presencial,1.34,0,Hombre,Portal Web,6,1616000,92.0,92,Casado,43,2018,2,high,-4.75,0,-2,1263422,1063,0,16,0
101157,102059,1,Híbrida,4.345,3,Hombre,Ferias & Networking,4,388298,67.0,69,Soltero,31,2016,7,low,102021,Presencial,2.55,2,Hombre,Portal Web,16,1616000,27.0,76,Viudo,50,2019,6,low,-1.795,-1,12,1227702,1057,0,19,1
101192,102150,1,Híbrida,4.255,3,Mujer,Referidos,11,446527,67.0,80,Divorciado,43,2022,6,low,102085,Presencial,3.9,8,Mujer,Portal Web,10,1358450,85.0,75,Casado,32,2012,12,high,-0.355,5,-1,911923,-3477,1,-11,0
101360,102054,1,Híbrida,1.825,3,Hombre,Linkedin,13,270184,67.0,77,Divorciado,38,2016,2,low,102044,Presencial,2.91,1,Hombre,Linkedin,17,1616000,85.0,74,Divorciado,41,2012,11,high,1.0850000000000002,-2,4,1345816,-1184,1,3,1
101217,102115,1,Híbrida,5.25,1,Hombre,Portal Web,12,276006,67.0,71,Casado,42,2018,12,low,102116,Presencial,2.0,2,Mujer,Portal Web,4,1616000,94.0,76,Soltero,35,2018,12,high,-3.25,1,-8,1339994,22,0,-7,1
100562,102051,1,Híbrida,1.155,1,Mujer,Linkedin,8,453873,67.0,75,Casado,38,2015,1,low,102075,Híbrida,1.39,1,Hombre,Portal Web,11,1616000,83.0,76,Casado,46,2019,11,high,0.23499999999999988,0,3,1162127,1760,0,8,1
101749,102116,1,Híbrida,5.085,0,Hombre,Portal Web,3,301763,67.0,81,Casado,46,2021,3,low,102021,Presencial,2.32,0,Mujer,Portal Web,22,1616000,94.0,76,Casado,59,2020,7,high,-2.765,0,19,1314237,-235,1,13,1
103639,102150,1,Híbrida,1.795,1,Hombre,Referidos,5,430626,67.0,72,Casado,39,2023,4,low,102085,Presencial,3.9,8,Mujer,Portal Web,10,1358450,85.0,75,Casado,32,2012,12,high,2.105,7,5,927824,-3780,1,-7,1
103245,102143,1,Híbrida,3.465,2,Mujer,Linkedin,11,831562,67.0,71,Casado,40,2021,10,low,102142,Presencial,1.07,2,Hombre,Portal Web,2,590000,90.0,78,Casado,25,2022,2,high,-2.3949999999999996,0,-9,-241562,118,0,-15,1
103008,102066,1,Híbrida,4.715,0,Mujer,Portal Web,6,272444,67.0,82,Casado,38,2015,12,low,102171,Presencial,3.62,3,Hombre,Referidos,5,1616000,97.0,84,Casado,55,2023,12,high,-1.0949999999999998,3,-1,1343556,2922,0,17,0
102677,102051,1,Híbrida,1.12,1,Mujer,Linkedin,8,458140,67.0,75,Casado,38,2015,1,low,102075,Híbrida,1.39,1,Hombre,Portal Web,11,1616000,83.0,76,Casado,46,2019,11,high,0.2699999999999998,0,3,1157860,1759,0,8,0
101107,102156,1,Híbrida,3.05,3,Hombre,Referidos,7,249006,66.0,73,Soltero,29,2021,11,low,102154,Presencial,4.23,2,Hombre,Portal Web,22,1616000,92.0,76,Soltero,63,2023,12,high,1.1800000000000006,-1,15,1366994,765,0,34,1
101391,102043,1,Híbrida,1.255,1,Hombre,Portal Web,9,431517,66.0,70,Soltero,31,2014,11,low,102051,Presencial,1.03,0,Hombre,Portal Web,5,1616000,60.0,76,Casado,44,2019,5,low,-0.22499999999999987,-1,-4,1184483,1640,0,13,1
100313,102088,1,Híbrida,1.82,9,Mujer,Linkedin,11,795755,66.0,76,Soltero,48,2019,1,low,102139,Presencial,4.96,1,Mujer,Portal Web,3,488000,82.0,65,Soltero,20,2018,4,high,3.1399999999999997,-8,-8,-307755,-271,1,-28,1
102645,102156,1,Híbrida,3.05,3,Hombre,Referidos,7,250892,66.0,73,Soltero,29,2021,11,low,102154,Presencial,4.23,2,Hombre,Portal Web,22,1616000,92.0,76,Soltero,63,2023,12,high,1.1800000000000006,-1,15,1365108,765,0,34,0
103551,102116,1,Híbrida,5.11,1,Hombre,Portal Web,3,293934,66.0,81,Casado,46,2021,3,low,102021,Presencial,2.32,0,Mujer,Portal Web,22,1616000,94.0,76,Casado,59,2020,7,high,-2.7900000000000005,-1,19,1322066,-237,1,13,1
103446,102058,1,Híbrida,5.745,2,Mujer,Portal Web,15,307168,66.0,73,Casado,40,2014,2,low,102172,Presencial,1.4,2,Hombre,Ferias & Networking,11,1616000,75.0,71,Casado,59,2021,2,low,-4.345000000000001,0,-4,1308832,2563,0,19,1
102398,102088,1,Híbrida,1.82,8,Mujer,Linkedin,11,801687,66.0,76,Soltero,48,2019,1,low,102139,Presencial,4.96,1,Mujer,Portal Web,3,488000,82.0,65,Soltero,20,2018,4,high,3.1399999999999997,-7,-8,-313687,-272,1,-28,1
101142,102043,1,Híbrida,6.005,1,Mujer,Linkedin,3,276368,65.0,73,Soltero,39,2015,9,low,102051,Presencial,1.03,0,Hombre,Portal Web,5,1616000,60.0,76,Casado,44,2019,5,low,-4.975,-1,2,1339632,1341,0,5,0
101117,102058,1,Híbrida,5.78,2,Mujer,Portal Web,15,306367,65.0,73,Casado,40,2014,2,low,102172,Presencial,1.4,2,Hombre,Ferias & Networking,11,1616000,75.0,71,Casado,59,2021,2,low,-4.380000000000001,0,-4,1309633,2560,0,19,0
100234,102041,1,Híbrida,1.73,2,Mujer,Linkedin,16,880303,65.0,74,Casado,41,2012,11,low,102147,Presencial,1.29,0,Mujer,Portal Web,8,1616000,44.0,73,Casado,51,2014,5,low,-0.43999999999999995,-2,-8,735697,551,0,10,0
100682,102032,1,Híbrida,3.99,7,Hombre,Portal Web,17,681539,65.0,73,Casado,42,2013,4,low,102065,Presencial,1.78,7,Hombre,Portal Web,14,1616000,42.0,71,Casado,42,2015,11,low,-2.21,0,-3,934461,936,0,0,0
102844,102119,1,Híbrida,7.0,1,Hombre,Portal Web,7,309438,65.0,67,Soltero,32,2021,10,low,102107,Presencial,2.22,2,Hombre,Portal Web,12,1616000,38.0,70,Divorciado,52,2021,1,low,-4.779999999999999,1,5,1306562,-278,1,20,0
102811,102127,1,Híbrida,2.21,1,Mujer,Portal Web,8,332634,65.0,74,Casado,33,2022,3,low,102028,Presencial,4.03,2,Mujer,Linkedin,9,1306940,88.0,78,Divorciado,32,2014,5,high,1.8200000000000003,1,1,974306,-2864,1,-1,0
103086,102043,1,Híbrida,1.255,1,Hombre,Portal Web,9,433068,65.0,70,Soltero,30,2014,11,low,102051,Presencial,1.03,0,Hombre,Portal Web,5,1616000,60.0,76,Casado,44,2019,5,low,-0.22499999999999987,-1,-4,1182932,1642,0,14,1
103827,102127,1,Híbrida,2.175,5,Hombre,Linkedin,7,466606,65.0,80,Soltero,38,2020,5,low,102028,Presencial,4.03,2,Mujer,Linkedin,9,1306940,88.0,78,Divorciado,32,2014,5,high,1.8550000000000004,-3,2,840334,-2199,1,-6,1
102692,102043,1,Híbrida,5.96,0,Mujer,Linkedin,5,277848,65.0,73,Soltero,39,2015,9,low,102051,Presencial,1.03,0,Hombre,Portal Web,5,1616000,60.0,76,Casado,44,2019,5,low,-4.93,0,0,1338152,1340,0,5,1
102345,102041,1,Híbrida,1.72,2,Mujer,Linkedin,16,873142,65.0,74,Casado,41,2012,11,low,102147,Presencial,1.29,0,Mujer,Portal Web,8,1616000,44.0,73,Casado,51,2014,5,low,-0.42999999999999994,-2,-8,742858,553,0,10,1
100594,102066,1,Híbrida,2.205,2,Hombre,Portal Web,4,326363,64.0,62,Soltero,26,2014,10,low,102171,Presencial,3.62,3,Hombre,Referidos,5,1616000,97.0,84,Casado,55,2023,12,high,1.415,1,1,1289637,3346,0,29,1
101913,102098,1,Híbrida,6.615,2,Mujer,Linkedin,6,410746,64.0,73,Casado,34,2019,4,low,102049,Presencial,1.8,1,Mujer,Portal Web,16,1616000,90.0,86,Casado,46,2021,1,high,-4.815,-1,10,1205254,655,0,12,0
101883,102043,1,Híbrida,3.475,1,Mujer,Portal Web,8,701989,64.0,73,Viudo,44,2014,4,low,102051,Presencial,1.03,0,Hombre,Portal Web,5,1616000,60.0,76,Casado,44,2019,5,low,-2.4450000000000003,-1,-3,914011,1855,0,0,1
103156,102066,1,Híbrida,2.18,1,Hombre,Portal Web,4,325576,64.0,62,Soltero,26,2014,10,low,102171,Presencial,3.62,3,Hombre,Referidos,5,1616000,97.0,84,Casado,55,2023,12,high,1.44,2,1,1290424,3345,0,29,0
103445,102043,1,Híbrida,3.515,2,Mujer,Portal Web,8,699135,64.0,73,Viudo,44,2014,4,low,102051,Presencial,1.03,0,Hombre,Portal Web,5,1616000,60.0,76,Casado,44,2019,5,low,-2.4850000000000003,-2,-3,916865,1855,0,0,1
101495,102072,1,Híbrida,1.625,3,Mujer,Referidos,4,408390,63.0,81,Casado,32,2016,8,low,102046,Presencial,2.61,2,Hombre,Ferias & Networking,3,947000,41.0,71,Soltero,30,2018,11,low,0.9849999999999999,-1,-1,538610,840,0,-2,1
100639,102096,1,Híbrida,1.61,1,Hombre,Referidos,13,899871,63.0,82,Soltero,54,2017,7,low,102116,Presencial,5.11,8,Mujer,Linkedin,13,1461470,90.0,74,Soltero,42,2021,5,high,3.5,7,0,561599,1393,0,-12,1
103048,102096,1,Híbrida,1.56,1,Hombre,Referidos,13,894755,63.0,82,Soltero,54,2017,7,low,102116,Presencial,5.11,8,Mujer,Linkedin,13,1461470,90.0,74,Soltero,42,2021,5,high,3.5500000000000003,7,0,566715,1394,0,-12,0
101922,102110,1,Híbrida,3.81,2,Hombre,Portal Web,4,180213,62.0,72,Casado,24,2021,3,low,102045,Presencial,1.6,5,Mujer,Linkedin,2,998000,87.0,76,Soltero,29,2016,11,high,-2.21,3,-2,817787,-1586,1,5,1
100209,102106,1,Híbrida,4.78,3,Hombre,Portal Web,1,188365,62.0,74,Casado,21,2018,3,low,102081,Presencial,1.39,1,Mujer,Ferias & Networking,5,1049000,86.0,86,Soltero,32,2019,6,high,-3.3900000000000006,-2,4,860635,450,0,11,1
100394,102047,1,Híbrida,2.81,2,Mujer,Referidos,4,431825,62.0,88,Casado,29,2013,9,low,102089,Presencial,2.67,1,Hombre,Linkedin,4,743000,14.0,70,Casado,22,2015,11,low,-0.14000000000000012,-1,0,311175,796,0,-7,1
100725,102007,1,Híbrida,1.885,3,Mujer,Portal Web,3,262367,62.0,83,Casado,33,2012,2,low,102070,Presencial,5.11,2,Mujer,Portal Web,6,1358450,96.0,62,Soltero,41,2022,4,high,3.2250000000000005,-1,3,1096083,3728,0,8,0
101829,102094,1,Híbrida,1.65,1,Mujer,Portal Web,9,436689,62.0,86,Casado,41,2018,5,low,102095,Presencial,1.32,1,Hombre,Portal Web,4,998000,90.0,85,Casado,28,2016,2,high,-0.32999999999999985,0,-5,561311,-847,1,-13,0
101781,102034,1,Híbrida,1.59,1,Hombre,Ferias & Networking,3,441939,62.0,81,Soltero,34,2012,3,low,102113,Presencial,7.84,7,Hombre,Linkedin,5,1564490,90.0,70,Casado,35,2012,9,high,6.25,6,2,1122551,180,0,1,0
100927,102171,1,Híbrida,6.565,1,Hombre,Ferias & Networking,3,636092,62.0,74,Casado,50,2022,12,low,102088,Presencial,2.57,4,Hombre,Linkedin,8,1616000,80.0,69,Casado,43,2017,10,high,-3.9950000000000006,3,5,979908,-1885,1,-7,0
104032,102106,1,Híbrida,4.78,3,Hombre,Portal Web,1,184173,62.0,74,Casado,21,2018,3,low,102081,Presencial,1.39,1,Mujer,Ferias & Networking,5,1049000,86.0,86,Soltero,32,2019,6,high,-3.3900000000000006,-2,4,864827,450,0,11,1
102531,102034,1,Híbrida,1.55,1,Hombre,Ferias & Networking,3,439479,62.0,81,Soltero,34,2012,3,low,102113,Presencial,7.84,7,Hombre,Linkedin,5,1564490,90.0,70,Casado,35,2012,9,high,6.29,6,2,1125011,182,0,1,0
102217,102171,1,Híbrida,6.535,0,Hombre,Ferias & Networking,3,634753,62.0,74,Casado,50,2022,12,low,102088,Presencial,2.57,4,Hombre,Linkedin,8,1616000,80.0,69,Casado,43,2017,10,high,-3.9650000000000003,4,5,981247,-1884,1,-7,0
102898,102129,1,Híbrida,2.77,10,Mujer,Portal Web,11,920740,62.0,70,Divorciado,47,2019,9,low,102142,Presencial,2.1,2,Mujer,Linkedin,3,590000,41.0,74,Soltero,24,2020,1,low,-0.6699999999999999,-8,-8,-330740,108,0,-23,1
103899,102100,1,Híbrida,2.215,7,Mujer,Portal Web,8,861106,62.0,79,Soltero,46,2018,5,low,102007,Presencial,3.3,1,Mujer,Portal Web,3,1255430,21.0,59,Casado,30,2013,2,low,1.085,-6,-5,394324,-1914,1,-16,1
100258,102023,1,Híbrida,3.66,1,Hombre,Ferias & Networking,4,293294,61.0,79,Soltero,22,2013,8,low,102105,Híbrida,4.9,1,Hombre,Portal Web,4,539000,80.0,65,Casado,23,2019,12,high,1.2400000000000002,0,0,245706,2317,0,1,0
100183,102038,1,Híbrida,4.84,1,Hombre,Portal Web,7,372545,61.0,73,Soltero,27,2014,5,low,102125,Presencial,2.06,1,Hombre,Portal Web,12,1616000,81.0,82,Casado,44,2018,1,high,-2.78,0,5,1243455,1349,0,17,0
101017,102054,1,Híbrida,1.48,1,Mujer,Linkedin,5,375572,61.0,87,Soltero,35,2014,11,low,102044,Presencial,2.91,1,Hombre,Linkedin,17,1616000,85.0,74,Divorciado,41,2012,11,high,1.4300000000000002,0,12,1240428,-751,1,6,1
101305,102126,1,Híbrida,1.745,2,Hombre,Ferias & Networking,16,719599,61.0,66,Casado,52,2021,1,low,102141,Presencial,2.5,1,Mujer,Referidos,2,1049000,94.0,79,Casado,34,2021,1,high,0.7549999999999999,-1,-14,329401,3,0,-18,1
103203,102094,1,Híbrida,1.645,1,Mujer,Portal Web,9,438623,61.0,86,Casado,41,2018,5,low,102095,Presencial,1.32,1,Hombre,Portal Web,4,998000,90.0,85,Casado,28,2016,2,high,-0.32499999999999996,0,-5,559377,-845,1,-13,1
103303,102054,1,Híbrida,3.715,2,Mujer,Linkedin,16,387454,61.0,73,Casado,41,2015,4,low,102044,Presencial,2.91,1,Hombre,Linkedin,17,1616000,85.0,74,Divorciado,41,2012,11,high,-0.8049999999999997,-1,1,1228546,-895,1,0,1
103467,102126,1,Híbrida,1.735,1,Hombre,Ferias & Networking,16,715730,61.0,66,Casado,52,2021,1,low,102141,Presencial,2.5,1,Mujer,Referidos,2,1049000,94.0,79,Casado,34,2021,1,high,0.7649999999999999,0,-14,333270,1,0,-18,1
101979,102074,1,Híbrida,2.415,11,Mujer,Linkedin,6,388044,60.0,73,Soltero,29,2015,5,low,102028,Presencial,1.35,0,Hombre,Ferias & Networking,4,1616000,80.0,83,Viudo,43,2015,12,high,-1.065,-11,-2,1227956,213,0,14,1
100006,102098,1,Híbrida,1.175,1,Hombre,Portal Web,6,888252,60.0,73,Soltero,38,2018,3,low,102049,Presencial,1.8,1,Mujer,Portal Web,16,1616000,90.0,86,Casado,46,2021,1,high,0.625,0,10,727748,1049,0,8,1
101965,102054,1,Híbrida,3.71,2,Mujer,Linkedin,16,384309,60.0,73,Casado,40,2015,4,low,102044,Presencial,2.91,1,Hombre,Linkedin,17,1616000,85.0,74,Divorciado,41,2012,11,high,-0.7999999999999998,-1,1,1231691,-895,1,1,1
101159,102059,1,Híbrida,2.435,0,Mujer,Linkedin,3,720854,60.0,80,Casado,44,2014,1,low,102021,Presencial,2.55,2,Hombre,Portal Web,16,1616000,27.0,76,Viudo,50,2019,6,low,0.11499999999999977,2,13,895146,1966,0,6,0
103120,102139,1,Híbrida,4.79,2,Mujer,Portal Web,3,208419,60.0,71,Casado,25,2021,3,low,102154,Presencial,6.48,1,Hombre,Ferias & Networking,5,590000,90.0,67,Casado,25,2021,6,high,1.6900000000000004,-1,2,381581,112,0,0,1
102378,102128,1,Híbrida,2.275,11,Mujer,Headhunter,13,299250,60.0,69,Casado,47,2022,8,low,102056,Presencial,4.11,10,Mujer,Portal Web,16,1616000,46.0,72,Soltero,55,2021,2,low,1.8350000000000004,-1,3,1316750,-538,1,8,1
100141,102172,1,Híbrida,2.45,2,Hombre,Portal Web,7,309705,59.0,67,Casado,33,2023,1,low,102020,Presencial,5.58,1,Hombre,Portal Web,7,1049000,57.0,70,Casado,29,2016,4,low,3.13,-1,0,739295,-2459,1,-4,1
101077,102058,1,Híbrida,2.245,9,Mujer,Portal Web,5,352331,59.0,74,Casado,27,2015,4,low,102172,Presencial,1.4,2,Hombre,Ferias & Networking,11,1616000,75.0,71,Casado,59,2021,2,low,-0.8450000000000002,-7,6,1263669,2146,0,32,1
103720,102058,1,Híbrida,2.225,9,Mujer,Portal Web,5,349860,59.0,74,Casado,27,2015,4,low,102172,Presencial,1.4,2,Hombre,Ferias & Networking,11,1616000,75.0,71,Casado,59,2021,2,low,-0.8250000000000002,-7,6,1266140,2147,0,32,1
103825,102098,1,Híbrida,1.175,1,Hombre,Portal Web,6,887930,59.0,73,Soltero,38,2018,3,low,102049,Presencial,1.8,1,Mujer,Portal Web,16,1616000,90.0,86,Casado,46,2021,1,high,0.625,0,10,728070,1049,0,8,1
103461,102082,1,Híbrida,1.84,2,Hombre,Portal Web,5,311450,59.0,77,Divorciado,43,2017,7,low,102050,Presencial,5.5,2,Mujer,Linkedin,7,1616000,81.0,70,Casado,36,2018,8,high,3.66,0,2,1304550,410,0,-7,1
100755,102138,1,Híbrida,4.42,3,Mujer,Linkedin,5,209999,58.0,73,Soltero,28,2023,6,low,102059,Presencial,3.26,1,Hombre,Linkedin,5,1616000,57.0,75,Soltero,44,2018,4,low,-1.1600000000000001,-2,0,1406001,-1889,1,16,1
100892,102155,1,Híbrida,1.855,1,Hombre,Portal Web,5,227457,58.0,73,Soltero,28,2022,2,low,102159,Presencial,1.78,1,Mujer,Ferias & Networking,1,590000,39.0,80,Soltero,20,2016,10,low,-0.07499999999999996,0,-4,362543,-1930,1,-8,1
101087,102042,1,Híbrida,4.515,12,Mujer,Linkedin,3,867443,58.0,81,Casado,35,2015,5,low,102107,Presencial,2.19,2,Hombre,Ferias & Networking,8,1616000,38.0,78,Divorciado,57,2018,6,low,-2.3249999999999997,-10,5,748557,1152,0,22,1
100018,102082,1,Híbrida,1.81,3,Hombre,Portal Web,5,306436,58.0,77,Divorciado,43,2017,7,low,102050,Presencial,5.5,2,Mujer,Linkedin,7,1616000,81.0,70,Casado,36,2018,8,high,3.69,-1,2,1309564,410,0,-7,1
103980,102060,1,Híbrida,1.495,9,Mujer,Linkedin,1,228688,58.0,67,Soltero,20,2014,6,low,102041,Presencial,4.42,3,Hombre,Referidos,16,1616000,82.0,62,Casado,45,2013,10,high,2.925,-6,15,1387312,-218,1,25,1
103862,102059,1,Híbrida,3.975,7,Mujer,Linkedin,11,486257,58.0,74,Casado,35,2015,9,low,102021,Presencial,2.55,2,Hombre,Portal Web,16,1616000,27.0,76,Viudo,50,2019,6,low,-1.4250000000000003,-5,5,1129743,1369,0,15,1
102877,102122,1,Híbrida,3.585,0,Hombre,Linkedin,5,378054,58.0,70,Soltero,41,2020,2,low,102075,Presencial,1.83,4,Hombre,Portal Web,6,1616000,90.0,66,Viudo,48,2019,3,high,-1.755,4,1,1237946,-344,1,7,0
101114,102157,1,Híbrida,2.905,1,Mujer,Linkedin,1,139506,57.0,72,Soltero,23,2023,3,low,102130,Presencial,0.73,1,Mujer,Portal Web,6,1616000,85.0,66,Viudo,44,2015,8,high,-2.175,0,5,1476494,-2768,1,21,1
101346,102005,1,Híbrida,1.62,1,Hombre,Linkedin,5,227118,57.0,76,Casado,17,2012,1,low,102075,Presencial,3.25,2,Hombre,Portal Web,15,1616000,90.0,65,Soltero,47,2017,2,high,1.63,1,10,1388882,1831,0,30,0
100742,102143,1,Híbrida,0.79,4,Mujer,Referidos,8,367633,57.0,76,Casado,34,2020,12,low,102142,Presencial,1.07,2,Hombre,Portal Web,2,590000,90.0,78,Casado,25,2022,2,high,0.28,-2,-6,222367,403,0,-9,0
101414,102115,1,Híbrida,2.56,0,Hombre,Portal Web,8,451028,57.0,70,Casado,36,2019,5,low,102116,Presencial,2.0,2,Mujer,Portal Web,4,1616000,94.0,76,Soltero,35,2018,12,high,-0.56,2,-4,1164972,-148,1,-1,1
101916,102059,1,Híbrida,3.975,7,Mujer,Linkedin,11,484369,57.0,74,Casado,35,2015,9,low,102021,Presencial,2.55,2,Hombre,Portal Web,16,1616000,27.0,76,Viudo,50,2019,6,low,-1.4250000000000003,-5,5,1131631,1366,0,15,1
100613,102122,1,Híbrida,3.59,1,Hombre,Linkedin,5,376973,57.0,70,Casado,41,2020,2,low,102075,Presencial,1.83,4,Hombre,Portal Web,6,1616000,90.0,66,Viudo,48,2019,3,high,-1.7599999999999998,3,1,1239027,-343,1,7,0
100874,102040,1,Híbrida,1.87,1,Mujer,Portal Web,12,297248,57.0,73,Casado,39,2014,1,low,102106,Presencial,3.21,1,Hombre,Linkedin,15,1616000,91.0,84,Soltero,45,2016,7,high,1.3399999999999999,0,3,1318752,925,0,6,1
100880,102144,1,Híbrida,7.18,2,Hombre,Linkedin,11,877895,57.0,76,Casado,54,2021,10,low,102156,Presencial,2.13,8,Mujer,Portal Web,11,1616000,5.0,82,Viudo,58,2015,6,low,-5.05,6,0,738105,-2302,1,4,1
104131,102157,1,Híbrida,2.875,2,Mujer,Linkedin,1,138253,57.0,72,Soltero,23,2023,3,low,102130,Presencial,0.73,1,Mujer,Portal Web,6,1616000,85.0,66,Viudo,44,2015,8,high,-2.145,-1,5,1477747,-2767,1,21,0
103829,102155,1,Híbrida,1.83,1,Hombre,Portal Web,5,233584,57.0,73,Soltero,28,2022,2,low,102159,Presencial,1.78,1,Mujer,Ferias & Networking,1,590000,39.0,80,Soltero,20,2016,10,low,-0.050000000000000044,0,-4,356416,-1929,1,-8,1
102513,102005,1,Híbrida,1.645,2,Hombre,Linkedin,5,225252,57.0,76,Casado,18,2012,1,low,102075,Presencial,3.25,2,Hombre,Portal Web,15,1616000,90.0,65,Soltero,47,2017,2,high,1.605,0,10,1390748,1832,0,29,0
102768,102125,1,Híbrida,5.86,3,Mujer,Portal Web,14,278416,57.0,74,Casado,45,2021,8,low,102096,Híbrida,4.0,2,Mujer,Referidos,5,692000,87.0,82,Casado,29,2022,7,high,-1.8600000000000003,-1,-9,413584,332,0,-16,0
101080,102124,1,Híbrida,2.68,2,Mujer,Ferias & Networking,15,405800,56.0,73,Casado,43,2020,10,low,102099,Presencial,2.84,2,Mujer,Linkedin,4,947000,90.0,70,Soltero,24,2012,10,high,0.1599999999999997,0,-11,541200,-2911,1,-19,0
100303,102026,1,Híbrida,1.34,1,Hombre,Portal Web,17,780925,56.0,73,Casado,40,2012,10,low,102101,Presencial,2.7,1,Mujer,Portal Web,15,1616000,97.0,79,Casado,58,2017,6,high,1.36,0,-2,835075,1714,0,18,1
101648,102127,1,Híbrida,2.935,2,Hombre,Linkedin,11,816347,56.0,80,Divorciado,50,2022,3,low,102028,Presencial,4.03,2,Mujer,Linkedin,9,1306940,88.0,78,Divorciado,32,2014,5,high,1.0950000000000002,0,-2,490593,-2853,1,-18,1
101764,102041,1,Híbrida,1.775,2,Hombre,Portal Web,13,796089,56.0,69,Soltero,44,2015,1,low,102147,Presencial,1.29,0,Mujer,Portal Web,8,1616000,44.0,73,Casado,51,2014,5,low,-0.4849999999999999,-2,-5,819911,-257,1,7,1
100773,102092,1,Híbrida,5.38,1,Mujer,Linkedin,9,858981,56.0,82,Divorciado,49,2017,4,low,102120,Presencial,1.23,6,Mujer,Linkedin,13,1616000,98.0,95,Viudo,41,2013,6,high,-4.15,5,4,757019,-1399,1,-8,0
102928,102026,1,Híbrida,1.31,1,Hombre,Portal Web,17,779137,56.0,73,Casado,40,2012,10,low,102101,Presencial,2.7,1,Mujer,Portal Web,15,1616000,97.0,79,Casado,58,2017,6,high,1.3900000000000001,0,-2,836863,1717,0,18,0
103701,102127,1,Híbrida,2.91,2,Hombre,Linkedin,11,819769,56.0,80,Divorciado,50,2022,3,low,102028,Presencial,4.03,2,Mujer,Linkedin,9,1306940,88.0,78,Divorciado,32,2014,5,high,1.12,0,-2,487171,-2853,1,-18,1
100131,102158,1,Híbrida,2.075,1,Mujer,Referidos,6,845919,55.0,73,Casado,41,2022,2,low,102093,Presencial,1.79,1,Mujer,Referidos,27,1900000,87.0,74,Viudo,54,2013,9,high,-0.28500000000000014,0,21,1054081,-3063,1,13,0
100525,102101,1,Híbrida,4.115,2,Mujer,Portal Web,9,306308,55.0,74,Soltero,45,2019,3,low,102089,Presencial,6.23,0,Hombre,Portal Web,26,1616000,92.0,68,Divorciado,55,2014,1,high,2.115,-2,17,1309692,-1903,1,10,1
101671,102140,1,Híbrida,1.94,0,Mujer,Referidos,6,736416,55.0,66,Soltero,53,2021,8,low,102040,Presencial,2.55,0,Mujer,Portal Web,16,1616000,46.0,69,Casado,39,2012,2,low,0.6099999999999999,0,10,879584,-3475,1,-14,1
100108,102051,1,Híbrida,2.585,2,Mujer,Portal Web,7,882067,55.0,79,Viudo,49,2013,5,low,102075,Híbrida,1.39,1,Hombre,Portal Web,11,1616000,83.0,76,Casado,46,2019,11,high,-1.195,-1,4,733933,2383,0,-3,1
101610,102143,1,Híbrida,5.95,2,Hombre,Portal Web,12,792368,54.0,73,Casado,42,2022,12,low,102142,Presencial,1.07,2,Hombre,Portal Web,2,590000,90.0,78,Casado,25,2022,2,high,-4.88,0,-10,-202368,-312,1,-17,0
101138,102049,1,Híbrida,3.295,3,Mujer,Portal Web,5,271617,54.0,79,Soltero,37,2015,9,low,102029,Presencial,6.89,0,Mujer,Portal Web,9,1616000,19.0,77,Divorciado,49,2023,3,low,3.5949999999999998,-3,4,1344383,2732,0,12,0
100205,102054,1,Híbrida,5.885,2,Hombre,Portal Web,14,319152,54.0,73,Casado,40,2013,9,low,102044,Presencial,2.91,1,Hombre,Linkedin,17,1616000,85.0,74,Divorciado,41,2012,11,high,-2.9749999999999996,-1,3,1296848,-313,1,1,0
102351,102143,1,Híbrida,5.955,2,Hombre,Portal Web,12,788750,54.0,73,Casado,42,2022,12,low,102142,Presencial,1.07,2,Hombre,Portal Web,2,590000,90.0,78,Casado,25,2022,2,high,-4.885,0,-10,-198750,-309,1,-17,0
102592,102158,1,Híbrida,2.065,1,Mujer,Referidos,6,845070,54.0,73,Casado,41,2022,2,low,102093,Presencial,1.79,1,Mujer,Referidos,27,1900000,87.0,74,Viudo,54,2013,9,high,-0.2749999999999999,0,21,1054930,-3064,1,13,1
103035,102075,1,Híbrida,2.56,2,Mujer,Portal Web,7,279918,54.0,71,Soltero,39,2016,4,low,102047,Presencial,2.7,1,Hombre,Referidos,11,1255430,90.0,76,Casado,30,2013,3,high,0.14000000000000012,-1,4,975512,-1103,1,-9,1
102637,102054,1,Híbrida,5.875,3,Hombre,Portal Web,14,314891,54.0,73,Casado,40,2013,9,low,102044,Presencial,2.91,1,Hombre,Linkedin,17,1616000,85.0,74,Divorciado,41,2012,11,high,-2.965,-2,3,1301109,-315,1,1,1
100213,102085,1,Híbrida,1.185,2,Hombre,Linkedin,5,298419,53.0,70,Casado,44,2019,5,low,102145,Presencial,6.59,4,Hombre,Portal Web,12,1616000,47.0,71,Casado,39,2015,8,low,5.404999999999999,2,7,1317581,-1386,1,-5,1
101742,102075,1,Híbrida,3.055,1,Hombre,Linkedin,7,326885,51.0,73,Casado,26,2015,1,low,102047,Presencial,2.7,1,Hombre,Referidos,11,1255430,90.0,76,Casado,30,2013,3,high,-0.355,0,4,928545,-671,1,4,0
100660,102133,1,Híbrida,6.645,0,Hombre,Headhunter,3,117694,48.0,75,Soltero,21,2022,12,low,102151,Híbrida,2.61,2,Hombre,Linkedin,4,1255430,98.0,65,Soltero,35,2018,2,high,-4.035,2,1,1137736,-1756,1,14,0
101437,102040,1,Híbrida,1.35,1,Hombre,Referidos,2,293473,48.0,78,Soltero,22,2012,9,low,102106,Presencial,3.21,1,Hombre,Linkedin,15,1616000,91.0,84,Soltero,45,2016,7,high,1.8599999999999999,0,13,1322527,1399,0,23,0
101937,102048,1,Híbrida,6.48,6,Hombre,Linkedin,6,370877,48.0,78,Soltero,26,2012,10,low,102092,Presencial,3.99,0,Mujer,Portal Web,5,590000,59.0,76,Soltero,20,2015,8,low,-2.49,-6,-1,219123,1037,0,-6,1
100823,102022,1,Híbrida,0.935,1,Mujer,Ferias & Networking,3,452782,48.0,81,Casado,30,2013,2,low,102081,Presencial,2.07,0,Hombre,Portal Web,6,1616000,94.0,66,Viudo,47,2020,5,high,1.1349999999999998,-1,3,1163218,2653,0,17,1
100593,102061,1,Híbrida,1.615,1,Hombre,Portal Web,7,291313,48.0,73,Casado,39,2015,2,low,102115,Presencial,2.14,2,Hombre,Ferias & Networking,10,1203920,37.0,80,Casado,29,2012,11,low,0.5250000000000001,1,3,912607,-833,1,-10,0
101260,102107,1,Híbrida,6.03,2,Hombre,Portal Web,7,719519,48.0,74,Divorciado,52,2020,10,low,102069,Presencial,2.4,1,Mujer,Linkedin,8,1616000,47.0,79,Casado,63,2023,6,low,-3.6300000000000003,-1,1,896481,978,0,11,1
104057,102107,1,Híbrida,3.095,8,Hombre,Linkedin,1,119013,48.0,77,Soltero,17,2018,6,low,102069,Presencial,2.4,1,Mujer,Linkedin,8,1616000,47.0,79,Casado,63,2023,6,low,-0.6950000000000003,-7,7,1496987,1826,0,46,1
103900,102071,1,Híbrida,3.705,12,Mujer,Portal Web,3,388637,48.0,76,Casado,31,2017,9,low,102171,Presencial,0.87,1,Hombre,Portal Web,11,1616000,85.0,72,Viudo,51,2023,11,high,-2.835,-11,8,1227363,2258,0,20,1
103263,102109,1,Híbrida,2.655,8,Mujer,Portal Web,9,390401,48.0,61,Soltero,32,2018,2,low,102123,Presencial,3.86,1,Mujer,Portal Web,5,998000,97.0,82,Casado,32,2019,9,high,1.205,-7,-4,607599,599,0,0,1
102263,102061,1,Híbrida,1.63,1,Hombre,Linkedin,7,291908,48.0,73,Casado,39,2015,2,low,102115,Presencial,2.14,2,Hombre,Ferias & Networking,10,1203920,37.0,80,Casado,29,2012,11,low,0.5100000000000002,1,3,912012,-832,1,-10,0
103992,102107,1,Híbrida,6.075,2,Hombre,Portal Web,7,715809,48.0,74,Divorciado,52,2020,10,low,102069,Presencial,2.4,1,Mujer,Linkedin,8,1616000,47.0,79,Casado,63,2023,6,low,-3.6750000000000003,-1,1,900191,981,0,11,1
100321,102122,1,Híbrida,4.425,1,Hombre,Ferias & Networking,2,138884,47.0,77,Soltero,21,2020,7,low,102075,Presencial,1.83,4,Hombre,Portal Web,6,1616000,90.0,66,Viudo,48,2019,3,high,-2.5949999999999998,3,4,1477116,-498,1,27,0
101884,102066,1,Híbrida,1.525,1,Mujer,Ferias & Networking,1,141515,47.0,65,Soltero,17,2016,10,low,102171,Presencial,3.62,3,Hombre,Referidos,5,1616000,97.0,84,Casado,55,2023,12,high,2.095,2,4,1474485,2617,0,38,1
101808,102087,1,Híbrida,6.705,0,Hombre,Ferias & Networking,4,190571,47.0,73,Soltero,21,2017,9,low,102111,Presencial,7.16,9,Mujer,Linkedin,10,1616000,98.0,79,Casado,42,2012,5,high,0.45500000000000007,9,6,1425429,-1944,1,21,0
101377,102076,1,Híbrida,3.665,3,Mujer,Portal Web,5,210110,47.0,88,Soltero,21,2015,10,low,102168,Híbrida,1.95,1,Hombre,Referidos,9,1616000,95.0,82,Soltero,53,2023,9,high,-1.715,-2,4,1405890,2881,0,32,1
100184,102034,1,Híbrida,3.455,0,Mujer,Referidos,4,272993,47.0,79,Casado,23,2014,5,low,102113,Presencial,7.84,7,Hombre,Linkedin,5,1564490,90.0,70,Casado,35,2012,9,high,4.385,7,1,1291497,-608,1,12,0
100222,102143,1,Híbrida,3.21,0,Mujer,Referidos,3,308772,47.0,67,Soltero,32,2022,1,low,102142,Presencial,1.07,2,Hombre,Portal Web,2,590000,90.0,78,Casado,25,2022,2,high,-2.1399999999999997,2,-1,281228,8,0,-7,1
101821,102041,1,Híbrida,1.945,6,Hombre,Portal Web,11,808515,47.0,73,Casado,33,2013,5,low,102147,Presencial,1.29,0,Mujer,Portal Web,8,1616000,44.0,73,Casado,51,2014,5,low,-0.655,-6,-3,807485,374,0,18,1
101496,102139,1,Híbrida,4.42,3,Hombre,Portal Web,7,379521,47.0,84,Casado,42,2021,5,low,102154,Presencial,6.48,1,Hombre,Ferias & Networking,5,590000,90.0,67,Casado,25,2021,6,high,2.0600000000000005,-2,-2,210479,37,0,-17,1
103719,102133,1,Híbrida,6.635,1,Hombre,Headhunter,3,122608,47.0,75,Soltero,22,2022,12,low,102151,Híbrida,2.61,2,Hombre,Linkedin,4,1255430,98.0,65,Soltero,35,2018,2,high,-4.025,1,1,1132822,-1757,1,13,1
102424,102122,1,Híbrida,4.46,1,Hombre,Ferias & Networking,2,143239,47.0,77,Soltero,21,2020,7,low,102075,Presencial,1.83,4,Hombre,Portal Web,6,1616000,90.0,66,Viudo,48,2019,3,high,-2.63,3,4,1472761,-495,1,27,1
103837,102076,1,Híbrida,3.65,2,Mujer,Portal Web,3,205787,47.0,88,Soltero,21,2015,10,low,102168,Híbrida,1.95,1,Hombre,Referidos,9,1616000,95.0,82,Soltero,53,2023,9,high,-1.7,-1,6,1410213,2880,0,32,1
102231,102060,1,Híbrida,5.385,1,Hombre,Referidos,10,390157,47.0,74,Casado,29,2015,8,low,102041,Presencial,4.42,3,Hombre,Referidos,16,1616000,82.0,62,Casado,45,2013,10,high,-0.9649999999999999,2,6,1225843,-653,1,16,0
103220,102095,1,Híbrida,2.6,8,Mujer,Linkedin,6,468602,47.0,82,Soltero,36,2018,5,low,102171,Presencial,3.28,2,Mujer,Portal Web,3,1616000,80.0,75,Soltero,42,2023,10,high,0.6799999999999997,-6,-3,1147398,1969,0,6,1
102651,102129,1,Híbrida,0.81,1,Mujer,Referidos,12,297912,47.0,72,Viudo,48,2023,1,low,102142,Presencial,2.1,2,Mujer,Linkedin,3,590000,41.0,74,Soltero,24,2020,1,low,1.29,1,-9,292088,-1097,1,-24,0
104171,102138,1,Híbrida,0.965,3,Hombre,Portal Web,5,309194,47.0,77,Soltero,48,2022,12,low,102059,Presencial,3.26,1,Hombre,Linkedin,5,1616000,57.0,75,Soltero,44,2018,4,low,2.295,-2,0,1306806,-1726,1,-4,0
100352,102086,1,Híbrida,1.755,3,Hombre,Referidos,1,209654,46.0,73,Casado,21,2016,6,low,102085,Presencial,2.22,2,Mujer,Linkedin,7,1306940,87.0,68,Divorciado,39,2021,3,high,0.4650000000000003,-1,6,1097286,1717,0,18,1
101015,102017,1,Híbrida,4.525,2,Hombre,Referidos,6,229910,46.0,79,Casado,19,2013,10,low,102035,Presencial,4.62,0,Mujer,Linkedin,2,641000,90.0,84,Casado,25,2019,11,high,0.09499999999999975,-2,-4,411090,2229,0,6,1
101615,102139,1,Híbrida,2.155,1,Hombre,Linkedin,4,331027,46.0,74,Soltero,33,2022,7,low,102154,Presencial,6.48,1,Hombre,Ferias & Networking,5,590000,90.0,67,Casado,25,2021,6,high,4.325000000000001,0,1,258973,-384,1,-8,0
101556,102093,1,Híbrida,1.57,9,Hombre,Portal Web,6,412516,46.0,79,Casado,33,2017,11,low,102139,Presencial,5.41,0,Mujer,Ferias & Networking,4,488000,89.0,62,Soltero,23,2021,6,high,3.84,-9,-2,75484,1308,0,-10,1
100080,102039,1,Híbrida,1.255,1,Hombre,Referidos,8,381051,46.0,72,Soltero,35,2014,5,low,102054,Presencial,3.66,0,Hombre,Referidos,5,1616000,93.0,75,Viudo,49,2018,6,high,2.4050000000000002,-1,-3,1234949,1495,0,14,0
101907,102120,1,Híbrida,7.605,1,Hombre,Ferias & Networking,8,429209,46.0,73,Soltero,44,2022,1,low,102171,Presencial,6.48,2,Hombre,Ferias & Networking,9,1616000,80.0,71,Casado,47,2023,8,high,-1.125,1,1,1186791,580,0,3,1
101643,102013,1,Híbrida,2.235,3,Hombre,Referidos,7,271911,46.0,74,Casado,34,2012,5,low,102139,Presencial,2.0,2,Mujer,Linkedin,4,743000,96.0,79,Casado,30,2022,11,high,-0.23499999999999988,-1,-3,471089,3827,0,-4,1
101893,102127,1,Híbrida,2.39,1,Hombre,Linkedin,11,718883,46.0,86,Divorciado,53,2021,7,low,102028,Presencial,4.03,2,Mujer,Linkedin,9,1306940,88.0,78,Divorciado,32,2014,5,high,1.6400000000000001,1,-2,588057,-2614,1,-21,1
102982,102017,1,Híbrida,4.555,2,Hombre,Referidos,6,233623,46.0,79,Casado,19,2013,10,low,102035,Presencial,4.62,0,Mujer,Linkedin,2,641000,90.0,84,Casado,25,2019,11,high,0.06500000000000039,-2,-4,407377,2229,0,6,0
102591,102034,1,Híbrida,3.42,0,Mujer,Referidos,4,266804,46.0,79,Casado,23,2014,5,low,102113,Presencial,7.84,7,Hombre,Linkedin,5,1564490,90.0,70,Casado,35,2012,9,high,4.42,7,1,1297686,-608,1,12,0
104096,102093,1,Híbrida,1.56,9,Hombre,Portal Web,6,410803,46.0,79,Casado,33,2017,11,low,102139,Presencial,5.41,0,Mujer,Ferias & Networking,4,488000,89.0,62,Soltero,23,2021,6,high,3.85,-9,-2,77197,1309,0,-10,1
103039,102013,1,Híbrida,2.26,3,Hombre,Referidos,7,271278,46.0,74,Casado,34,2012,5,low,102139,Presencial,2.0,2,Mujer,Linkedin,4,743000,96.0,79,Casado,30,2022,11,high,-0.2599999999999998,-1,-3,471722,3826,0,-4,1
103997,102137,1,Híbrida,3.905,1,Hombre,Linkedin,16,795692,46.0,73,Casado,51,2022,3,low,102046,Presencial,1.18,0,Mujer,Portal Web,2,845000,37.0,79,Casado,27,2017,12,low,-2.7249999999999996,-1,-14,49308,-1533,1,-24,1
103944,102101,1,Híbrida,1.87,0,Mujer,Portal Web,7,696011,46.0,73,Divorciado,48,2018,1,low,102089,Presencial,6.23,0,Hombre,Portal Web,26,1616000,92.0,68,Divorciado,55,2014,1,high,4.36,0,19,919989,-1483,1,7,1
102803,102013,1,Híbrida,3.66,3,Mujer,Portal Web,13,697247,46.0,85,Casado,42,2012,5,low,102139,Presencial,2.0,2,Mujer,Linkedin,4,743000,96.0,79,Casado,30,2022,11,high,-1.6600000000000001,-1,-9,45753,3827,0,-12,0
103411,102121,1,Híbrida,6.945,1,Hombre,Linkedin,8,719647,46.0,78,Casado,50,2019,8,low,102127,Híbrida,1.63,2,Hombre,Portal Web,4,1616000,90.0,77,Divorciado,44,2012,2,high,-5.315,1,-4,896353,-2733,1,-6,1
102567,102107,1,Híbrida,3.535,6,Mujer,Portal Web,10,722206,46.0,73,Divorciado,49,2017,10,low,102069,Presencial,2.4,1,Mujer,Linkedin,8,1616000,47.0,79,Casado,63,2023,6,low,-1.1350000000000002,-5,-2,893794,2077,0,14,0
101535,102064,1,Híbrida,4.95,8,Hombre,Portal Web,1,187072,45.0,66,Soltero,18,2015,8,low,102067,Presencial,1.34,0,Hombre,Portal Web,6,1616000,92.0,92,Casado,43,2018,2,high,-3.6100000000000003,-8,5,1428928,915,0,25,1
100129,102104,1,Híbrida,1.64,2,Mujer,Linkedin,15,451017,45.0,81,Divorciado,45,2019,11,low,102129,Híbrida,6.72,1,Mujer,Portal Web,6,743000,91.0,61,Soltero,30,2023,4,high,5.08,-1,-9,291983,1229,0,-15,0
101632,102096,1,Híbrida,0.795,3,Hombre,Portal Web,4,299979,45.0,77,Viudo,43,2017,11,low,102116,Presencial,5.11,8,Mujer,Linkedin,13,1461470,90.0,74,Soltero,42,2021,5,high,4.315,5,9,1161491,1274,0,-1,1
101738,102063,1,Híbrida,2.18,2,Hombre,Ferias & Networking,4,696418,45.0,65,Casado,47,2016,11,low,102135,Presencial,2.73,0,Mujer,Linkedin,1,539000,26.0,75,Soltero,24,2021,4,low,0.5499999999999998,-2,-3,-157418,1600,0,-23,1
100412,102073,1,Híbrida,2.885,2,Hombre,Ferias & Networking,6,742078,45.0,72,Divorciado,49,2016,11,low,102139,Presencial,1.98,2,Hombre,Portal Web,11,1306940,95.0,86,Soltero,37,2019,7,high,-0.9049999999999998,0,5,564862,965,0,-12,0
102833,102137,1,Híbrida,2.86,2,Mujer,Referidos,3,121964,45.0,81,Soltero,22,2022,6,low,102046,Presencial,1.18,0,Mujer,Portal Web,2,845000,37.0,79,Casado,27,2017,12,low,-1.68,-2,-1,723036,-1633,1,5,0
102458,102017,1,Híbrida,1.68,2,Mujer,Portal Web,1,188444,45.0,68,Soltero,14,2012,2,low,102035,Presencial,4.62,0,Mujer,Linkedin,2,641000,90.0,84,Casado,25,2019,11,high,2.9400000000000004,-2,1,452556,2831,0,11,1
102922,102039,1,Híbrida,1.275,1,Hombre,Referidos,8,378363,45.0,72,Soltero,35,2014,5,low,102054,Presencial,3.66,0,Hombre,Referidos,5,1616000,93.0,75,Viudo,49,2018,6,high,2.3850000000000002,-1,-3,1237637,1493,0,14,0
103324,102143,1,Híbrida,2.08,1,Mujer,Referidos,6,421668,45.0,74,Viudo,48,2023,3,low,102142,Presencial,1.07,2,Hombre,Portal Web,2,590000,90.0,78,Casado,25,2022,2,high,-1.01,1,-4,168332,-397,1,-23,1
103625,102096,1,Híbrida,0.805,3,Hombre,Portal Web,4,301187,45.0,77,Viudo,43,2017,11,low,102116,Presencial,5.11,8,Mujer,Linkedin,13,1461470,90.0,74,Soltero,42,2021,5,high,4.305000000000001,5,9,1160283,1275,0,-1,1
102420,102073,1,Híbrida,2.89,1,Hombre,Ferias & Networking,6,740718,45.0,72,Divorciado,49,2016,11,low,102139,Presencial,1.98,2,Hombre,Portal Web,11,1306940,95.0,86,Soltero,37,2019,7,high,-0.9100000000000001,1,5,566222,967,0,-12,0
100752,102126,1,Híbrida,3.055,2,Mujer,Referidos,2,207394,44.0,83,Casado,23,2019,5,low,102141,Presencial,2.5,1,Mujer,Referidos,2,1049000,94.0,79,Casado,34,2021,1,high,-0.5550000000000002,-1,0,841606,615,0,11,0
101784,102120,1,Híbrida,3.89,1,Mujer,Portal Web,4,227078,44.0,81,Casado,26,2020,5,low,102171,Presencial,6.48,2,Hombre,Ferias & Networking,9,1616000,80.0,71,Casado,47,2023,8,high,2.5900000000000003,1,5,1388922,1187,0,21,1
100518,102149,1,Híbrida,7.54,3,Hombre,Ferias & Networking,13,271200,44.0,81,Soltero,44,2022,6,low,102141,Presencial,2.07,0,Mujer,Headhunter,3,1409960,90.0,86,Casado,37,2017,2,high,-5.470000000000001,-3,-10,1138760,-1944,1,-7,1
101307,102036,1,Híbrida,1.42,9,Hombre,Portal Web,14,662375,44.0,73,Divorciado,40,2012,10,low,102054,Presencial,1.68,8,Hombre,Portal Web,5,1616000,92.0,76,Viudo,54,2022,1,high,0.26,-1,-9,953625,3358,0,14,1
100366,102111,1,Híbrida,2.225,1,Hombre,Portal Web,9,700796,44.0,70,Casado,49,2018,12,low,102097,Híbrida,2.04,1,Mujer,Referidos,15,1616000,94.0,67,Soltero,50,2021,5,high,-0.18500000000000005,0,6,915204,870,0,1,1
103357,102120,1,Híbrida,3.895,1,Mujer,Portal Web,4,227779,44.0,81,Casado,26,2020,5,low,102171,Presencial,6.48,2,Hombre,Ferias & Networking,9,1616000,80.0,71,Casado,47,2023,8,high,2.5850000000000004,1,5,1388221,1185,0,21,1
103316,102048,1,Híbrida,0.92,2,Mujer,Linkedin,9,825032,44.0,81,Soltero,36,2015,7,low,102092,Presencial,3.99,0,Mujer,Portal Web,5,590000,59.0,76,Soltero,20,2015,8,low,3.0700000000000003,-2,-4,-235032,25,0,-16,1
103797,102045,1,Híbrida,2.515,2,Hombre,Linkedin,6,682087,44.0,76,Divorciado,45,2015,6,low,102171,Presencial,3.19,3,Hombre,Portal Web,11,1616000,97.0,65,Casado,53,2023,9,high,0.6749999999999998,1,5,933913,3021,0,8,0
102774,102131,1,Híbrida,6.81,1,Hombre,Ferias & Networking,6,876374,44.0,76,Casado,51,2021,3,low,102109,Presencial,5.54,0,Hombre,Linkedin,3,998000,39.0,77,Soltero,34,2021,12,low,-1.2699999999999996,-1,-3,121626,287,0,-17,1
103560,102111,1,Híbrida,2.24,1,Hombre,Portal Web,9,700062,44.0,70,Casado,49,2018,12,low,102097,Híbrida,2.04,1,Mujer,Referidos,15,1616000,94.0,67,Soltero,50,2021,5,high,-0.20000000000000018,0,6,915938,869,0,1,1
103091,102063,1,Híbrida,2.17,2,Hombre,Ferias & Networking,4,700944,44.0,65,Casado,47,2016,11,low,102135,Presencial,2.73,0,Mujer,Linkedin,1,539000,26.0,75,Soltero,24,2021,4,low,0.56,-2,-3,-161944,1600,0,-23,1
100621,102103,1,Híbrida,1.84,1,Hombre,Portal Web,1,164260,43.0,65,Soltero,21,2019,6,low,102023,Presencial,1.69,6,Hombre,Portal Web,3,1616000,90.0,74,Casado,45,2013,5,high,-0.15000000000000013,5,2,1451740,-2227,1,24,1
101567,102033,1,Híbrida,2.035,3,Hombre,Ferias & Networking,5,203292,43.0,76,Casado,18,2013,12,low,102172,Presencial,6.25,2,Mujer,Portal Web,16,1616000,90.0,79,Divorciado,39,2014,5,high,4.215,-1,11,1412708,137,0,21,0
100582,102113,1,Híbrida,3.13,0,Mujer,Linkedin,7,792301,43.0,73,Casado,33,2018,3,low,102041,Presencial,2.96,2,Hombre,Portal Web,6,1152410,46.0,75,Casado,27,2012,1,low,-0.16999999999999993,2,-1,360109,-2255,1,-6,1
100853,102020,1,Híbrida,0.925,2,Mujer,Linkedin,4,445456,43.0,78,Soltero,31,2013,9,low,102134,Presencial,6.63,1,Mujer,Linkedin,11,1203920,90.0,78,Casado,35,2018,12,high,5.705,-1,7,758464,1911,0,4,0
102805,102103,1,Híbrida,1.83,2,Hombre,Portal Web,1,163838,43.0,65,Soltero,21,2019,6,low,102023,Presencial,1.69,6,Hombre,Portal Web,3,1616000,90.0,74,Casado,45,2013,5,high,-0.14000000000000012,4,2,1452162,-2228,1,24,1
102447,102056,1,Híbrida,1.68,0,Hombre,Ferias & Networking,3,142580,43.0,81,Soltero,17,2016,2,low,102014,Presencial,5.24,1,Hombre,Ferias & Networking,16,1616000,70.0,63,Viudo,65,2023,3,low,3.5600000000000005,1,13,1473420,2586,0,48,0
103390,102033,1,Híbrida,2.05,2,Hombre,Ferias & Networking,5,207455,43.0,76,Casado,18,2013,12,low,102172,Presencial,6.25,2,Mujer,Portal Web,16,1616000,90.0,79,Divorciado,39,2014,5,high,4.2,0,11,1408545,137,0,21,1
103542,102075,1,Híbrida,0.805,3,Mujer,Portal Web,4,276394,43.0,81,Soltero,40,2016,10,low,102047,Presencial,2.7,1,Hombre,Referidos,11,1255430,90.0,76,Casado,30,2013,3,high,1.895,-2,7,979036,-1309,1,-10,1
101523,102076,1,Híbrida,1.08,2,Mujer,Linkedin,1,147171,42.0,72,Soltero,18,2017,1,low,102168,Híbrida,1.95,1,Hombre,Referidos,9,1616000,95.0,82,Soltero,53,2023,9,high,0.8699999999999999,-1,8,1468829,2417,0,35,1
100550,102010,1,Híbrida,1.695,2,Mujer,Linkedin,3,213243,42.0,74,Divorciado,17,2012,1,low,102035,Presencial,2.02,0,Mujer,Linkedin,5,1564490,77.0,73,Casado,44,2021,8,low,0.32499999999999996,-2,2,1351247,3487,0,27,0
100397,102070,1,Híbrida,3.52,0,Hombre,Ferias & Networking,3,346240,42.0,74,Casado,27,2015,5,low,102035,Presencial,1.7,1,Mujer,Referidos,4,1616000,77.0,73,Viudo,38,2013,3,low,-1.82,1,1,1269760,-783,1,11,0
101185,102068,1,Híbrida,1.725,0,Hombre,Portal Web,3,390985,42.0,80,Casado,29,2015,3,low,102043,Híbrida,2.17,3,Mujer,Referidos,4,896000,41.0,81,Soltero,23,2012,8,low,0.44499999999999984,3,1,505015,-932,1,-6,0
101241,102048,1,Híbrida,2.71,3,Hombre,Portal Web,5,268331,42.0,80,Casado,36,2014,9,low,102092,Presencial,3.99,0,Mujer,Portal Web,5,590000,59.0,76,Soltero,20,2015,8,low,1.2800000000000002,-3,0,321669,349,0,-16,1
101254,102093,1,Híbrida,2.325,3,Mujer,Portal Web,24,913177,42.0,79,Viudo,58,2018,12,low,102139,Presencial,5.41,0,Mujer,Ferias & Networking,4,488000,89.0,62,Soltero,23,2021,6,high,3.085,-3,-20,-425177,922,0,-35,0
104102,102076,1,Híbrida,1.105,2,Mujer,Linkedin,1,141774,42.0,72,Soltero,18,2017,1,low,102168,Híbrida,1.95,1,Hombre,Referidos,9,1616000,95.0,82,Soltero,53,2023,9,high,0.845,-1,8,1474226,2419,0,35,1
103543,102074,1,Híbrida,1.78,0,Mujer,Portal Web,2,332775,42.0,71,Soltero,29,2017,3,low,102028,Presencial,1.35,0,Hombre,Ferias & Networking,4,1616000,80.0,83,Viudo,43,2015,12,high,-0.42999999999999994,0,2,1283225,-439,1,14,1
103060,102113,1,Híbrida,3.145,0,Mujer,Linkedin,7,787239,42.0,73,Casado,33,2018,3,low,102041,Presencial,2.96,2,Hombre,Portal Web,6,1152410,46.0,75,Casado,27,2012,1,low,-0.18500000000000005,2,-1,365171,-2256,1,-6,1
102267,102153,1,Híbrida,3.415,2,Mujer,Ferias & Networking,5,305109,42.0,74,Soltero,49,2023,4,low,102143,Presencial,6.39,1,Mujer,Linkedin,5,1616000,90.0,68,Casado,41,2019,6,high,2.9749999999999996,-1,0,1310891,-1398,1,-8,0
103780,102172,1,Híbrida,4.46,3,Hombre,Portal Web,4,662380,42.0,71,Divorciado,51,2022,8,low,102020,Presencial,5.58,1,Hombre,Portal Web,7,1049000,57.0,70,Casado,29,2016,4,low,1.12,-2,3,386620,-2316,1,-22,1
102403,102034,1,Híbrida,1.595,8,Hombre,Portal Web,10,837621,42.0,81,Viudo,45,2012,5,low,102113,Presencial,7.84,7,Hombre,Linkedin,5,1564490,90.0,70,Casado,35,2012,9,high,6.245,-1,-5,726869,116,0,-10,1
101906,102046,1,Híbrida,4.915,2,Mujer,Linkedin,8,351239,41.0,75,Casado,24,2012,10,low,102007,Presencial,1.68,0,Mujer,Portal Web,8,1616000,41.0,71,Soltero,50,2015,10,low,-3.2350000000000003,-2,0,1264761,1122,0,26,0
102068,102043,2,Híbrida,2.17,3,Mujer,Referidos,4,896000,41.0,81,Soltero,23,2012,8,low,102051,Presencial,1.03,0,Hombre,Portal Web,5,1616000,60.0,76,Casado,44,2019,5,low,-1.14,-3,1,720000,2464,0,21,1
100346,102043,1,Híbrida,4.765,5,Hombre,Portal Web,5,289512,41.0,73,Soltero,38,2013,12,low,102051,Presencial,1.03,0,Hombre,Portal Web,5,1616000,60.0,76,Casado,44,2019,5,low,-3.7349999999999994,-5,0,1326488,1987,0,6,0
101892,102109,1,Híbrida,1.91,3,Hombre,Portal Web,9,657404,41.0,76,Soltero,49,2021,2,low,102123,Presencial,3.86,1,Mujer,Portal Web,5,998000,97.0,82,Casado,32,2019,9,high,1.95,-2,-4,340596,-520,1,-17,1
101175,102075,1,Híbrida,1.11,2,Hombre,Portal Web,8,798654,41.0,67,Casado,47,2016,4,low,102047,Presencial,2.7,1,Hombre,Referidos,11,1255430,90.0,76,Casado,30,2013,3,high,1.59,-1,3,456776,-1126,1,-17,0
102593,102023,1,Híbrida,3.1,0,Mujer,Ferias & Networking,2,82107,41.0,86,Soltero,9,2012,3,low,102105,Híbrida,4.9,1,Hombre,Portal Web,4,539000,80.0,65,Casado,23,2019,12,high,1.8000000000000003,1,2,456893,2830,0,14,0
103033,102097,1,Híbrida,2.095,2,Hombre,Referidos,4,327603,41.0,74,Casado,30,2018,10,low,102024,Presencial,1.95,6,Hombre,Portal Web,4,1100900,57.0,77,Soltero,31,2016,10,low,-0.14500000000000024,4,0,773297,-707,1,1,1
103292,102096,1,Híbrida,2.075,1,Mujer,Referidos,3,348273,41.0,86,Soltero,29,2017,7,low,102116,Presencial,5.11,8,Mujer,Linkedin,13,1461470,90.0,74,Soltero,42,2021,5,high,3.035,7,10,1113197,1405,0,13,1
102332,102074,1,Híbrida,4.055,5,Hombre,Portal Web,6,452212,41.0,73,Casado,34,2017,10,low,102028,Presencial,1.35,0,Hombre,Ferias & Networking,4,1616000,80.0,83,Viudo,43,2015,12,high,-2.7049999999999996,-5,-2,1163788,-653,1,9,1
102552,102091,1,Híbrida,2.39,5,Mujer,Linkedin,9,445766,41.0,83,Divorciado,34,2017,10,low,102149,Presencial,1.54,1,Mujer,Portal Web,4,1616000,73.0,77,Casado,39,2014,12,low,-0.8500000000000001,-4,-5,1170234,-1009,1,5,0
103814,102043,1,Híbrida,4.77,5,Hombre,Portal Web,5,285887,41.0,73,Soltero,38,2013,12,low,102051,Presencial,1.03,0,Hombre,Portal Web,5,1616000,60.0,76,Casado,44,2019,5,low,-3.7399999999999993,-5,0,1330113,1988,0,6,0
101703,102008,1,Híbrida,1.995,2,Mujer,Portal Web,2,79878,40.0,75,Soltero,9,2012,4,low,102107,Presencial,3.99,1,Mujer,Linkedin,7,405435,90.0,82,Soltero,39,2023,1,high,1.995,-1,5,325557,3938,0,30,1
101184,102024,1,Híbrida,3.425,14,Mujer,Linkedin,1,96389,40.0,85,Soltero,12,2014,4,low,102074,Presencial,2.28,0,Hombre,Headhunter,9,1616000,84.0,70,Casado,48,2018,3,high,-1.145,-14,8,1519611,1444,0,36,1
101317,102121,1,Híbrida,2.84,3,Mujer,Linkedin,5,286848,40.0,80,Casado,31,2021,12,low,102127,Híbrida,1.63,2,Hombre,Portal Web,4,1616000,90.0,77,Divorciado,44,2012,2,high,-1.21,-1,-1,1329152,-3580,1,13,1
100706,102123,1,Híbrida,1.715,1,Mujer,Referidos,2,306142,40.0,72,Soltero,29,2019,6,low,102043,Presencial,5.5,1,Mujer,Linkedin,16,1616000,42.0,66,Soltero,51,2021,9,low,3.785,0,14,1309858,830,0,22,0
100163,102102,1,Híbrida,2.605,8,Hombre,Linkedin,6,368390,40.0,73,Soltero,33,2020,3,low,102018,Presencial,2.48,0,Hombre,Portal Web,5,1616000,92.0,63,Viudo,49,2019,4,high,-0.125,-8,-1,1247610,-345,1,16,0
100626,102091,1,Híbrida,2.36,5,Mujer,Linkedin,9,445254,40.0,83,Divorciado,35,2017,10,low,102149,Presencial,1.54,1,Mujer,Portal Web,4,1616000,73.0,77,Casado,39,2014,12,low,-0.8199999999999998,-4,-5,1170746,-1010,1,4,0
100230,102063,1,Híbrida,3.105,3,Hombre,Portal Web,9,881559,40.0,66,Casado,46,2017,7,low,102135,Presencial,2.73,0,Mujer,Linkedin,1,539000,26.0,75,Soltero,24,2021,4,low,-0.375,-3,-8,-342559,1352,0,-22,1
102016,102008,2,Híbrida,2.51,2,Mujer,Portal Web,6,1616000,40.0,80,Casado,44,2017,8,low,102107,Presencial,3.99,1,Mujer,Linkedin,7,405435,90.0,82,Soltero,39,2023,1,high,1.4800000000000004,-1,1,-1210565,1963,0,-5,1
102200,102008,1,Híbrida,1.99,2,Mujer,Portal Web,2,77412,40.0,75,Soltero,9,2012,4,low,102107,Presencial,3.99,1,Mujer,Linkedin,7,405435,90.0,82,Soltero,39,2023,1,high,2.0,-1,5,328023,3938,0,30,0
103778,102141,1,Híbrida,6.6,0,Hombre,Portal Web,7,308277,40.0,77,Casado,33,2022,12,low,102134,Presencial,1.88,1,Mujer,Linkedin,3,1100900,64.0,69,Soltero,32,2018,5,low,-4.72,1,-4,792623,-1666,1,-1,1
103272,102125,1,Híbrida,1.61,3,Hombre,Referidos,8,508216,40.0,73,Casado,42,2021,10,low,102096,Híbrida,4.0,2,Mujer,Referidos,5,692000,87.0,82,Casado,29,2022,7,high,2.3899999999999997,-1,-3,183784,272,0,-13,1
102709,102043,1,Híbrida,3.39,2,Hombre,Portal Web,5,527361,40.0,74,Soltero,34,2013,6,low,102051,Presencial,1.03,0,Hombre,Portal Web,5,1616000,60.0,76,Casado,44,2019,5,low,-2.3600000000000003,-2,0,1088639,2163,0,10,1
103075,102143,1,Híbrida,3.78,2,Hombre,Portal Web,3,423588,40.0,73,Casado,46,2020,11,low,102142,Presencial,1.07,2,Hombre,Portal Web,2,590000,90.0,78,Casado,25,2022,2,high,-2.71,0,-1,166412,454,0,-21,1
102751,102075,1,Híbrida,4.885,1,Mujer,Portal Web,12,637682,40.0,79,Casado,43,2016,7,low,102047,Presencial,2.7,1,Hombre,Referidos,11,1255430,90.0,76,Casado,30,2013,3,high,-2.1849999999999996,0,-1,617748,-1216,1,-13,1
103320,102063,1,Híbrida,3.115,4,Hombre,Portal Web,9,878932,40.0,66,Casado,46,2017,7,low,102135,Presencial,2.73,0,Mujer,Linkedin,1,539000,26.0,75,Soltero,24,2021,4,low,-0.38500000000000023,-4,-8,-339932,1353,0,-22,1
103262,102075,1,Híbrida,1.115,2,Hombre,Portal Web,8,799972,40.0,67,Casado,47,2016,4,low,102047,Presencial,2.7,1,Hombre,Referidos,11,1255430,90.0,76,Casado,30,2013,3,high,1.5850000000000002,-1,3,455458,-1123,1,-17,0
101844,102077,1,Híbrida,5.49,1,Mujer,Linkedin,4,349521,39.0,82,Casado,30,2017,3,low,102146,Presencial,2.27,0,Hombre,Ferias & Networking,11,1306940,31.0,64,Soltero,39,2021,6,low,-3.22,-1,7,957419,1564,0,9,1
100888,102057,1,Híbrida,5.53,1,Mujer,Referidos,7,830071,39.0,67,Soltero,31,2014,2,low,102019,Presencial,1.97,4,Hombre,Portal Web,5,1616000,90.0,73,Viudo,59,2022,12,high,-3.5600000000000005,3,-2,785929,3236,0,28,1
100863,102125,1,Híbrida,1.615,3,Hombre,Referidos,8,505964,39.0,73,Casado,42,2021,10,low,102096,Híbrida,4.0,2,Mujer,Referidos,5,692000,87.0,82,Casado,29,2022,7,high,2.385,-1,-3,186036,273,0,-13,1
101896,102120,1,Híbrida,2.1,0,Mujer,Portal Web,3,301328,39.0,73,Casado,46,2021,3,low,102171,Presencial,6.48,2,Hombre,Ferias & Networking,9,1616000,80.0,71,Casado,47,2023,8,high,4.380000000000001,2,6,1314672,875,0,1,1
101251,102065,1,Híbrida,3.37,2,Hombre,Linkedin,7,660135,39.0,73,Divorciado,44,2016,2,low,102026,Presencial,2.44,2,Hombre,Ferias & Networking,13,1616000,45.0,60,Divorciado,35,2014,10,low,-0.9300000000000002,0,6,955865,-508,1,-9,0
100458,102050,1,Híbrida,3.015,0,Hombre,Ferias & Networking,12,879724,39.0,78,Soltero,45,2014,11,low,102069,Presencial,3.7,0,Mujer,Linkedin,11,1512980,90.0,88,Soltero,40,2017,10,high,0.685,0,-1,633256,1048,0,-5,1
104061,102024,1,Híbrida,3.41,14,Mujer,Linkedin,1,98622,39.0,85,Soltero,12,2014,4,low,102074,Presencial,2.28,0,Hombre,Headhunter,9,1616000,84.0,70,Casado,48,2018,3,high,-1.1300000000000003,-14,8,1517378,1441,0,36,1
102234,102045,1,Híbrida,6.905,2,Hombre,Ferias & Networking,7,406245,39.0,79,Casado,29,2014,5,low,102171,Presencial,3.19,3,Hombre,Portal Web,11,1616000,97.0,65,Casado,53,2023,9,high,-3.7150000000000003,1,4,1209755,3414,0,24,0
102724,102133,1,Híbrida,3.645,1,Hombre,Referidos,3,715446,39.0,83,Viudo,53,2022,10,low,102151,Híbrida,2.61,2,Hombre,Linkedin,4,1255430,98.0,65,Soltero,35,2018,2,high,-1.0350000000000001,1,1,539984,-1699,1,-18,1
102754,102050,1,Híbrida,3.045,1,Hombre,Ferias & Networking,12,878856,39.0,78,Soltero,45,2014,11,low,102069,Presencial,3.7,0,Mujer,Linkedin,11,1512980,90.0,88,Soltero,40,2017,10,high,0.6550000000000002,-1,-1,634124,1051,0,-5,1
101161,102159,1,Híbrida,2.2,1,Mujer,Portal Web,6,225490,38.0,73,Divorciado,28,2022,6,low,102120,Híbrida,0.98,2,Hombre,Referidos,14,808000,90.0,86,Soltero,44,2022,8,high,-1.2200000000000002,1,8,582510,61,0,16,1
101363,102137,1,Híbrida,1.815,3,Mujer,Referidos,5,268717,38.0,65,Casado,31,2022,3,low,102046,Presencial,1.18,0,Mujer,Portal Web,2,845000,37.0,79,Casado,27,2017,12,low,-0.635,-3,-3,576283,-1543,1,-4,0
101545,102124,1,Híbrida,1.54,2,Hombre,Referidos,4,489057,38.0,80,Casado,41,2022,3,low,102099,Presencial,2.84,2,Mujer,Linkedin,4,947000,90.0,70,Soltero,24,2012,10,high,1.2999999999999998,0,0,457943,-3411,1,-17,0
101249,102034,1,Híbrida,3.06,0,Hombre,Portal Web,4,299337,38.0,84,Casado,40,2015,2,low,102113,Presencial,7.84,7,Hombre,Linkedin,5,1564490,90.0,70,Casado,35,2012,9,high,4.779999999999999,7,1,1265153,-874,1,-5,0
100540,102124,1,Híbrida,1.755,2,Hombre,Portal Web,13,677097,38.0,76,Soltero,51,2021,4,low,102099,Presencial,2.84,2,Mujer,Linkedin,4,947000,90.0,70,Soltero,24,2012,10,high,1.085,0,-9,269903,-3098,1,-27,1
102223,102059,1,Híbrida,2.705,0,Hombre,Headhunter,5,369574,38.0,77,Casado,27,2014,11,low,102021,Presencial,2.55,2,Hombre,Portal Web,16,1616000,27.0,76,Viudo,50,2019,6,low,-0.15500000000000025,2,11,1246426,1680,0,23,1
103771,102061,1,Híbrida,5.47,1,Mujer,Portal Web,7,266633,38.0,76,Soltero,39,2017,5,low,102115,Presencial,2.14,2,Hombre,Ferias & Networking,10,1203920,37.0,80,Casado,29,2012,11,low,-3.3299999999999996,1,3,937287,-1636,1,-10,1
103167,102038,1,Híbrida,2.605,2,Mujer,Portal Web,12,278933,38.0,77,Casado,36,2012,11,low,102125,Presencial,2.06,1,Hombre,Portal Web,12,1616000,81.0,82,Casado,44,2018,1,high,-0.5449999999999999,-1,0,1337067,1879,0,8,1
102886,102154,1,Híbrida,2.59,1,Hombre,Linkedin,12,379188,38.0,74,Soltero,46,2021,9,low,102172,Presencial,5.45,1,Hombre,Portal Web,7,1512980,93.0,69,Soltero,39,2017,10,high,2.8600000000000003,0,-5,1133792,-1440,1,-7,0
103074,102121,1,Híbrida,1.665,3,Hombre,Portal Web,7,288669,38.0,79,Casado,44,2019,12,low,102127,Híbrida,1.63,2,Hombre,Portal Web,4,1616000,90.0,77,Divorciado,44,2012,2,high,-0.03500000000000014,-1,-3,1327331,-2843,1,0,0
100803,102029,1,Híbrida,1.99,0,Mujer,Linkedin,3,188595,37.0,79,Soltero,17,2012,7,low,102132,Presencial,5.79,2,Hombre,Portal Web,16,1616000,80.0,84,Casado,49,2017,9,high,3.8,2,13,1427405,1893,0,32,1
100645,102040,1,Híbrida,2.74,2,Hombre,Portal Web,2,208236,37.0,78,Soltero,20,2015,5,low,102106,Presencial,3.21,1,Hombre,Linkedin,15,1616000,91.0,84,Soltero,45,2016,7,high,0.46999999999999975,-1,13,1407764,419,0,25,0
101923,102059,1,Híbrida,2.695,0,Hombre,Ferias & Networking,5,373375,37.0,77,Casado,27,2014,11,low,102021,Presencial,2.55,2,Hombre,Portal Web,16,1616000,27.0,76,Viudo,50,2019,6,low,-0.14500000000000002,2,11,1242625,1683,0,23,0
101212,102106,1,Híbrida,1.435,3,Hombre,Portal Web,4,279334,37.0,73,Soltero,43,2019,10,low,102081,Presencial,1.39,1,Mujer,Ferias & Networking,5,1049000,86.0,86,Soltero,32,2019,6,high,-0.04500000000000015,-2,1,769666,-128,1,-11,1
101695,102038,1,Híbrida,2.59,1,Mujer,Portal Web,12,274670,37.0,77,Casado,36,2012,11,low,102125,Presencial,2.06,1,Hombre,Portal Web,12,1616000,81.0,82,Casado,44,2018,1,high,-0.5299999999999998,0,0,1341330,1880,0,8,1
100679,102121,1,Híbrida,1.67,2,Hombre,Portal Web,7,284404,37.0,79,Divorciado,44,2019,12,low,102127,Híbrida,1.63,2,Hombre,Portal Web,4,1616000,90.0,77,Divorciado,44,2012,2,high,-0.040000000000000036,0,-3,1331596,-2843,1,0,0
100357,102082,1,Híbrida,3.57,2,Hombre,Linkedin,5,290535,37.0,80,Viudo,40,2015,12,low,102050,Presencial,5.5,2,Mujer,Linkedin,7,1616000,81.0,70,Casado,36,2018,8,high,1.9300000000000002,0,2,1325465,966,0,-4,1
103699,102109,1,Híbrida,1.935,2,Hombre,Portal Web,2,120772,37.0,64,Soltero,18,2018,7,low,102123,Presencial,3.86,1,Mujer,Portal Web,5,998000,97.0,82,Casado,32,2019,9,high,1.9249999999999998,-1,3,877228,446,0,14,1
102838,102029,1,Híbrida,1.965,0,Mujer,Linkedin,3,188923,37.0,79,Soltero,16,2012,7,low,102132,Presencial,5.79,2,Hombre,Portal Web,16,1616000,80.0,84,Casado,49,2017,9,high,3.825,2,13,1427077,1893,0,33,1
102299,102040,1,Híbrida,2.73,2,Hombre,Portal Web,2,213630,37.0,78,Soltero,20,2015,5,low,102106,Presencial,3.21,1,Hombre,Linkedin,15,1616000,91.0,84,Soltero,45,2016,7,high,0.48,-1,13,1402370,418,0,25,1
102818,102098,1,Híbrida,1.88,2,Mujer,Referidos,2,371110,37.0,74,Soltero,30,2017,5,low,102049,Presencial,1.8,1,Mujer,Portal Web,16,1616000,90.0,86,Casado,46,2021,1,high,-0.07999999999999985,-1,14,1244890,1370,0,16,1
103469,102124,1,Híbrida,1.535,2,Hombre,Referidos,4,486369,37.0,80,Casado,41,2022,3,low,102099,Presencial,2.84,2,Mujer,Linkedin,4,947000,90.0,70,Soltero,24,2012,10,high,1.305,0,0,460631,-3413,1,-17,1
102863,102149,1,Híbrida,6.005,1,Hombre,Ferias & Networking,12,800255,37.0,81,Casado,49,2021,6,low,102141,Presencial,2.07,0,Mujer,Headhunter,3,1409960,90.0,86,Casado,37,2017,2,high,-3.935,-1,-9,609705,-1565,1,-12,0
104165,102124,1,Híbrida,1.8,2,Hombre,Portal Web,12,675975,37.0,76,Soltero,51,2021,4,low,102099,Presencial,2.84,2,Mujer,Linkedin,4,947000,90.0,70,Soltero,24,2012,10,high,1.0399999999999998,0,-8,271025,-3098,1,-27,1
104140,102079,1,Híbrida,4.45,2,Hombre,Portal Web,12,699672,34.0,69,Divorciado,49,2018,10,low,102146,Presencial,2.63,1,Mujer,Portal Web,4,1358450,80.0,81,Soltero,35,2016,3,high,-1.8200000000000003,-1,-8,658778,-956,1,-14,1
100667,102079,1,Híbrida,4.415,2,Hombre,Portal Web,13,701625,33.0,69,Divorciado,49,2018,10,low,102146,Presencial,2.63,1,Mujer,Portal Web,4,1358450,80.0,81,Soltero,35,2016,3,high,-1.7850000000000001,-1,-9,656825,-957,1,-14,1
101059,102016,1,Híbrida,2.76,0,Hombre,Ferias & Networking,5,309226,30.0,70,Casado,24,2013,6,low,102008,Híbrida,2.51,2,Mujer,Portal Web,6,1616000,40.0,80,Casado,44,2017,8,low,-0.25,2,1,1306774,1544,0,20,1
103575,102113,1,Híbrida,2.785,2,Hombre,Linkedin,6,372214,30.0,73,Casado,32,2018,10,low,102041,Presencial,2.96,2,Hombre,Portal Web,6,1152410,46.0,75,Casado,27,2012,1,low,0.17499999999999982,0,0,780196,-2450,1,-5,1
100812,102072,1,Híbrida,3.955,9,Hombre,Portal Web,6,324778,29.0,79,Soltero,27,2016,4,low,102046,Presencial,2.61,2,Hombre,Ferias & Networking,3,947000,41.0,71,Soltero,30,2018,11,low,-1.3450000000000002,-7,-3,622222,953,0,3,0
100361,102073,1,Híbrida,4.445,2,Mujer,Referidos,4,350993,29.0,79,Casado,28,2015,11,low,102139,Presencial,1.98,2,Hombre,Portal Web,11,1306940,95.0,86,Soltero,37,2019,7,high,-2.4650000000000003,0,7,955947,1319,0,9,1
101731,102060,1,Híbrida,1.64,6,Mujer,Linkedin,7,260939,29.0,68,Casado,35,2014,5,low,102041,Presencial,4.42,3,Hombre,Referidos,16,1616000,82.0,62,Casado,45,2013,10,high,2.7800000000000002,-3,9,1355061,-192,1,10,1
102720,102016,1,Híbrida,2.75,1,Hombre,Ferias & Networking,5,309853,29.0,70,Casado,24,2013,6,low,102008,Híbrida,2.51,2,Mujer,Portal Web,6,1616000,40.0,80,Casado,44,2017,8,low,-0.2400000000000002,1,1,1306147,1542,0,20,0
103946,102073,1,Híbrida,4.42,3,Mujer,Referidos,4,349428,29.0,79,Casado,28,2015,12,low,102139,Presencial,1.98,2,Hombre,Portal Web,11,1306940,95.0,86,Soltero,37,2019,7,high,-2.44,-1,7,957512,1317,0,9,1
103504,102060,1,Híbrida,1.615,7,Mujer,Linkedin,7,261467,29.0,68,Casado,35,2014,5,low,102041,Presencial,4.42,3,Hombre,Referidos,16,1616000,82.0,62,Casado,45,2013,10,high,2.8049999999999997,-4,9,1354533,-192,1,10,1
100250,102131,1,Híbrida,4.7,2,Hombre,Portal Web,3,504808,28.0,65,Casado,43,2022,10,low,102109,Presencial,5.54,0,Hombre,Linkedin,3,998000,39.0,77,Soltero,34,2021,12,low,0.8399999999999999,-2,0,493192,-311,1,-9,0
101022,102049,1,Híbrida,2.165,1,Hombre,Portal Web,5,304258,28.0,73,Casado,40,2013,6,low,102029,Presencial,6.89,0,Mujer,Portal Web,9,1616000,19.0,77,Divorciado,49,2023,3,low,4.725,-1,4,1311742,3549,0,9,1
102383,102072,1,Híbrida,3.95,9,Hombre,Portal Web,6,333471,28.0,79,Casado,27,2016,4,low,102046,Presencial,2.61,2,Hombre,Ferias & Networking,3,947000,41.0,71,Soltero,30,2018,11,low,-1.3400000000000003,-7,-3,613529,952,0,3,0
102623,102131,1,Híbrida,4.72,2,Hombre,Portal Web,3,506175,28.0,65,Casado,43,2022,10,low,102109,Presencial,5.54,0,Hombre,Linkedin,3,998000,39.0,77,Soltero,34,2021,12,low,0.8200000000000003,-2,0,491825,-312,1,-9,1
100714,102145,1,Híbrida,5.26,8,Hombre,Portal Web,13,810991,27.0,62,Casado,42,2023,1,low,102116,Presencial,1.43,1,Mujer,Portal Web,3,692000,89.0,73,Viudo,23,2016,12,high,-3.83,-7,-10,-118991,-2224,1,-19,1
100497,102064,1,Híbrida,3.565,1,Hombre,Portal Web,5,416283,27.0,75,Soltero,39,2016,10,low,102067,Presencial,1.34,0,Hombre,Portal Web,6,1616000,92.0,92,Casado,43,2018,2,high,-2.2249999999999996,-1,1,1199717,480,0,4,0
101389,102038,1,Híbrida,2.03,1,Hombre,Ferias & Networking,5,722472,27.0,71,Divorciado,45,2014,10,low,102125,Presencial,2.06,1,Hombre,Portal Web,12,1616000,81.0,82,Casado,44,2018,1,high,0.03000000000000025,0,7,893528,1193,0,-1,1
103038,102149,1,Híbrida,0.97,1,Mujer,Portal Web,3,193333,27.0,74,Soltero,27,2023,3,low,102141,Presencial,2.07,0,Mujer,Headhunter,3,1409960,90.0,86,Casado,37,2017,2,high,1.0999999999999999,-1,0,1216627,-2217,1,10,1
103187,102155,1,Híbrida,1.315,2,Mujer,Referidos,4,225282,27.0,79,Soltero,30,2023,5,low,102159,Presencial,1.78,1,Mujer,Ferias & Networking,1,590000,39.0,80,Soltero,20,2016,10,low,0.4650000000000001,-1,-3,364718,-2389,1,-10,0
103443,102145,1,Híbrida,5.28,7,Hombre,Portal Web,13,810672,27.0,62,Casado,42,2023,1,low,102116,Presencial,1.43,1,Mujer,Portal Web,3,692000,89.0,73,Viudo,23,2016,12,high,-3.8500000000000005,-6,-10,-118672,-2222,1,-19,1
102265,102038,1,Híbrida,2.04,0,Hombre,Ferias & Networking,5,721543,27.0,71,Divorciado,45,2014,10,low,102125,Presencial,2.06,1,Hombre,Portal Web,12,1616000,81.0,82,Casado,44,2018,1,high,0.020000000000000018,1,7,894457,1193,0,-1,0
101890,102145,1,Híbrida,1.06,1,Mujer,Referidos,1,97834,26.0,74,Soltero,19,2021,8,low,102116,Presencial,1.43,1,Mujer,Portal Web,3,692000,89.0,73,Viudo,23,2016,12,high,0.3699999999999999,0,2,594166,-1727,1,4,1
101289,102155,1,Híbrida,1.32,1,Mujer,Referidos,4,227445,26.0,79,Soltero,30,2023,5,low,102159,Presencial,1.78,1,Mujer,Ferias & Networking,1,590000,39.0,80,Soltero,20,2016,10,low,0.45999999999999996,0,-3,362555,-2391,1,-10,0
100946,102108,1,Híbrida,0.2,0,Mujer,Portal Web,7,506917,26.0,73,Soltero,38,2018,8,low,102040,Presencial,2.92,1,Mujer,Portal Web,5,1616000,46.0,75,Casado,50,2023,5,low,2.7199999999999998,1,-2,1109083,1737,0,12,0
100947,102024,1,Híbrida,1.58,8,Mujer,Portal Web,10,273567,26.0,80,Soltero,36,2013,7,low,102074,Presencial,2.28,0,Hombre,Headhunter,9,1616000,84.0,70,Casado,48,2018,3,high,0.6999999999999997,-8,-1,1342433,1705,0,12,1
100326,102017,1,Híbrida,6.91,1,Hombre,Portal Web,4,299925,26.0,73,Viudo,37,2013,1,low,102035,Presencial,4.62,0,Mujer,Linkedin,2,641000,90.0,84,Casado,25,2019,11,high,-2.29,-1,-2,341075,2484,0,-12,1
102542,102049,1,Híbrida,1.365,4,Mujer,Portal Web,2,327345,26.0,84,Casado,24,2013,3,low,102029,Presencial,6.89,0,Mujer,Portal Web,9,1616000,19.0,77,Divorciado,49,2023,3,low,5.5249999999999995,-4,7,1288655,3656,0,25,0
102503,102036,1,Híbrida,6.25,6,Hombre,Portal Web,4,264651,26.0,94,Casado,37,2015,2,low,102054,Presencial,1.68,8,Hombre,Portal Web,5,1616000,92.0,76,Viudo,54,2022,1,high,-4.57,2,1,1351349,2524,0,17,0
100743,102036,1,Híbrida,6.26,6,Hombre,Portal Web,4,271539,25.0,94,Casado,37,2015,2,low,102054,Presencial,1.68,8,Hombre,Portal Web,5,1616000,92.0,76,Viudo,54,2022,1,high,-4.58,2,1,1344461,2524,0,17,1
100807,102101,1,Híbrida,1.08,3,Hombre,Referidos,12,914612,25.0,66,Viudo,57,2019,8,low,102089,Presencial,6.23,0,Hombre,Portal Web,26,1616000,92.0,68,Divorciado,55,2014,1,high,5.15,-3,14,701388,-2033,1,-2,1
103397,102108,1,Híbrida,0.225,1,Mujer,Portal Web,7,507618,25.0,73,Soltero,38,2018,8,low,102040,Presencial,2.92,1,Mujer,Portal Web,5,1616000,46.0,75,Casado,50,2023,5,low,2.695,0,-2,1108382,1736,0,12,1
102487,102149,1,Híbrida,2.65,0,Mujer,Linkedin,7,717665,25.0,69,Casado,53,2022,3,low,102141,Presencial,2.07,0,Mujer,Headhunter,3,1409960,90.0,86,Casado,37,2017,2,high,-0.5800000000000001,0,-4,692295,-1839,1,-16,0
101106,102078,1,Híbrida,2.175,1,Mujer,Portal Web,6,272434,24.0,79,Soltero,24,2015,11,low,102143,Presencial,2.17,1,Hombre,Ferias & Networking,9,998000,83.0,76,Casado,29,2017,5,high,-0.004999999999999893,0,3,725566,556,0,5,1
100322,102055,1,Híbrida,3.085,5,Hombre,Portal Web,9,328471,24.0,80,Soltero,25,2014,5,low,102129,Presencial,1.92,2,Hombre,Referidos,8,1616000,97.0,63,Casado,42,2013,2,high,-1.165,-3,-1,1287529,-438,1,17,1
101476,102031,1,Híbrida,3.045,1,Mujer,Linkedin,10,718249,24.0,86,Soltero,45,2014,4,low,102111,Presencial,2.95,2,Hombre,Portal Web,8,1610000,76.0,87,Casado,31,2017,7,low,-0.09499999999999975,1,-2,891751,1189,0,-14,1
100295,102079,1,Híbrida,0.88,2,Hombre,Ferias & Networking,5,700733,23.0,66,Soltero,48,2018,3,low,102146,Presencial,2.63,1,Mujer,Portal Web,4,1358450,80.0,81,Soltero,35,2016,3,high,1.75,-1,-1,657717,-741,1,-13,1
103325,102136,1,Híbrida,1.88,3,Mujer,Ferias & Networking,11,449668,23.0,74,Soltero,39,2022,3,low,102034,Presencial,1.78,2,Hombre,Portal Web,3,1616000,89.0,78,Casado,35,2013,1,high,-0.09999999999999987,-1,-8,1166332,-3368,1,-4,1
101925,102021,1,Híbrida,2.24,18,Mujer,Linkedin,4,332806,22.0,81,Casado,25,2013,7,low,102069,Presencial,2.25,1,Hombre,Linkedin,8,1616000,47.0,80,Casado,52,2017,3,low,0.009999999999999787,-17,4,1283194,1346,0,27,1
100622,102091,1,Híbrida,3.48,4,Mujer,Portal Web,10,389056,22.0,79,Soltero,31,2017,5,low,102149,Presencial,1.54,1,Mujer,Portal Web,4,1616000,73.0,77,Casado,39,2014,12,low,-1.94,-3,-6,1226944,-860,1,8,0
100732,102136,1,Híbrida,1.915,2,Mujer,Ferias & Networking,11,449522,22.0,74,Soltero,39,2022,3,low,102034,Presencial,1.78,2,Hombre,Portal Web,3,1616000,89.0,78,Casado,35,2013,1,high,-0.135,0,-8,1166478,-3367,1,-4,1
102173,102120,2,Híbrida,2.27,1,Hombre,Portal Web,6,1616000,22.0,82,Divorciado,49,2018,4,low,102171,Presencial,6.48,2,Hombre,Ferias & Networking,9,1616000,80.0,71,Casado,47,2023,8,high,4.210000000000001,1,3,0,1958,0,-2,1
100705,102120,1,Híbrida,7.92,2,Mujer,Portal Web,8,292651,21.0,84,Soltero,30,2020,6,low,102171,Presencial,6.48,2,Hombre,Ferias & Networking,9,1616000,80.0,71,Casado,47,2023,8,high,-1.4399999999999995,0,1,1323349,1168,0,17,1
100433,102110,1,Híbrida,1.945,2,Hombre,Linkedin,12,659410,21.0,72,Casado,48,2020,4,low,102045,Presencial,1.6,5,Mujer,Linkedin,2,998000,87.0,76,Soltero,29,2016,11,high,-0.345,3,-10,338590,-1227,1,-19,1
101062,102040,1,Híbrida,5.93,1,Mujer,Ferias & Networking,16,655728,21.0,73,Soltero,41,2013,2,low,102106,Presencial,3.21,1,Hombre,Linkedin,15,1616000,91.0,84,Soltero,45,2016,7,high,-2.7199999999999998,0,-1,960272,1246,0,4,1
103979,102110,1,Híbrida,1.935,1,Hombre,Linkedin,12,662396,21.0,72,Casado,48,2020,4,low,102045,Presencial,1.6,5,Mujer,Linkedin,2,998000,87.0,76,Soltero,29,2016,11,high,-0.33499999999999996,4,-10,335604,-1227,1,-19,1
102746,102162,1,Híbrida,1.81,3,Mujer,Referidos,9,308493,20.0,77,Soltero,49,2023,4,low,102146,Presencial,1.12,0,Mujer,Referidos,9,1616000,31.0,74,Casado,41,2022,11,low,-0.69,-3,0,1307507,-151,1,-8,1
102312,102115,1,Híbrida,2.82,1,Mujer,Portal Web,8,466950,19.0,73,Soltero,40,2021,12,low,102116,Presencial,2.0,2,Mujer,Portal Web,4,1616000,94.0,76,Soltero,35,2018,12,high,-0.8199999999999998,1,-4,1149050,-1070,1,-5,0
100378,102016,1,Híbrida,2.92,7,Hombre,Portal Web,3,352445,18.0,75,Casado,25,2013,2,low,102008,Híbrida,2.51,2,Mujer,Portal Web,6,1616000,40.0,80,Casado,44,2017,8,low,-0.41000000000000014,-5,3,1263555,1669,0,19,1
103823,102016,1,Híbrida,2.94,8,Hombre,Portal Web,3,348077,18.0,75,Casado,25,2013,2,low,102008,Híbrida,2.51,2,Mujer,Portal Web,6,1616000,40.0,80,Casado,44,2017,8,low,-0.43000000000000016,-6,3,1267923,1670,0,19,1
102663,102114,1,Híbrida,1.285,2,Mujer,Portal Web,4,387307,18.0,77,Casado,36,2021,6,low,102050,Presencial,1.44,1,Mujer,Portal Web,5,1616000,91.0,69,Divorciado,47,2021,5,high,0.15500000000000003,-1,1,1228693,-30,1,11,1
101222,102044,1,Híbrida,4.875,3,Hombre,Ferias & Networking,12,465225,17.0,65,Casado,34,2015,7,low,102155,Presencial,1.54,1,Hombre,Ferias & Networking,14,1616000,56.0,68,Soltero,47,2023,3,low,-3.335,-2,2,1150775,2811,0,13,0
101933,102087,1,Híbrida,2.665,2,Mujer,Referidos,8,722409,16.0,62,Soltero,47,2016,4,low,102111,Presencial,7.16,9,Mujer,Linkedin,10,1616000,98.0,79,Casado,42,2012,5,high,4.495,7,2,893591,-1438,1,-5,1
100976,102084,1,Híbrida,3.47,1,Hombre,Portal Web,7,493210,15.0,73,Casado,36,2017,5,low,102171,Presencial,2.62,3,Mujer,Portal Web,14,1616000,89.0,76,Divorciado,50,2023,7,high,-0.8500000000000001,2,7,1122790,2249,0,14,1
102324,102123,1,Híbrida,2.825,0,Mujer,Ferias & Networking,4,783973,15.0,79,Casado,36,2019,3,low,102043,Presencial,5.5,1,Mujer,Linkedin,16,1616000,42.0,66,Soltero,51,2021,9,low,2.675,1,12,832027,935,0,15,0
103813,102084,1,Híbrida,3.515,2,Hombre,Portal Web,7,491954,15.0,73,Casado,37,2017,5,low,102171,Presencial,2.62,3,Mujer,Portal Web,14,1616000,89.0,76,Divorciado,50,2023,7,high,-0.895,1,7,1124046,2248,0,13,1
102286,102051,1,Híbrida,2.095,1,Hombre,Portal Web,2,145263,13.0,82,Soltero,16,2014,11,low,102075,Híbrida,1.39,1,Hombre,Portal Web,11,1616000,83.0,76,Casado,46,2019,11,high,-0.7050000000000003,0,9,1470737,1827,0,30,0
103730,102054,1,Híbrida,1.54,2,Mujer,Linkedin,2,165073,13.0,66,Soltero,15,2013,10,low,102044,Presencial,2.91,1,Hombre,Linkedin,17,1616000,85.0,74,Divorciado,41,2012,11,high,1.37,-1,15,1450927,-353,1,26,1
103789,102159,1,Híbrida,4.475,0,Mujer,Referidos,3,185815,13.0,68,Casado,26,2023,3,low,102120,Híbrida,0.98,2,Hombre,Referidos,14,808000,90.0,86,Soltero,44,2022,8,high,-3.4949999999999997,2,11,622185,-195,1,18,1
101694,102051,1,Híbrida,2.075,1,Hombre,Portal Web,2,146322,12.0,82,Soltero,16,2014,11,low,102075,Híbrida,1.39,1,Hombre,Portal Web,11,1616000,83.0,76,Casado,46,2019,11,high,-0.6850000000000003,0,9,1469678,1825,0,30,0
103378,102065,1,Híbrida,3.655,2,Mujer,Referidos,2,115700,12.0,75,Soltero,16,2017,7,low,102026,Presencial,2.44,2,Hombre,Ferias & Networking,13,1616000,45.0,60,Divorciado,35,2014,10,low,-1.2149999999999999,0,11,1500300,-1025,1,19,1
100119,102168,1,Híbrida,1.685,2,Mujer,Portal Web,1,83583,80.0,82,Soltero,21,2023,10,high,102172,Presencial,6.22,1,Hombre,Referidos,15,1616000,75.0,68,Viudo,42,2012,1,low,4.535,-1,14,1532417,-4294,1,21,1
100176,102172,1,Híbrida,1.555,9,Mujer,Linkedin,2,96994,80.0,76,Soltero,21,2023,7,high,102020,Presencial,5.58,1,Hombre,Portal Web,7,1049000,57.0,70,Casado,29,2016,4,low,4.025,-8,5,952006,-2632,1,8,1
101962,102137,1,Híbrida,1.335,8,Mujer,Linkedin,5,210572,80.0,73,Soltero,29,2023,9,high,102046,Presencial,1.18,0,Mujer,Portal Web,2,845000,37.0,79,Casado,27,2017,12,low,-0.15500000000000003,-8,-3,634428,-2079,1,-2,1
100973,102172,1,Híbrida,1.255,12,Mujer,Portal Web,3,324976,80.0,68,Soltero,35,2023,8,high,102020,Presencial,5.58,1,Hombre,Portal Web,7,1049000,57.0,70,Casado,29,2016,4,low,4.325,-11,4,724024,-2667,1,-6,1
101216,102172,1,Híbrida,2.91,3,Hombre,Referidos,9,349037,80.0,72,Casado,35,2023,9,high,102020,Presencial,5.58,1,Hombre,Portal Web,7,1049000,57.0,70,Casado,29,2016,4,low,2.67,-2,-2,699963,-2706,1,-6,0
100399,102154,1,Híbrida,3.18,5,Mujer,Linkedin,2,408609,80.0,73,Casado,38,2023,9,high,102172,Presencial,5.45,1,Hombre,Portal Web,7,1512980,93.0,69,Soltero,39,2017,10,high,2.27,-4,5,1104371,-2187,1,1,1
100901,102137,1,Híbrida,3.495,1,Mujer,Portal Web,8,788562,80.0,75,Soltero,38,2023,7,high,102046,Presencial,1.18,0,Mujer,Portal Web,2,845000,37.0,79,Casado,27,2017,12,low,-2.3150000000000004,-1,-6,56438,-2036,1,-11,1
101978,102171,1,Híbrida,1.395,1,Hombre,Ferias & Networking,4,322222,80.0,66,Casado,50,2023,7,high,102088,Presencial,2.57,4,Hombre,Linkedin,8,1616000,80.0,69,Casado,43,2017,10,high,1.1749999999999998,3,4,1293778,-2107,1,-7,0
100530,102143,1,Híbrida,5.34,10,Mujer,Linkedin,5,694555,80.0,71,Viudo,54,2023,10,high,102142,Presencial,1.07,2,Hombre,Portal Web,2,590000,90.0,78,Casado,25,2022,2,high,-4.27,-8,-3,-104555,-635,1,-29,1
101574,102171,1,Híbrida,4.155,3,Hombre,Portal Web,6,722376,80.0,77,Casado,54,2023,9,high,102088,Presencial,2.57,4,Hombre,Linkedin,8,1616000,80.0,69,Casado,43,2017,10,high,-1.5850000000000004,1,2,893624,-2181,1,-11,1
100966,102166,1,Híbrida,2.19,2,Mujer,Portal Web,14,720159,80.0,81,Divorciado,54,2023,8,high,102135,Presencial,7.74,2,Hombre,Referidos,9,1306940,63.0,81,Casado,40,2022,6,low,5.550000000000001,0,-5,586781,-419,1,-14,1
103371,102137,1,Híbrida,1.305,8,Mujer,Linkedin,5,210738,80.0,73,Soltero,29,2023,9,high,102046,Presencial,1.18,0,Mujer,Portal Web,2,845000,37.0,79,Casado,27,2017,12,low,-0.125,-8,-3,634262,-2078,1,-2,0
103646,102159,1,Híbrida,1.015,1,Hombre,Linkedin,4,312505,80.0,68,Casado,34,2023,10,high,102120,Híbrida,0.98,2,Hombre,Referidos,14,808000,90.0,86,Soltero,44,2022,8,high,-0.03499999999999992,1,10,495495,-438,1,10,0
104114,102172,1,Híbrida,1.26,13,Mujer,Portal Web,3,325465,80.0,68,Soltero,35,2023,8,high,102020,Presencial,5.58,1,Hombre,Portal Web,7,1049000,57.0,70,Casado,29,2016,4,low,4.32,-12,4,723535,-2667,1,-6,1
103964,102172,1,Híbrida,4.33,1,Mujer,Linkedin,4,271258,80.0,61,Casado,45,2023,8,high,102020,Presencial,5.58,1,Hombre,Portal Web,7,1049000,57.0,70,Casado,29,2016,4,low,1.25,0,3,777742,-2665,1,-16,1
103809,102166,1,Híbrida,2.22,2,Mujer,Portal Web,14,720908,80.0,81,Divorciado,54,2023,8,high,102135,Presencial,7.74,2,Hombre,Referidos,9,1306940,63.0,81,Casado,40,2022,6,low,5.52,0,-5,586032,-419,1,-14,1
102366,102171,1,Híbrida,4.145,2,Hombre,Portal Web,6,719602,80.0,77,Casado,54,2023,9,high,102088,Presencial,2.57,4,Hombre,Linkedin,8,1616000,80.0,69,Casado,43,2017,10,high,-1.5749999999999997,2,2,896398,-2183,1,-11,0
104030,102144,1,Presencial,2.365,2,Hombre,Linkedin,1,101765,98.0,83,Soltero,20,2021,10,high,102156,Presencial,2.13,8,Mujer,Portal Web,11,1616000,5.0,82,Viudo,58,2015,6,low,-0.23500000000000032,6,10,1514235,-2307,1,38,1
102691,102113,1,Presencial,7.605,8,Hombre,Linkedin,4,310995,97.0,63,Soltero,31,2020,8,high,102041,Presencial,2.96,2,Hombre,Portal Web,6,1152410,46.0,75,Casado,27,2012,1,low,-4.6450000000000005,-6,2,841415,-3137,1,-4,0
100711,102090,1,Presencial,2.405,2,Hombre,Portal Web,5,490942,96.0,72,Divorciado,36,2018,1,high,102171,Presencial,6.83,0,Hombre,Linkedin,4,488000,92.0,76,Soltero,19,2017,2,high,4.425000000000001,-2,-1,-2942,-334,1,-17,0
100369,102145,1,Presencial,4.665,3,Hombre,Ferias & Networking,11,435329,96.0,75,Soltero,44,2021,1,high,102116,Presencial,1.43,1,Mujer,Portal Web,3,692000,89.0,73,Viudo,23,2016,12,high,-3.2350000000000003,-2,-8,256671,-1504,1,-21,1
100299,102022,1,Presencial,2.775,1,Hombre,Portal Web,18,773592,96.0,75,Divorciado,44,2013,10,high,102081,Presencial,2.07,0,Hombre,Portal Web,6,1616000,94.0,66,Viudo,47,2020,5,high,-0.7050000000000001,-1,-12,842408,2409,0,3,0
101168,102074,1,Presencial,3.035,2,Mujer,Referidos,9,920080,96.0,60,Casado,48,2015,12,high,102028,Presencial,1.35,0,Hombre,Ferias & Networking,4,1616000,80.0,83,Viudo,43,2015,12,high,-1.685,-2,-5,695920,17,0,-5,0
103563,102150,1,Presencial,1.88,3,Hombre,Ferias & Networking,2,123616,96.0,78,Soltero,22,2022,7,high,102085,Presencial,3.9,8,Mujer,Portal Web,10,1358450,85.0,75,Casado,32,2012,12,high,2.02,5,8,1234834,-3489,1,10,0
102566,102090,1,Presencial,2.4,1,Hombre,Portal Web,5,492492,96.0,72,Divorciado,36,2018,1,high,102171,Presencial,6.83,0,Hombre,Linkedin,4,488000,92.0,76,Soltero,19,2017,2,high,4.43,-1,-1,-4492,-335,1,-17,0
102921,102045,1,Presencial,1.48,0,Mujer,Referidos,11,736271,96.0,79,Casado,48,2015,7,high,102171,Presencial,3.19,3,Hombre,Portal Web,11,1616000,97.0,65,Casado,53,2023,9,high,1.71,3,0,879729,3003,0,5,0
100464,102021,1,Presencial,2.26,1,Mujer,Portal Web,2,82756,95.0,78,Soltero,10,2013,7,high,102069,Presencial,2.25,1,Hombre,Linkedin,8,1616000,47.0,80,Casado,52,2017,3,low,-0.009999999999999787,0,6,1533244,1363,0,42,1
100926,102108,1,Presencial,2.32,3,Hombre,Portal Web,3,180221,95.0,86,Casado,22,2018,8,high,102040,Presencial,2.92,1,Mujer,Portal Web,5,1616000,46.0,75,Casado,50,2023,5,low,0.6000000000000001,-2,2,1435779,1741,0,28,0
100113,102139,1,Presencial,3.37,3,Hombre,Linkedin,8,406748,95.0,83,Casado,35,2020,6,high,102154,Presencial,6.48,1,Hombre,Ferias & Networking,5,590000,90.0,67,Casado,25,2021,6,high,3.1100000000000003,-2,-3,183252,380,0,-10,0
100687,102116,1,Presencial,1.98,0,Mujer,Portal Web,8,407708,95.0,77,Soltero,34,2018,11,high,102021,Presencial,2.32,0,Mujer,Portal Web,22,1616000,94.0,76,Casado,59,2020,7,high,0.33999999999999986,0,14,1208292,622,0,25,0
101078,102112,1,Presencial,2.425,2,Hombre,Linkedin,5,451255,95.0,69,Casado,36,2018,12,high,102031,Presencial,2.27,7,Hombre,Linkedin,1,692000,83.0,74,Soltero,26,2020,6,high,-0.1549999999999998,5,-4,240745,560,0,-10,0
101540,102068,1,Presencial,3.45,2,Mujer,Ferias & Networking,14,304189,95.0,81,Casado,42,2015,9,high,102043,Híbrida,2.17,3,Mujer,Referidos,4,896000,41.0,81,Soltero,23,2012,8,low,-1.2800000000000002,1,-10,591811,-1124,1,-19,0
101628,102144,1,Presencial,1.715,8,Mujer,Linkedin,5,861114,95.0,65,Soltero,56,2022,9,high,102156,Presencial,2.13,8,Mujer,Portal Web,11,1616000,5.0,82,Viudo,58,2015,6,low,0.4149999999999998,0,6,754886,-2648,1,2,0
103816,102105,1,Presencial,6.345,0,Mujer,Portal Web,4,186508,95.0,69,Soltero,23,2019,4,high,102113,Híbrida,2.07,0,Hombre,Linkedin,8,1616000,85.0,71,Viudo,45,2017,3,high,-4.275,0,4,1429492,-748,1,22,1
102415,102040,1,Presencial,5.585,3,Hombre,Referidos,6,346632,95.0,84,Casado,27,2015,9,high,102106,Presencial,3.21,1,Hombre,Linkedin,15,1616000,91.0,84,Soltero,45,2016,7,high,-2.375,-2,9,1269368,311,0,18,0
103903,102107,1,Presencial,2.49,9,Hombre,Portal Web,7,392108,95.0,71,Casado,31,2017,10,high,102069,Presencial,2.4,1,Mujer,Linkedin,8,1616000,47.0,79,Casado,63,2023,6,low,-0.0900000000000003,-8,1,1223892,2087,0,32,0
103066,102139,1,Presencial,3.39,2,Hombre,Linkedin,8,412983,95.0,83,Casado,35,2020,6,high,102154,Presencial,6.48,1,Hombre,Ferias & Networking,5,590000,90.0,67,Casado,25,2021,6,high,3.0900000000000003,-1,-3,177017,380,0,-10,0
102841,102126,1,Presencial,2.19,2,Mujer,Referidos,5,279469,95.0,79,Casado,43,2020,3,high,102141,Presencial,2.5,1,Mujer,Referidos,2,1049000,94.0,79,Casado,34,2021,1,high,0.31000000000000005,-1,-3,769531,307,0,-9,0
102326,102068,1,Presencial,3.41,2,Mujer,Ferias & Networking,14,303716,95.0,81,Casado,42,2015,9,high,102043,Híbrida,2.17,3,Mujer,Referidos,4,896000,41.0,81,Soltero,23,2012,8,low,-1.2400000000000002,1,-10,592284,-1122,1,-19,0
102870,102022,1,Presencial,2.765,1,Hombre,Portal Web,18,775672,95.0,75,Divorciado,44,2013,10,high,102081,Presencial,2.07,0,Hombre,Portal Web,6,1616000,94.0,66,Viudo,47,2020,5,high,-0.6950000000000003,-1,-12,840328,2410,0,3,0
102116,102021,2,Presencial,2.32,0,Mujer,Portal Web,22,1616000,94.0,76,Casado,59,2020,7,high,102069,Presencial,2.25,1,Hombre,Linkedin,8,1616000,47.0,80,Casado,52,2017,3,low,-0.06999999999999984,1,-14,0,-1211,1,-7,1
102953,102021,1,Presencial,2.255,1,Mujer,Portal Web,3,76521,94.0,78,Soltero,10,2013,6,high,102069,Presencial,2.25,1,Hombre,Linkedin,8,1616000,47.0,80,Casado,52,2017,3,low,-0.004999999999999893,0,5,1539479,1366,0,42,0
102288,102043,1,Presencial,7.3,1,Hombre,Portal Web,10,309725,94.0,78,Soltero,39,2013,6,high,102051,Presencial,1.03,0,Hombre,Portal Web,5,1616000,60.0,76,Casado,44,2019,5,low,-6.27,-1,-5,1306275,2156,0,5,1
100548,102100,1,Presencial,1.66,2,Hombre,Ferias & Networking,10,297528,93.0,71,Soltero,44,2019,8,high,102007,Presencial,3.3,1,Mujer,Portal Web,3,1255430,21.0,59,Casado,30,2013,2,low,1.64,-1,-7,957902,-2365,1,-14,1
101401,102043,1,Presencial,7.31,1,Hombre,Ferias & Networking,10,311708,93.0,78,Soltero,39,2013,6,high,102051,Presencial,1.03,0,Hombre,Portal Web,5,1616000,60.0,76,Casado,44,2019,5,low,-6.279999999999999,-1,-5,1304292,2156,0,5,0
102154,102172,2,Presencial,5.45,1,Hombre,Portal Web,7,1512980,93.0,69,Soltero,39,2017,10,high,102020,Presencial,5.58,1,Hombre,Portal Web,7,1049000,57.0,70,Casado,29,2016,4,low,0.1299999999999999,0,0,-463980,-528,1,-10,1
103993,102172,1,Presencial,1.68,1,Mujer,Ferias & Networking,1,141388,93.0,68,Soltero,24,2023,6,high,102020,Presencial,5.58,1,Hombre,Portal Web,7,1049000,57.0,70,Casado,29,2016,4,low,3.9000000000000004,0,6,907612,-2603,1,5,1
102534,102124,1,Presencial,2.47,1,Mujer,Portal Web,1,206251,93.0,75,Casado,26,2022,7,high,102099,Presencial,2.84,2,Mujer,Linkedin,4,947000,90.0,70,Soltero,24,2012,10,high,0.36999999999999966,1,3,740749,-3546,1,-2,0
102545,102105,1,Presencial,1.835,2,Hombre,Ferias & Networking,14,695878,93.0,74,Viudo,48,2017,10,high,102113,Híbrida,2.07,0,Hombre,Linkedin,8,1616000,85.0,71,Viudo,45,2017,3,high,0.23499999999999988,-2,-6,920122,-217,1,-3,0
102864,102025,1,Presencial,4.78,1,Mujer,Ferias & Networking,16,734842,93.0,75,Viudo,46,2013,11,high,102132,Presencial,1.6,0,Hombre,Portal Web,9,1616000,90.0,81,Viudo,56,2018,4,high,-3.18,-1,-7,881158,1594,0,10,0
100315,102124,1,Presencial,2.495,2,Mujer,Portal Web,1,204898,92.0,75,Casado,26,2022,7,high,102099,Presencial,2.84,2,Mujer,Linkedin,4,947000,90.0,70,Soltero,24,2012,10,high,0.34499999999999975,0,3,742102,-3549,1,-2,0
101101,102103,1,Presencial,3.825,3,Mujer,Ferias & Networking,2,188496,92.0,76,Viudo,24,2020,10,high,102023,Presencial,1.69,6,Hombre,Portal Web,3,1616000,90.0,74,Casado,45,2013,5,high,-2.1350000000000002,3,1,1427504,-2719,1,21,0
102090,102171,2,Presencial,6.83,0,Hombre,Linkedin,4,488000,92.0,76,Soltero,19,2017,2,high,102088,Presencial,2.57,4,Hombre,Linkedin,8,1616000,80.0,69,Casado,43,2017,10,high,-4.26,4,4,1128000,230,0,24,0
103754,102171,1,Presencial,6.545,2,Mujer,Portal Web,9,308491,92.0,68,Casado,33,2023,5,high,102088,Presencial,2.57,4,Hombre,Linkedin,8,1616000,80.0,69,Casado,43,2017,10,high,-3.975,2,-1,1307509,-2061,1,10,0
101653,102128,1,Presencial,1.09,2,Hombre,Portal Web,2,98877,91.0,84,Soltero,19,2020,6,high,102056,Presencial,4.11,10,Mujer,Portal Web,16,1616000,46.0,72,Soltero,55,2021,2,low,3.0200000000000005,8,14,1517123,242,0,36,1
100930,102071,1,Presencial,3.64,3,Hombre,Portal Web,1,121058,91.0,81,Soltero,17,2018,4,high,102171,Presencial,0.87,1,Hombre,Portal Web,11,1616000,85.0,72,Viudo,51,2023,11,high,-2.77,-2,10,1494942,2040,0,34,0
100379,102126,1,Presencial,7.025,1,Hombre,Portal Web,3,141326,91.0,71,Soltero,21,2020,11,high,102141,Presencial,2.5,1,Mujer,Referidos,2,1049000,94.0,79,Casado,34,2021,1,high,-4.525,0,-1,907674,62,0,13,1
101099,102094,1,Presencial,3.97,3,Mujer,Linkedin,2,140573,91.0,81,Casado,18,2017,9,high,102095,Presencial,1.32,1,Hombre,Portal Web,4,998000,90.0,85,Casado,28,2016,2,high,-2.6500000000000004,-2,2,857427,-598,1,10,0
100204,102040,1,Presencial,1.74,0,Hombre,Linkedin,1,137122,91.0,86,Soltero,15,2014,10,high,102106,Presencial,3.21,1,Hombre,Linkedin,15,1616000,91.0,84,Soltero,45,2016,7,high,1.47,1,14,1478878,645,0,30,0
101271,102017,1,Presencial,1.685,0,Mujer,Portal Web,1,147208,91.0,75,Soltero,13,2012,5,high,102035,Presencial,4.62,0,Mujer,Linkedin,2,641000,90.0,84,Casado,25,2019,11,high,2.935,0,1,493792,2726,0,12,0
101468,102082,1,Presencial,4.765,3,Mujer,Portal Web,1,162910,91.0,79,Soltero,19,2017,12,high,102050,Presencial,5.5,2,Mujer,Linkedin,7,1616000,81.0,70,Casado,36,2018,8,high,0.7350000000000003,-1,6,1453090,237,0,17,0
100268,102093,1,Presencial,1.48,2,Mujer,Headhunter,3,184115,91.0,72,Soltero,23,2020,1,high,102139,Presencial,5.41,0,Mujer,Ferias & Networking,4,488000,89.0,62,Soltero,23,2021,6,high,3.93,-2,1,303885,512,0,0,0
101589,102047,1,Presencial,3.135,3,Hombre,Portal Web,1,162599,91.0,78,Soltero,17,2015,3,high,102089,Presencial,2.67,1,Hombre,Linkedin,4,743000,14.0,70,Casado,22,2015,11,low,-0.46499999999999986,-2,3,580401,258,0,5,0
100004,102047,1,Presencial,3.225,5,Mujer,Linkedin,2,183238,91.0,84,Casado,16,2012,10,high,102089,Presencial,2.67,1,Hombre,Linkedin,4,743000,14.0,70,Casado,22,2015,11,low,-0.5550000000000002,-4,2,559762,1119,0,6,0
101576,102106,1,Presencial,1.03,3,Mujer,Portal Web,1,185527,91.0,85,Soltero,23,2019,10,high,102081,Presencial,1.39,1,Mujer,Ferias & Networking,5,1049000,86.0,86,Soltero,32,2019,6,high,0.3599999999999999,-2,4,863473,-125,1,9,0
101517,102085,1,Presencial,2.345,2,Mujer,Portal Web,5,189432,91.0,74,Casado,22,2018,4,high,102145,Presencial,6.59,4,Hombre,Portal Web,12,1616000,47.0,71,Casado,39,2015,8,low,4.244999999999999,2,7,1426568,-979,1,17,0
101386,102160,1,Presencial,2.225,1,Hombre,Ferias & Networking,6,232366,91.0,75,Soltero,28,2022,9,high,102087,Presencial,2.21,0,Hombre,Portal Web,3,794000,83.0,78,Casado,28,2019,8,high,-0.015000000000000124,-1,-3,561634,-1113,1,0,0
101562,102127,1,Presencial,1.41,9,Hombre,Linkedin,1,213411,91.0,80,Casado,25,2019,10,high,102028,Presencial,4.03,2,Mujer,Linkedin,9,1306940,88.0,78,Divorciado,32,2014,5,high,2.62,-7,8,1093529,-1962,1,7,1
100994,102119,1,Presencial,7.565,5,Hombre,Linkedin,2,226417,91.0,66,Casado,28,2022,3,high,102107,Presencial,2.22,2,Hombre,Portal Web,12,1616000,38.0,70,Divorciado,52,2021,1,low,-5.345000000000001,-3,10,1389583,-429,1,24,0
101637,102036,1,Presencial,6.745,6,Mujer,Portal Web,2,225932,91.0,76,Soltero,18,2012,2,high,102054,Presencial,1.68,8,Hombre,Portal Web,5,1616000,92.0,76,Viudo,54,2022,1,high,-5.065,2,3,1390068,3629,0,36,1
101855,102086,1,Presencial,1.46,6,Hombre,Portal Web,5,245656,91.0,78,Soltero,23,2016,5,high,102085,Presencial,2.22,2,Mujer,Linkedin,7,1306940,87.0,68,Divorciado,39,2021,3,high,0.7600000000000002,-4,2,1061284,1763,0,16,1
100013,102115,1,Presencial,1.535,3,Mujer,Linkedin,4,267370,91.0,79,Casado,27,2018,12,high,102116,Presencial,2.0,2,Mujer,Portal Web,4,1616000,94.0,76,Soltero,35,2018,12,high,0.4650000000000001,-1,0,1348630,18,0,8,0
100564,102039,1,Presencial,1.94,3,Hombre,Referidos,3,270445,91.0,71,Soltero,21,2013,6,high,102054,Presencial,3.66,0,Hombre,Referidos,5,1616000,93.0,75,Viudo,49,2018,6,high,1.7200000000000002,-3,2,1345555,1811,0,28,0
100788,102124,1,Presencial,3.175,1,Mujer,Ferias & Networking,5,287705,91.0,74,Casado,29,2020,6,high,102099,Presencial,2.84,2,Mujer,Linkedin,4,947000,90.0,70,Soltero,24,2012,10,high,-0.33499999999999996,1,-1,659295,-2772,1,-5,0
101092,102052,1,Presencial,2.39,0,Hombre,Portal Web,5,287491,91.0,79,Casado,23,2014,1,high,102093,Presencial,4.45,0,Hombre,Linkedin,5,641000,84.0,76,Divorciado,17,2012,4,high,2.06,0,0,353509,-668,1,-6,0
100913,102050,1,Presencial,1.155,10,Hombre,Portal Web,6,290326,91.0,69,Soltero,23,2013,10,high,102069,Presencial,3.7,0,Mujer,Linkedin,11,1512980,90.0,88,Soltero,40,2017,10,high,2.545,-10,5,1222654,1467,0,17,1
101173,102171,1,Presencial,6.565,3,Mujer,Portal Web,9,308964,91.0,68,Casado,33,2023,5,high,102088,Presencial,2.57,4,Hombre,Linkedin,8,1616000,80.0,69,Casado,43,2017,10,high,-3.9950000000000006,1,-1,1307036,-2061,1,10,1
101336,102121,1,Presencial,6.57,1,Hombre,Linkedin,8,311863,91.0,80,Divorciado,30,2019,6,high,102127,Híbrida,1.63,2,Hombre,Portal Web,4,1616000,90.0,77,Divorciado,44,2012,2,high,-4.94,1,-4,1304137,-2664,1,14,1
101486,102083,1,Presencial,7.76,2,Mujer,Portal Web,2,332559,91.0,81,Soltero,27,2015,10,high,102147,Presencial,1.61,0,Mujer,Portal Web,5,1564490,83.0,71,Soltero,44,2021,2,high,-6.1499999999999995,-2,3,1231931,1947,0,17,1
100798,102171,1,Presencial,2.32,1,Mujer,Portal Web,6,364896,91.0,66,Soltero,36,2023,5,high,102088,Presencial,2.57,4,Hombre,Linkedin,8,1616000,80.0,69,Casado,43,2017,10,high,0.25,3,2,1251104,-2052,1,7,1
100856,102130,1,Presencial,1.245,1,Mujer,Portal Web,5,389621,91.0,75,Casado,37,2022,6,high,102068,Presencial,1.97,6,Hombre,Linkedin,5,1616000,84.0,73,Soltero,31,2014,4,high,0.7249999999999999,5,0,1226379,-2966,1,-6,0
101452,102112,1,Presencial,2.92,1,Mujer,Linkedin,6,407714,91.0,75,Soltero,33,2018,6,high,102031,Presencial,2.27,7,Hombre,Linkedin,1,692000,83.0,74,Soltero,26,2020,6,high,-0.6499999999999999,6,-5,284286,751,0,-7,0
100199,102080,1,Presencial,1.9,0,Mujer,Referidos,9,765129,91.0,79,Soltero,32,2017,2,high,102035,Presencial,1.93,0,Mujer,Linkedin,18,1616000,94.0,75,Viudo,47,2016,8,high,0.030000000000000027,0,9,850871,-187,1,15,0
100459,102057,1,Presencial,1.195,1,Mujer,Linkedin,9,406625,91.0,81,Casado,32,2016,8,high,102019,Presencial,1.97,4,Hombre,Portal Web,5,1616000,90.0,73,Viudo,59,2022,12,high,0.7749999999999999,3,-4,1209375,2325,0,27,0
101661,102026,1,Presencial,4.775,5,Hombre,Portal Web,7,407607,91.0,75,Soltero,28,2013,7,high,102101,Presencial,2.7,1,Mujer,Portal Web,15,1616000,97.0,79,Casado,58,2017,6,high,-2.075,-4,8,1208393,1453,0,30,1
101642,102090,1,Presencial,1.74,13,Mujer,Linkedin,5,425975,91.0,81,Soltero,33,2016,12,high,102171,Presencial,6.83,0,Hombre,Linkedin,4,488000,92.0,76,Soltero,19,2017,2,high,5.09,-13,-1,62025,66,0,-14,1
100656,102050,1,Presencial,1.995,10,Mujer,Portal Web,7,425177,91.0,76,Casado,30,2013,12,high,102069,Presencial,3.7,0,Mujer,Linkedin,11,1512980,90.0,88,Soltero,40,2017,10,high,1.705,-10,4,1087803,1405,0,10,0
100716,102171,1,Presencial,5.065,2,Hombre,Portal Web,6,449651,91.0,72,Casado,40,2023,4,high,102088,Presencial,2.57,4,Hombre,Linkedin,8,1616000,80.0,69,Casado,43,2017,10,high,-2.4950000000000006,2,2,1166349,-2030,1,3,0
101493,102149,1,Presencial,2.435,1,Hombre,Referidos,9,452367,91.0,72,Casado,38,2021,3,high,102141,Presencial,2.07,0,Mujer,Headhunter,3,1409960,90.0,86,Casado,37,2017,2,high,-0.3650000000000002,-1,-6,957593,-1493,1,-1,0
100290,102124,1,Presencial,1.555,0,Hombre,Linkedin,7,769611,91.0,65,Soltero,37,2019,5,high,102099,Presencial,2.84,2,Mujer,Linkedin,4,947000,90.0,70,Soltero,24,2012,10,high,1.285,2,-3,177389,-2391,1,-13,1
100654,102088,1,Presencial,1.28,11,Mujer,Portal Web,10,764171,91.0,72,Soltero,35,2017,5,high,102139,Presencial,4.96,1,Mujer,Portal Web,3,488000,82.0,65,Soltero,20,2018,4,high,3.6799999999999997,-10,-7,-276171,345,0,-15,0
100942,102061,1,Presencial,1.875,0,Hombre,Referidos,2,465919,91.0,78,Casado,34,2016,11,high,102115,Presencial,2.14,2,Hombre,Ferias & Networking,10,1203920,37.0,80,Casado,29,2012,11,low,0.2650000000000001,2,8,738001,-1467,1,-5,0
100427,102053,1,Presencial,1.805,0,Mujer,Headhunter,4,451167,91.0,75,Soltero,32,2014,4,high,102030,Presencial,1.29,0,Hombre,Portal Web,11,1616000,81.0,64,Soltero,36,2012,12,high,-0.5149999999999999,0,7,1164833,-472,1,4,0
101739,102052,1,Presencial,2.085,1,Hombre,Ferias & Networking,4,792309,91.0,67,Soltero,32,2014,4,high,102093,Presencial,4.45,0,Hombre,Linkedin,5,641000,84.0,76,Divorciado,17,2012,4,high,2.365,-1,1,-151309,-738,1,-15,0
100052,102144,1,Presencial,2.52,1,Hombre,Linkedin,6,486648,91.0,96,Soltero,41,2022,7,high,102156,Presencial,2.13,8,Mujer,Portal Web,11,1616000,5.0,82,Viudo,58,2015,6,low,-0.3900000000000001,7,5,1129352,-2570,1,17,1
100661,102098,1,Presencial,2.86,2,Mujer,Portal Web,5,491961,91.0,82,Soltero,38,2019,3,high,102049,Presencial,1.8,1,Mujer,Portal Web,16,1616000,90.0,86,Casado,46,2021,1,high,-1.0599999999999998,-1,11,1124039,694,0,8,0
100983,102079,1,Presencial,3.245,2,Hombre,Referidos,4,510760,91.0,78,Casado,37,2017,5,high,102146,Presencial,2.63,1,Mujer,Portal Web,4,1358450,80.0,81,Soltero,35,2016,3,high,-0.6150000000000002,-1,0,847690,-431,1,-2,0
100688,102133,1,Presencial,2.705,0,Hombre,Portal Web,11,258926,91.0,71,Soltero,43,2022,4,high,102151,Híbrida,2.61,2,Hombre,Linkedin,4,1255430,98.0,65,Soltero,35,2018,2,high,-0.0950000000000002,2,-7,996504,-1500,1,-8,0
100120,102052,1,Presencial,4.56,7,Mujer,Portal Web,13,528010,91.0,78,Casado,34,2014,1,high,102093,Presencial,4.45,0,Hombre,Linkedin,5,641000,84.0,76,Divorciado,17,2012,4,high,-0.10999999999999943,-7,-8,112990,-640,1,-17,1
101215,102110,1,Presencial,5.51,1,Mujer,Portal Web,4,261040,91.0,70,Divorciado,42,2020,9,high,102045,Presencial,1.6,5,Mujer,Linkedin,2,998000,87.0,76,Soltero,29,2016,11,high,-3.9099999999999997,4,-2,736960,-1404,1,-13,0
101453,102012,1,Presencial,1.135,8,Mujer,Portal Web,9,434977,91.0,79,Soltero,34,2013,1,high,102122,Presencial,2.09,1,Mujer,Portal Web,7,1100000,90.0,80,Casado,34,2019,7,high,0.9549999999999998,-7,-2,665023,2354,0,0,0
100804,102132,1,Presencial,5.57,1,Hombre,Referidos,6,267525,91.0,78,Soltero,43,2020,12,high,102138,Presencial,4.51,1,Hombre,Linkedin,16,1616000,25.0,80,Viudo,45,2014,3,low,-1.0600000000000005,0,10,1348475,-2453,1,2,0
101148,102045,1,Presencial,1.585,3,Mujer,Linkedin,14,276009,91.0,70,Divorciado,37,2014,2,high,102171,Presencial,3.19,3,Hombre,Portal Web,11,1616000,97.0,65,Casado,53,2023,9,high,1.605,0,-3,1339991,3519,0,16,1
100304,102024,1,Presencial,1.33,3,Hombre,Ferias & Networking,4,279350,91.0,74,Casado,37,2013,7,high,102074,Presencial,2.28,0,Hombre,Headhunter,9,1616000,84.0,70,Casado,48,2018,3,high,0.9499999999999997,-3,5,1336650,1691,0,11,0
100971,102127,1,Presencial,5.82,2,Hombre,Portal Web,9,286857,91.0,83,Casado,44,2019,7,high,102028,Presencial,4.03,2,Mujer,Linkedin,9,1306940,88.0,78,Divorciado,32,2014,5,high,-1.79,0,0,1020083,-1871,1,-12,1
100087,102074,1,Presencial,2.025,1,Hombre,Ferias & Networking,7,288419,91.0,77,Divorciado,39,2015,8,high,102028,Presencial,1.35,0,Hombre,Ferias & Networking,4,1616000,80.0,83,Viudo,43,2015,12,high,-0.6749999999999998,-1,-3,1327581,150,0,4,0
100578,102021,1,Presencial,2.465,1,Mujer,Portal Web,3,294678,91.0,59,Soltero,39,2013,7,high,102069,Presencial,2.25,1,Hombre,Linkedin,8,1616000,47.0,80,Casado,52,2017,3,low,-0.21499999999999986,0,5,1321322,1347,0,13,0
101668,102090,1,Presencial,1.97,1,Hombre,Referidos,13,456816,91.0,70,Viudo,46,2019,9,high,102171,Presencial,6.83,0,Hombre,Linkedin,4,488000,92.0,76,Soltero,19,2017,2,high,4.86,-1,-9,31184,-943,1,-27,0
100671,102110,1,Presencial,2.05,2,Mujer,Portal Web,3,310770,91.0,84,Casado,45,2019,9,high,102045,Presencial,1.6,5,Mujer,Linkedin,2,998000,87.0,76,Soltero,29,2016,11,high,-0.44999999999999973,3,-1,687230,-1015,1,-16,0
101609,102061,1,Presencial,4.12,8,Hombre,Portal Web,15,641707,91.0,74,Casado,42,2015,8,high,102115,Presencial,2.14,2,Hombre,Ferias & Networking,10,1203920,37.0,80,Casado,29,2012,11,low,-1.98,-6,-5,562213,-1020,1,-13,0
101594,102041,1,Presencial,2.07,3,Hombre,Ferias & Networking,15,918780,91.0,81,Soltero,43,2015,8,high,102147,Presencial,1.29,0,Mujer,Portal Web,8,1616000,44.0,73,Casado,51,2014,5,low,-0.7799999999999998,-3,-7,697220,-441,1,8,1
101351,102139,1,Presencial,4.665,0,Mujer,Headhunter,4,773984,91.0,74,Soltero,50,2021,6,high,102154,Presencial,6.48,1,Hombre,Ferias & Networking,5,590000,90.0,67,Casado,25,2021,6,high,1.8150000000000004,1,1,-183984,13,0,-25,0
100857,102065,1,Presencial,1.67,0,Mujer,Ferias & Networking,9,656067,91.0,80,Soltero,43,2014,6,high,102026,Presencial,2.44,2,Hombre,Ferias & Networking,13,1616000,45.0,60,Divorciado,35,2014,10,low,0.77,2,4,959933,118,0,-8,0
101045,102025,1,Presencial,4.59,3,Hombre,Portal Web,5,659480,91.0,70,Casado,41,2013,7,high,102132,Presencial,1.6,0,Hombre,Portal Web,9,1616000,90.0,81,Viudo,56,2018,4,high,-2.9899999999999998,-3,4,956520,1728,0,15,0
100618,102087,1,Presencial,2.27,1,Hombre,Referidos,8,673723,91.0,75,Soltero,47,2017,12,high,102111,Presencial,7.16,9,Mujer,Linkedin,10,1616000,98.0,79,Casado,42,2012,5,high,4.890000000000001,8,2,942277,-2058,1,-5,1
101969,102051,1,Presencial,1.735,6,Hombre,Portal Web,18,702614,91.0,79,Soltero,43,2014,3,high,102075,Híbrida,1.39,1,Hombre,Portal Web,11,1616000,83.0,76,Casado,46,2019,11,high,-0.3450000000000002,-5,-7,913386,2080,0,3,0
101899,102017,1,Presencial,3.41,3,Mujer,Ferias & Networking,7,675858,91.0,73,Soltero,41,2012,2,high,102035,Presencial,4.62,0,Mujer,Linkedin,2,641000,90.0,84,Casado,25,2019,11,high,1.21,-3,-5,-34858,2811,0,-16,0
100665,102129,1,Presencial,2.77,3,Mujer,Portal Web,16,694180,91.0,75,Viudo,52,2022,1,high,102142,Presencial,2.1,2,Mujer,Linkedin,3,590000,41.0,74,Soltero,24,2020,1,low,-0.6699999999999999,-1,-13,-104180,-754,1,-28,1
100072,102101,1,Presencial,4.08,0,Mujer,Portal Web,14,699577,91.0,72,Viudo,50,2019,7,high,102089,Presencial,6.23,0,Hombre,Portal Web,26,1616000,92.0,68,Divorciado,55,2014,1,high,2.1500000000000004,0,12,916423,-2024,1,5,1
100713,102054,1,Presencial,2.99,1,Hombre,Linkedin,9,699169,91.0,74,Casado,44,2014,1,high,102044,Presencial,2.91,1,Hombre,Linkedin,17,1616000,85.0,74,Divorciado,41,2012,11,high,-0.08000000000000007,0,8,916831,-421,1,-3,0
101181,102028,1,Presencial,6.455,2,Mujer,Portal Web,8,701137,91.0,77,Viudo,42,2012,1,high,102085,Presencial,1.39,2,Mujer,Linkedin,12,1358450,97.0,72,Soltero,35,2016,12,high,-5.065,0,4,657313,1804,0,-7,0
101554,102014,1,Presencial,1.835,2,Hombre,Referidos,17,735358,91.0,83,Viudo,45,2013,4,high,102096,Presencial,1.78,1,Mujer,Portal Web,2,488000,98.0,78,Soltero,25,2023,1,high,-0.05499999999999994,-1,-15,-247358,3577,0,-20,0
100059,102135,1,Presencial,2.81,1,Hombre,Portal Web,3,794364,91.0,83,Viudo,55,2023,1,high,102028,Presencial,2.04,1,Hombre,Portal Web,2,1616000,82.0,75,Divorciado,49,2017,10,high,-0.77,0,-1,821636,-1932,1,-6,0
100795,102108,1,Presencial,4.29,2,Mujer,Ferias & Networking,9,733657,91.0,74,Viudo,53,2021,3,high,102040,Presencial,2.92,1,Mujer,Portal Web,5,1616000,46.0,75,Casado,50,2023,5,low,-1.37,-1,-4,882343,790,0,-3,0
100527,102123,1,Presencial,4.875,1,Mujer,Linkedin,8,735117,91.0,83,Viudo,53,2020,12,high,102043,Presencial,5.5,1,Mujer,Linkedin,16,1616000,42.0,66,Soltero,51,2021,9,low,0.625,0,8,880883,284,0,-2,0
100034,102064,1,Presencial,6.29,6,Hombre,Portal Web,3,741552,91.0,77,Viudo,49,2016,5,high,102067,Presencial,1.34,0,Hombre,Portal Web,6,1616000,92.0,92,Casado,43,2018,2,high,-4.95,-6,3,874448,634,0,-6,0
101683,102047,1,Presencial,6.42,1,Hombre,Linkedin,7,817068,91.0,63,Viudo,49,2015,4,high,102089,Presencial,2.67,1,Hombre,Linkedin,4,743000,14.0,70,Casado,22,2015,11,low,-3.75,0,-3,-74068,221,0,-27,0
100640,102107,1,Presencial,4.97,1,Mujer,Portal Web,7,894597,91.0,77,Soltero,56,2019,12,high,102069,Presencial,2.4,1,Mujer,Linkedin,8,1616000,47.0,79,Casado,63,2023,6,low,-2.57,0,1,721403,1271,0,7,0
104008,102128,1,Presencial,1.05,2,Hombre,Portal Web,2,98612,91.0,84,Soltero,19,2020,6,high,102056,Presencial,4.11,10,Mujer,Portal Web,16,1616000,46.0,72,Soltero,55,2021,2,low,3.0600000000000005,8,14,1517388,244,0,36,1
103078,102071,1,Presencial,3.685,3,Hombre,Portal Web,1,119666,91.0,81,Soltero,17,2018,4,high,102171,Presencial,0.87,1,Hombre,Portal Web,11,1616000,85.0,72,Viudo,51,2023,11,high,-2.815,-2,10,1496334,2037,0,34,0
102595,102084,1,Presencial,2.525,1,Mujer,Linkedin,2,136848,91.0,76,Soltero,18,2018,6,high,102171,Presencial,2.62,3,Mujer,Portal Web,14,1616000,89.0,76,Divorciado,50,2023,7,high,0.0950000000000002,2,12,1479152,1855,0,32,0
103147,102105,1,Presencial,1.5,1,Hombre,Portal Web,3,161881,91.0,71,Soltero,20,2018,5,high,102113,Híbrida,2.07,0,Hombre,Linkedin,8,1616000,85.0,71,Viudo,45,2017,3,high,0.5699999999999998,-1,5,1454119,-419,1,25,0
103372,102082,1,Presencial,4.775,3,Mujer,Portal Web,1,160345,91.0,79,Soltero,20,2017,12,high,102050,Presencial,5.5,2,Mujer,Linkedin,7,1616000,81.0,70,Casado,36,2018,8,high,0.7249999999999996,-1,6,1455655,238,0,16,0
103548,102056,1,Presencial,2.335,3,Mujer,Linkedin,5,209017,91.0,76,Soltero,19,2015,6,high,102014,Presencial,5.24,1,Hombre,Ferias & Networking,16,1616000,70.0,63,Viudo,65,2023,3,low,2.9050000000000002,-2,11,1406983,2812,0,46,1
102399,102031,1,Presencial,3.18,0,Hombre,Headhunter,1,186105,91.0,68,Soltero,16,2012,12,high,102111,Presencial,2.95,2,Hombre,Portal Web,8,1610000,76.0,87,Casado,31,2017,7,low,-0.22999999999999998,2,7,1423895,1652,0,15,0
103828,102028,1,Presencial,5.86,2,Hombre,Portal Web,1,201296,91.0,72,Casado,16,2012,5,high,102085,Presencial,1.39,2,Mujer,Linkedin,12,1358450,97.0,72,Soltero,35,2016,12,high,-4.470000000000001,0,11,1157154,1689,0,19,1
103860,102106,1,Presencial,1.04,3,Mujer,Portal Web,1,189467,91.0,85,Soltero,23,2019,10,high,102081,Presencial,1.39,1,Mujer,Ferias & Networking,5,1049000,86.0,86,Soltero,32,2019,6,high,0.34999999999999987,-2,4,859533,-124,1,9,1
102295,102160,1,Presencial,2.225,0,Hombre,Ferias & Networking,6,232115,91.0,75,Soltero,28,2022,9,high,102087,Presencial,2.21,0,Hombre,Portal Web,3,794000,83.0,78,Casado,28,2019,8,high,-0.015000000000000124,0,-3,561885,-1114,1,0,0
102575,102022,1,Presencial,1.58,1,Mujer,Portal Web,1,205407,91.0,72,Casado,18,2013,8,high,102081,Presencial,2.07,0,Hombre,Portal Web,6,1616000,94.0,66,Viudo,47,2020,5,high,0.48999999999999977,-1,5,1410593,2471,0,29,0
102284,102140,1,Presencial,1.65,1,Mujer,Headhunter,2,227160,91.0,70,Casado,29,2023,1,high,102040,Presencial,2.55,0,Mujer,Portal Web,16,1616000,46.0,69,Casado,39,2012,2,low,0.8999999999999999,-1,14,1388840,-3983,1,10,0
103694,102036,1,Presencial,6.75,7,Mujer,Portal Web,2,229146,91.0,76,Soltero,18,2012,1,high,102054,Presencial,1.68,8,Hombre,Portal Web,5,1616000,92.0,76,Viudo,54,2022,1,high,-5.07,1,3,1386854,3631,0,36,1
103502,102063,1,Presencial,2.09,2,Hombre,Portal Web,8,246708,91.0,88,Casado,21,2014,2,high,102135,Presencial,2.73,0,Mujer,Linkedin,1,539000,26.0,75,Soltero,24,2021,4,low,0.6400000000000001,-2,-7,292292,2622,0,3,1
102680,102017,1,Presencial,1.735,1,Hombre,Portal Web,5,251384,91.0,82,Soltero,21,2013,9,high,102035,Presencial,4.62,0,Mujer,Linkedin,2,641000,90.0,84,Casado,25,2019,11,high,2.885,-1,-3,389616,2251,0,4,0
103326,102107,1,Presencial,3.36,1,Hombre,Ferias & Networking,6,270673,91.0,78,Casado,27,2018,9,high,102069,Presencial,2.4,1,Mujer,Linkedin,8,1616000,47.0,79,Casado,63,2023,6,low,-0.96,0,2,1345327,1733,0,36,0
103015,102039,1,Presencial,1.92,2,Hombre,Referidos,3,270272,91.0,71,Soltero,21,2013,7,high,102054,Presencial,3.66,0,Hombre,Referidos,5,1616000,93.0,75,Viudo,49,2018,6,high,1.7400000000000002,-2,2,1345728,1810,0,28,0
102368,102033,1,Presencial,7.505,1,Mujer,Ferias & Networking,4,285996,91.0,76,Casado,22,2013,2,high,102172,Presencial,6.25,2,Mujer,Portal Web,16,1616000,90.0,79,Divorciado,39,2014,5,high,-1.255,1,12,1330004,446,0,17,0
102240,102160,1,Presencial,3.335,2,Hombre,Referidos,9,329478,91.0,79,Casado,33,2022,4,high,102087,Presencial,2.21,0,Hombre,Portal Web,3,794000,83.0,78,Casado,28,2019,8,high,-1.125,-2,-6,464522,-975,1,-5,0
102247,102114,1,Presencial,4.49,2,Mujer,Linkedin,7,305127,91.0,78,Soltero,29,2018,7,high,102050,Presencial,1.44,1,Mujer,Portal Web,5,1616000,91.0,69,Divorciado,47,2021,5,high,-3.0500000000000003,-1,-2,1310873,1054,0,18,0
102275,102083,1,Presencial,4.87,1,Mujer,Ferias & Networking,6,310677,91.0,77,Casado,27,2017,3,high,102147,Presencial,1.61,0,Mujer,Portal Web,5,1564490,83.0,71,Soltero,44,2021,2,high,-3.26,-1,-1,1253813,1429,0,17,0
102292,102057,1,Presencial,2.495,1,Hombre,Linkedin,2,305522,91.0,74,Casado,27,2016,12,high,102019,Presencial,1.97,4,Hombre,Portal Web,5,1616000,90.0,73,Viudo,59,2022,12,high,-0.5250000000000001,3,3,1310478,2208,0,32,0
103205,102118,1,Presencial,4.26,8,Mujer,Portal Web,3,345611,91.0,83,Soltero,32,2020,3,high,102171,Presencial,4.76,17,Mujer,Linkedin,4,1616000,86.0,74,Soltero,39,2023,8,high,0.5,9,1,1270389,1253,0,7,1
102859,102105,1,Presencial,3.19,1,Hombre,Portal Web,8,332706,91.0,79,Soltero,29,2018,4,high,102113,Híbrida,2.07,0,Hombre,Linkedin,8,1616000,85.0,71,Viudo,45,2017,3,high,-1.12,-1,0,1283294,-375,1,16,1
102568,102083,1,Presencial,7.74,1,Mujer,Portal Web,2,331299,91.0,81,Casado,27,2015,10,high,102147,Presencial,1.61,0,Mujer,Portal Web,5,1564490,83.0,71,Soltero,44,2021,2,high,-6.13,-1,3,1233191,1946,0,17,0
102421,102022,1,Presencial,1.985,3,Hombre,Ferias & Networking,9,351060,91.0,64,Casado,25,2013,3,high,102081,Presencial,2.07,0,Hombre,Portal Web,6,1616000,94.0,66,Viudo,47,2020,5,high,0.08499999999999974,-3,-3,1264940,2623,0,22,0
103337,102120,1,Presencial,2.245,5,Hombre,Portal Web,6,388034,91.0,79,Casado,32,2018,10,high,102171,Presencial,6.48,2,Hombre,Ferias & Networking,9,1616000,80.0,71,Casado,47,2023,8,high,4.235,-3,3,1227966,1759,0,15,0
104125,102156,1,Presencial,1.87,2,Mujer,Portal Web,7,385327,91.0,79,Soltero,37,2023,3,high,102154,Presencial,4.23,2,Hombre,Portal Web,22,1616000,92.0,76,Soltero,63,2023,12,high,2.3600000000000003,0,15,1230673,267,0,26,0
102969,102101,1,Presencial,1.625,3,Hombre,Linkedin,2,390751,91.0,67,Soltero,31,2017,5,high,102089,Presencial,6.23,0,Hombre,Portal Web,26,1616000,92.0,68,Divorciado,55,2014,1,high,4.605,-3,24,1225249,-1228,1,24,0
103564,102052,1,Presencial,4.85,3,Mujer,Ferias & Networking,3,388523,91.0,66,Soltero,30,2016,4,high,102093,Presencial,4.45,0,Hombre,Linkedin,5,641000,84.0,76,Divorciado,17,2012,4,high,-0.39999999999999947,-3,2,252477,-1472,1,-13,0
104155,102106,1,Presencial,1.295,2,Hombre,Portal Web,11,430872,91.0,67,Soltero,36,2021,1,high,102081,Presencial,1.39,1,Mujer,Ferias & Networking,5,1049000,86.0,86,Soltero,32,2019,6,high,0.09499999999999997,-1,-6,618128,-570,1,-4,1
103260,102144,1,Presencial,3.015,1,Mujer,Ferias & Networking,7,426682,91.0,69,Casado,38,2022,1,high,102156,Presencial,2.13,8,Mujer,Portal Web,11,1616000,5.0,82,Viudo,58,2015,6,low,-0.8850000000000002,7,4,1189318,-2386,1,20,0
102780,102050,1,Presencial,1.99,10,Mujer,Portal Web,7,425176,91.0,76,Casado,30,2013,12,high,102069,Presencial,3.7,0,Mujer,Linkedin,11,1512980,90.0,88,Soltero,40,2017,10,high,1.7100000000000002,-10,4,1087804,1405,0,10,0
102220,102125,1,Presencial,2.01,1,Mujer,Headhunter,8,466869,91.0,86,Viudo,39,2021,9,high,102096,Híbrida,4.0,2,Mujer,Referidos,5,692000,87.0,82,Casado,29,2022,7,high,1.9900000000000002,1,-3,225131,316,0,-10,0
103748,102095,1,Presencial,1.46,2,Hombre,Portal Web,6,447505,91.0,77,Casado,36,2018,11,high,102171,Presencial,3.28,2,Mujer,Portal Web,3,1616000,80.0,75,Soltero,42,2023,10,high,1.8199999999999998,0,-3,1168495,1793,0,6,1
103207,102053,1,Presencial,1.825,0,Mujer,Headhunter,4,449338,91.0,75,Soltero,31,2014,4,high,102030,Presencial,1.29,0,Hombre,Portal Web,11,1616000,81.0,64,Soltero,36,2012,12,high,-0.5349999999999999,0,7,1166662,-473,1,5,0
103149,102079,1,Presencial,5.38,2,Mujer,Portal Web,4,468737,91.0,78,Soltero,37,2018,10,high,102146,Presencial,2.63,1,Mujer,Portal Web,4,1358450,80.0,81,Soltero,35,2016,3,high,-2.75,-1,0,889713,-945,1,-2,0
102178,102052,1,Presencial,2.6,2,Hombre,Ferias & Networking,4,771108,91.0,80,Casado,34,2016,5,high,102093,Presencial,4.45,0,Hombre,Linkedin,5,641000,84.0,76,Divorciado,17,2012,4,high,1.85,-2,1,-130108,-1517,1,-17,0
102888,102058,1,Presencial,1.755,9,Hombre,Portal Web,5,849764,91.0,71,Casado,33,2014,5,high,102172,Presencial,1.4,2,Hombre,Ferias & Networking,11,1616000,75.0,71,Casado,59,2021,2,low,-0.355,-7,6,766236,2480,0,26,0
103765,102051,1,Presencial,1.95,2,Mujer,Referidos,9,831302,91.0,67,Casado,32,2013,10,high,102075,Híbrida,1.39,1,Hombre,Portal Web,11,1616000,83.0,76,Casado,46,2019,11,high,-0.56,-1,2,784698,2209,0,14,0
103111,102012,1,Presencial,5.22,5,Hombre,Referidos,5,469565,91.0,85,Casado,30,2012,3,high,102122,Presencial,2.09,1,Mujer,Portal Web,7,1100000,90.0,80,Casado,34,2019,7,high,-3.13,-4,2,630435,2659,0,4,0
103339,102122,1,Presencial,5.05,1,Mujer,Ferias & Networking,13,771722,91.0,83,Divorciado,39,2020,6,high,102075,Presencial,1.83,4,Hombre,Portal Web,6,1616000,90.0,66,Viudo,48,2019,3,high,-3.2199999999999998,3,-7,844278,-465,1,9,1
103226,102094,1,Presencial,1.895,2,Mujer,Portal Web,6,872150,91.0,71,Casado,38,2019,5,high,102095,Presencial,1.32,1,Hombre,Portal Web,4,998000,90.0,85,Casado,28,2016,2,high,-0.575,-1,-2,125850,-1190,1,-10,1
103037,102102,1,Presencial,3.08,1,Mujer,Portal Web,12,510122,91.0,71,Casado,38,2018,10,high,102018,Presencial,2.48,0,Hombre,Portal Web,5,1616000,92.0,63,Viudo,49,2019,4,high,-0.6000000000000001,-1,-7,1105878,185,0,11,0
103651,102080,1,Presencial,1.195,2,Mujer,Portal Web,6,492572,91.0,68,Soltero,36,2017,2,high,102035,Presencial,1.93,0,Mujer,Linkedin,18,1616000,94.0,75,Viudo,47,2016,8,high,0.7349999999999999,-2,12,1123428,-194,1,11,1
103832,102079,1,Presencial,3.25,3,Hombre,Referidos,4,504971,91.0,78,Casado,37,2017,5,high,102146,Presencial,2.63,1,Mujer,Portal Web,4,1358450,80.0,81,Soltero,35,2016,3,high,-0.6200000000000001,-2,0,853479,-429,1,-2,1
103486,102077,1,Presencial,2.84,0,Mujer,Portal Web,11,378475,91.0,77,Soltero,37,2017,2,high,102146,Presencial,2.27,0,Hombre,Ferias & Networking,11,1306940,31.0,64,Soltero,39,2021,6,low,-0.5699999999999998,0,0,928465,1595,0,2,0
104079,102044,1,Presencial,3.14,7,Mujer,Portal Web,7,456680,91.0,69,Divorciado,35,2013,3,high,102155,Presencial,1.54,1,Hombre,Ferias & Networking,14,1616000,56.0,68,Soltero,47,2023,3,low,-1.6,-6,7,1159320,3653,0,12,1
103208,102009,1,Presencial,2.125,2,Mujer,Portal Web,7,458830,91.0,82,Soltero,35,2012,11,high,102116,Presencial,2.06,2,Hombre,Referidos,9,1461470,90.0,73,Casado,44,2022,8,high,-0.06499999999999995,0,2,1002640,3542,0,9,1
103159,102118,1,Presencial,6.27,0,Mujer,Portal Web,6,274088,91.0,72,Casado,45,2021,11,high,102171,Presencial,4.76,17,Mujer,Linkedin,4,1616000,86.0,74,Soltero,39,2023,8,high,-1.5099999999999998,17,-2,1341912,637,0,-6,0
103299,102049,1,Presencial,4.63,1,Hombre,Referidos,5,286537,91.0,76,Viudo,38,2014,12,high,102029,Presencial,6.89,0,Mujer,Portal Web,9,1616000,19.0,77,Divorciado,49,2023,3,low,2.26,-1,4,1329463,3013,0,11,0
103591,102041,1,Presencial,1.985,5,Hombre,Ferias & Networking,11,291239,91.0,76,Soltero,38,2014,8,high,102147,Presencial,1.29,0,Mujer,Portal Web,8,1616000,44.0,73,Casado,51,2014,5,low,-0.6950000000000001,-5,-3,1324761,-97,1,13,0
103803,102110,1,Presencial,2.035,2,Mujer,Portal Web,3,307789,91.0,84,Casado,45,2019,9,high,102045,Presencial,1.6,5,Mujer,Linkedin,2,998000,87.0,76,Soltero,29,2016,11,high,-0.43500000000000005,3,-1,690211,-1012,1,-16,0
103935,102086,1,Presencial,3.18,3,Hombre,Portal Web,11,396764,91.0,71,Viudo,44,2018,3,high,102085,Presencial,2.22,2,Mujer,Linkedin,7,1306940,87.0,68,Divorciado,39,2021,3,high,-0.96,-1,-4,910176,1070,0,-5,0
103310,102075,1,Presencial,3.795,2,Hombre,Portal Web,9,301116,91.0,81,Casado,43,2018,3,high,102047,Presencial,2.7,1,Hombre,Referidos,11,1255430,90.0,76,Casado,30,2013,3,high,-1.0949999999999998,-1,2,954314,-1799,1,-13,0
103506,102047,1,Presencial,2.1,1,Mujer,Referidos,4,300248,91.0,72,Divorciado,39,2014,8,high,102089,Presencial,2.67,1,Hombre,Linkedin,4,743000,14.0,70,Casado,22,2015,11,low,0.5699999999999998,0,0,442752,465,0,-17,1
103362,102153,1,Presencial,1.62,1,Hombre,Ferias & Networking,13,795064,91.0,75,Divorciado,49,2022,9,high,102143,Presencial,6.39,1,Mujer,Linkedin,5,1616000,90.0,68,Casado,41,2019,6,high,4.77,0,-8,820936,-1185,1,-8,1
103751,102116,1,Presencial,1.195,0,Hombre,Linkedin,5,311417,91.0,88,Viudo,48,2021,11,high,102021,Presencial,2.32,0,Mujer,Portal Web,22,1616000,94.0,76,Casado,59,2020,7,high,1.1249999999999998,0,17,1304583,-480,1,11,1
102372,102134,1,Presencial,1.85,3,Hombre,Portal Web,14,376467,91.0,81,Soltero,47,2020,9,high,102135,Presencial,2.25,2,Hombre,Portal Web,5,1358450,90.0,69,Viudo,31,2012,7,high,0.3999999999999999,-1,-9,981983,-2994,1,-16,1
102470,102020,1,Presencial,1.865,1,Hombre,Portal Web,6,305345,91.0,68,Casado,38,2012,10,high,102134,Presencial,6.63,1,Mujer,Linkedin,11,1203920,90.0,78,Casado,35,2018,12,high,4.765,0,5,898575,2254,0,-3,0
102792,102062,1,Presencial,1.89,2,Mujer,Referidos,15,640050,91.0,78,Soltero,44,2017,5,high,102149,Presencial,0.92,2,Mujer,Referidos,6,692000,38.0,72,Soltero,21,2014,10,low,-0.9699999999999999,0,-9,51950,-970,1,-23,0
103855,102118,1,Presencial,1.55,2,Hombre,Linkedin,10,662433,91.0,78,Viudo,49,2020,10,high,102171,Presencial,4.76,17,Mujer,Linkedin,4,1616000,86.0,74,Soltero,39,2023,8,high,3.21,15,-6,953567,1034,0,-10,1
103650,102077,1,Presencial,5.08,2,Mujer,Referidos,17,656611,91.0,84,Soltero,46,2018,5,high,102146,Presencial,2.27,0,Hombre,Ferias & Networking,11,1306940,31.0,64,Soltero,39,2021,6,low,-2.81,-2,-6,650329,1145,0,-7,0
102572,102063,1,Presencial,1.565,1,Mujer,Linkedin,8,880034,91.0,83,Casado,46,2017,7,high,102135,Presencial,2.73,0,Mujer,Linkedin,1,539000,26.0,75,Soltero,24,2021,4,low,1.165,-1,-7,-341034,1378,0,-22,0
102459,102014,1,Presencial,3.48,7,Mujer,Linkedin,8,776934,91.0,74,Viudo,41,2012,7,high,102096,Presencial,1.78,1,Mujer,Portal Web,2,488000,98.0,78,Soltero,25,2023,1,high,-1.7,-6,-6,-288934,3831,0,-16,1
103449,102129,1,Presencial,1.755,1,Mujer,Referidos,16,676389,91.0,75,Soltero,51,2022,1,high,102142,Presencial,2.1,2,Mujer,Linkedin,3,590000,41.0,74,Soltero,24,2020,1,low,0.3450000000000002,1,-13,-86389,-735,1,-27,0
102933,102127,1,Presencial,2.185,3,Mujer,Portal Web,11,679286,91.0,72,Soltero,50,2021,7,high,102028,Presencial,4.03,2,Mujer,Linkedin,9,1306940,88.0,78,Divorciado,32,2014,5,high,1.8450000000000002,-1,-2,627654,-2602,1,-18,1
103351,102103,1,Presencial,4.64,2,Hombre,Portal Web,3,678655,91.0,74,Divorciado,49,2020,2,high,102023,Presencial,1.69,6,Hombre,Portal Web,3,1616000,90.0,74,Casado,45,2013,5,high,-2.9499999999999997,4,0,937345,-2453,1,-4,1
103671,102087,1,Presencial,2.26,1,Hombre,Referidos,8,681260,91.0,75,Soltero,47,2017,12,high,102111,Presencial,7.16,9,Mujer,Linkedin,10,1616000,98.0,79,Casado,42,2012,5,high,4.9,8,2,934740,-2060,1,-5,0
102419,102030,1,Presencial,3.765,1,Mujer,Portal Web,15,698855,91.0,64,Casado,42,2012,6,high,102058,Presencial,6.34,0,Mujer,Referidos,14,1616000,90.0,76,Viudo,41,2015,4,high,2.5749999999999997,-1,-1,917145,1028,0,-1,0
103405,102129,1,Presencial,2.765,3,Mujer,Portal Web,16,702225,91.0,75,Viudo,52,2022,2,high,102142,Presencial,2.1,2,Mujer,Linkedin,3,590000,41.0,74,Soltero,24,2020,1,low,-0.665,-1,-13,-112225,-755,1,-28,0
103552,102101,1,Presencial,4.125,1,Mujer,Portal Web,14,696436,91.0,72,Viudo,50,2019,7,high,102089,Presencial,6.23,0,Hombre,Portal Web,26,1616000,92.0,68,Divorciado,55,2014,1,high,2.1050000000000004,-1,12,919564,-2022,1,5,0
103921,102112,1,Presencial,2.145,3,Mujer,Linkedin,5,700479,91.0,91,Divorciado,48,2018,7,high,102031,Presencial,2.27,7,Hombre,Linkedin,1,692000,83.0,74,Soltero,26,2020,6,high,0.125,4,-4,-8479,708,0,-22,1
102736,102054,1,Presencial,2.945,1,Hombre,Linkedin,9,701770,91.0,74,Casado,44,2014,1,high,102044,Presencial,2.91,1,Hombre,Linkedin,17,1616000,85.0,74,Divorciado,41,2012,11,high,-0.0349999999999997,0,8,914230,-421,1,-3,0
102776,102162,1,Presencial,1.27,2,Mujer,Portal Web,9,737883,91.0,84,Casado,54,2022,12,high,102146,Presencial,1.12,0,Mujer,Referidos,9,1616000,31.0,74,Casado,41,2022,11,low,-0.1499999999999999,-2,0,878117,-14,1,-13,0
103344,102014,1,Presencial,1.86,2,Hombre,Referidos,17,738875,91.0,83,Viudo,45,2013,3,high,102096,Presencial,1.78,1,Mujer,Portal Web,2,488000,98.0,78,Soltero,25,2023,1,high,-0.08000000000000007,-1,-15,-250875,3579,0,-20,0
103204,102108,1,Presencial,4.285,3,Mujer,Ferias & Networking,9,734855,91.0,74,Viudo,54,2021,3,high,102040,Presencial,2.92,1,Mujer,Portal Web,5,1616000,46.0,75,Casado,50,2023,5,low,-1.3650000000000002,-2,-4,881145,788,0,-4,0
102822,102123,1,Presencial,4.89,1,Mujer,Linkedin,8,739054,91.0,83,Viudo,53,2020,12,high,102043,Presencial,5.5,1,Mujer,Linkedin,16,1616000,42.0,66,Soltero,51,2021,9,low,0.6100000000000003,0,8,876946,282,0,-2,0
102256,102103,1,Presencial,5.525,3,Hombre,Linkedin,14,733521,91.0,84,Divorciado,52,2020,4,high,102023,Presencial,1.69,6,Hombre,Portal Web,3,1616000,90.0,74,Casado,45,2013,5,high,-3.8350000000000004,3,-11,882479,-2522,1,-7,0
103317,102018,1,Presencial,4.96,3,Mujer,Portal Web,7,742244,91.0,76,Divorciado,45,2013,4,high,102160,Presencial,5.57,5,Hombre,Portal Web,3,692000,90.0,69,Divorciado,28,2022,2,high,0.6100000000000003,2,-4,-50244,3230,0,-17,0
102482,102075,1,Presencial,2.935,1,Hombre,Referidos,9,876655,91.0,76,Casado,50,2015,7,high,102047,Presencial,2.7,1,Hombre,Referidos,11,1255430,90.0,76,Casado,30,2013,3,high,-0.23499999999999988,0,2,378775,-841,1,-20,0
102183,102023,1,Presencial,1.45,4,Hombre,Referidos,7,916044,91.0,84,Casado,50,2012,7,high,102105,Híbrida,4.9,1,Hombre,Portal Web,4,539000,80.0,65,Casado,23,2019,12,high,3.45,-3,-3,-377044,2722,0,-27,0
100664,102061,1,Presencial,1.815,2,Hombre,Ferias & Networking,1,97210,90.0,72,Soltero,11,2014,3,high,102115,Presencial,2.14,2,Hombre,Ferias & Networking,10,1203920,37.0,80,Casado,29,2012,11,low,0.3250000000000002,0,9,1106710,-493,1,18,0
100698,102108,1,Presencial,1.975,0,Mujer,Portal Web,3,135335,90.0,67,Casado,18,2018,2,high,102040,Presencial,2.92,1,Mujer,Portal Web,5,1616000,46.0,75,Casado,50,2023,5,low,0.9449999999999998,1,2,1480665,1924,0,32,0
100553,102105,1,Presencial,2.255,2,Mujer,Linkedin,1,121503,90.0,69,Soltero,17,2018,2,high,102113,Híbrida,2.07,0,Hombre,Linkedin,8,1616000,85.0,71,Viudo,45,2017,3,high,-0.18500000000000005,-2,7,1494497,-323,1,28,1
101900,102070,1,Presencial,7.3,2,Mujer,Portal Web,1,121978,90.0,81,Soltero,16,2017,4,high,102035,Presencial,1.7,1,Mujer,Referidos,4,1616000,77.0,73,Viudo,38,2013,3,low,-5.6,-1,3,1494022,-1488,1,22,0
101506,102089,1,Presencial,1.095,3,Mujer,Portal Web,1,137138,90.0,75,Soltero,18,2018,6,high,102077,Presencial,2.75,1,Hombre,Ferias & Networking,6,1616000,96.0,69,Divorciado,60,2021,10,high,1.655,-2,5,1478862,1215,0,42,0
101162,102081,1,Presencial,2.755,2,Hombre,Referidos,3,138213,90.0,85,Soltero,18,2018,4,high,102135,Presencial,2.5,2,Hombre,Portal Web,4,488000,26.0,64,Soltero,18,2015,8,low,-0.2549999999999999,0,1,349787,-977,1,0,0
100630,102077,1,Presencial,1.985,1,Hombre,Portal Web,3,158965,90.0,76,Soltero,18,2017,7,high,102146,Presencial,2.27,0,Hombre,Ferias & Networking,11,1306940,31.0,64,Soltero,39,2021,6,low,0.2849999999999999,-1,8,1147975,1431,0,21,0
101470,102034,1,Presencial,2.855,8,Hombre,Portal Web,1,143033,90.0,71,Casado,13,2012,8,high,102113,Presencial,7.84,7,Hombre,Linkedin,5,1564490,90.0,70,Casado,35,2012,9,high,4.984999999999999,-1,4,1421457,47,0,22,0
101292,102107,1,Presencial,1.895,4,Hombre,Portal Web,2,141123,90.0,80,Soltero,22,2020,12,high,102069,Presencial,2.4,1,Mujer,Linkedin,8,1616000,47.0,79,Casado,63,2023,6,low,0.5049999999999999,-3,6,1474877,927,0,41,1
100911,102000,1,Presencial,4.975,2,Hombre,Portal Web,1,142847,90.0,76,Soltero,13,2012,2,high,102075,Presencial,1.9,0,Hombre,Ferias & Networking,7,1616000,90.0,70,Soltero,53,2023,2,high,-3.0749999999999997,-2,6,1473153,4023,0,40,0
100401,102155,1,Presencial,6.365,10,Mujer,Portal Web,1,162933,90.0,74,Soltero,25,2023,1,high,102159,Presencial,1.78,1,Mujer,Ferias & Networking,1,590000,39.0,80,Soltero,20,2016,10,low,-4.585,-9,0,427067,-2275,1,-5,1
100477,102140,1,Presencial,2.49,1,Mujer,Referidos,3,167914,90.0,88,Soltero,23,2021,4,high,102040,Presencial,2.55,0,Mujer,Portal Web,16,1616000,46.0,69,Casado,39,2012,2,low,0.05999999999999961,-1,13,1448086,-3357,1,16,0
101243,102087,1,Presencial,3.74,2,Hombre,Referidos,4,163897,90.0,82,Soltero,18,2016,5,high,102111,Presencial,7.16,9,Mujer,Linkedin,10,1616000,98.0,79,Casado,42,2012,5,high,3.42,7,6,1452103,-1486,1,24,0
101298,102035,1,Presencial,1.84,7,Hombre,Portal Web,4,167057,90.0,69,Soltero,15,2012,8,high,102041,Presencial,2.86,1,Hombre,Portal Web,23,1900000,83.0,72,Casado,57,2013,8,high,1.0199999999999998,-6,19,1732943,368,0,42,0
100644,102131,1,Presencial,1.005,1,Hombre,Linkedin,1,184112,90.0,79,Soltero,23,2020,2,high,102109,Presencial,5.54,0,Hombre,Linkedin,3,998000,39.0,77,Soltero,34,2021,12,low,4.535,-1,2,813888,688,0,11,1
101584,102133,1,Presencial,1.23,2,Hombre,Portal Web,1,185154,90.0,75,Soltero,25,2021,3,high,102151,Híbrida,2.61,2,Hombre,Linkedin,4,1255430,98.0,65,Soltero,35,2018,2,high,1.38,0,3,1070276,-1115,1,10,0
100923,102059,1,Presencial,2.04,2,Hombre,Portal Web,1,186785,90.0,75,Casado,20,2016,4,high,102021,Presencial,2.55,2,Hombre,Portal Web,16,1616000,27.0,76,Viudo,50,2019,6,low,0.5099999999999998,0,15,1429215,1151,0,30,0
100932,102130,1,Presencial,1.335,3,Hombre,Linkedin,5,206168,90.0,70,Soltero,27,2021,12,high,102068,Presencial,1.97,6,Hombre,Linkedin,5,1616000,84.0,73,Soltero,31,2014,4,high,0.635,3,0,1409832,-2783,1,4,0
100741,102075,1,Presencial,2.105,2,Hombre,Linkedin,4,210407,90.0,83,Soltero,23,2017,6,high,102047,Presencial,2.7,1,Hombre,Referidos,11,1255430,90.0,76,Casado,30,2013,3,high,0.5950000000000002,-1,7,1045023,-1538,1,7,0
100967,102137,1,Presencial,2.52,0,Hombre,Ferias & Networking,1,245773,90.0,75,Casado,29,2022,5,high,102046,Presencial,1.18,0,Mujer,Portal Web,2,845000,37.0,79,Casado,27,2017,12,low,-1.34,0,1,599227,-1599,1,-2,0
102019,102129,2,Presencial,2.59,7,Mujer,Portal Web,4,488000,90.0,74,Soltero,24,2021,6,high,102142,Presencial,2.1,2,Mujer,Linkedin,3,590000,41.0,74,Soltero,24,2020,1,low,-0.48999999999999977,-5,-1,102000,-524,1,0,1
101800,102129,1,Presencial,1.54,3,Hombre,Ferias & Networking,8,245418,90.0,70,Casado,29,2021,12,high,102142,Presencial,2.1,2,Mujer,Linkedin,3,590000,41.0,74,Soltero,24,2020,1,low,0.56,-1,-5,344582,-723,1,-5,1
101688,102153,1,Presencial,3.4,2,Hombre,Linkedin,2,270966,90.0,75,Soltero,31,2022,8,high,102143,Presencial,6.39,1,Mujer,Linkedin,5,1616000,90.0,68,Casado,41,2019,6,high,2.9899999999999998,-1,3,1345034,-1166,1,10,0
100935,102069,1,Presencial,8.07,2,Mujer,Ferias & Networking,7,270496,90.0,63,Soltero,23,2015,1,high,102069,Presencial,4.64,1,Mujer,Ferias & Networking,19,1616000,47.0,74,Casado,60,2021,10,low,-3.4300000000000006,-1,12,1345504,2461,0,37,0
102018,102160,2,Presencial,5.57,5,Hombre,Portal Web,3,692000,90.0,69,Divorciado,28,2022,2,high,102087,Presencial,2.21,0,Hombre,Portal Web,3,794000,83.0,78,Casado,28,2019,8,high,-3.3600000000000003,-5,0,102000,-921,1,0,0
100121,102160,1,Presencial,3.37,1,Hombre,Referidos,9,329689,90.0,79,Casado,33,2022,4,high,102087,Presencial,2.21,0,Hombre,Portal Web,3,794000,83.0,78,Casado,28,2019,8,high,-1.1600000000000001,-1,-6,464311,-973,1,-5,0
100586,102105,1,Presencial,3.155,1,Hombre,Portal Web,8,328727,90.0,79,Soltero,29,2018,4,high,102113,Híbrida,2.07,0,Hombre,Linkedin,8,1616000,85.0,71,Viudo,45,2017,3,high,-1.085,-1,0,1287273,-378,1,16,0
101368,102105,1,Presencial,1.245,2,Mujer,Referidos,5,346759,90.0,72,Casado,30,2018,4,high,102113,Híbrida,2.07,0,Hombre,Linkedin,8,1616000,85.0,71,Viudo,45,2017,3,high,0.8249999999999997,-2,3,1269241,-394,1,15,0
101058,102113,1,Presencial,1.24,3,Mujer,Portal Web,5,770169,90.0,72,Casado,35,2021,3,high,102041,Presencial,2.96,2,Hombre,Portal Web,6,1152410,46.0,75,Casado,27,2012,1,low,1.72,-1,1,382241,-3360,1,-8,1
100894,102111,1,Presencial,6.84,1,Mujer,Ferias & Networking,6,373104,90.0,80,Casado,33,2019,10,high,102097,Híbrida,2.04,1,Mujer,Referidos,15,1616000,94.0,67,Soltero,50,2021,5,high,-4.8,0,9,1242896,576,0,17,0
101541,102120,1,Presencial,2.265,5,Hombre,Portal Web,6,390991,90.0,79,Casado,32,2018,10,high,102171,Presencial,6.48,2,Hombre,Ferias & Networking,9,1616000,80.0,71,Casado,47,2023,8,high,4.215,-3,3,1225009,1760,0,15,0
101522,102052,1,Presencial,4.895,3,Mujer,Ferias & Networking,3,386292,90.0,66,Soltero,30,2016,4,high,102093,Presencial,4.45,0,Hombre,Linkedin,5,641000,84.0,76,Divorciado,17,2012,4,high,-0.4449999999999994,-3,2,254708,-1473,1,-13,0
100787,102147,1,Presencial,5.465,2,Mujer,Ferias & Networking,7,409703,90.0,77,Soltero,38,2022,12,high,102057,Presencial,1.58,2,Hombre,Portal Web,4,1616000,90.0,80,Casado,49,2022,12,high,-3.885,0,-3,1206297,2,0,11,1
101822,102110,1,Presencial,2.83,1,Hombre,Referidos,11,409315,90.0,71,Casado,33,2018,5,high,102045,Presencial,1.6,5,Mujer,Linkedin,2,998000,87.0,76,Soltero,29,2016,11,high,-1.23,4,-9,588685,-549,1,-4,0
100227,102092,1,Presencial,1.97,1,Hombre,Portal Web,7,411375,90.0,66,Divorciado,32,2017,7,high,102120,Presencial,1.23,6,Mujer,Linkedin,13,1616000,98.0,95,Viudo,41,2013,6,high,-0.74,5,6,1204625,-1491,1,9,1
100393,102069,1,Presencial,2.0,4,Mujer,Portal Web,11,409444,90.0,83,Casado,30,2014,12,high,102069,Presencial,4.64,1,Mujer,Ferias & Networking,19,1616000,47.0,74,Casado,60,2021,10,low,2.6399999999999997,-3,8,1206556,2494,0,30,0
102124,102099,2,Presencial,2.84,2,Mujer,Linkedin,4,947000,90.0,70,Soltero,24,2012,10,high,102080,Presencial,1.71,0,Hombre,Portal Web,11,1616000,76.0,80,Viudo,51,2021,10,low,-1.13,-2,7,669000,3263,0,27,1
101456,102099,1,Presencial,1.75,2,Mujer,Referidos,5,428884,90.0,70,Soltero,35,2018,4,high,102080,Presencial,1.71,0,Hombre,Portal Web,11,1616000,76.0,80,Viudo,51,2021,10,low,-0.040000000000000036,-2,6,1187116,1260,0,16,0
100852,102102,1,Presencial,2.355,2,Mujer,Portal Web,6,428108,90.0,77,Soltero,34,2017,10,high,102018,Presencial,2.48,0,Hombre,Portal Web,5,1616000,92.0,63,Viudo,49,2019,4,high,0.125,-2,-1,1187892,534,0,15,0
101894,102087,1,Presencial,2.12,1,Hombre,Referidos,6,451526,90.0,67,Casado,33,2016,5,high,102111,Presencial,7.16,9,Mujer,Linkedin,10,1616000,98.0,79,Casado,42,2012,5,high,5.04,8,4,1164474,-1466,1,9,0
101070,102122,1,Presencial,1.635,11,Mujer,Portal Web,4,469596,90.0,80,Casado,39,2021,8,high,102075,Presencial,1.83,4,Hombre,Portal Web,6,1616000,90.0,66,Viudo,48,2019,3,high,0.19500000000000006,-7,2,1146404,-865,1,9,0
101324,102117,1,Presencial,2.375,6,Mujer,Linkedin,3,469407,90.0,68,Casado,39,2021,2,high,102154,Presencial,4.05,1,Mujer,Linkedin,10,1616000,90.0,80,Divorciado,48,2021,1,high,1.6749999999999998,-5,7,1146593,-29,1,9,0
100387,102124,1,Presencial,5.245,3,Mujer,Portal Web,3,467586,90.0,77,Casado,39,2021,2,high,102099,Presencial,2.84,2,Mujer,Linkedin,4,947000,90.0,70,Soltero,24,2012,10,high,-2.4050000000000002,-1,1,479414,-3024,1,-15,0
100762,102132,1,Presencial,5.5,1,Hombre,Portal Web,6,764422,90.0,68,Divorciado,39,2020,10,high,102138,Presencial,4.51,1,Hombre,Linkedin,16,1616000,25.0,80,Viudo,45,2014,3,low,-0.9900000000000002,0,10,851578,-2412,1,6,0
101165,102012,1,Presencial,5.19,5,Hombre,Referidos,5,471539,90.0,85,Casado,30,2012,3,high,102122,Presencial,2.09,1,Mujer,Portal Web,7,1100000,90.0,80,Casado,34,2019,7,high,-3.1000000000000005,-4,2,628461,2658,0,4,0
101485,102094,1,Presencial,1.87,3,Mujer,Portal Web,6,869226,90.0,71,Casado,38,2019,5,high,102095,Presencial,1.32,1,Hombre,Portal Web,4,998000,90.0,85,Casado,28,2016,2,high,-0.55,-2,-2,128774,-1192,1,-10,1
101380,102102,1,Presencial,3.085,2,Mujer,Portal Web,12,505069,90.0,71,Casado,38,2018,10,high,102018,Presencial,2.48,0,Hombre,Portal Web,5,1616000,92.0,63,Viudo,49,2019,4,high,-0.605,-2,-7,1110931,185,0,11,0
100672,102091,1,Presencial,1.495,1,Mujer,Referidos,13,244097,90.0,72,Soltero,38,2018,10,high,102149,Presencial,1.54,1,Mujer,Portal Web,4,1616000,73.0,77,Casado,39,2014,12,low,0.04499999999999993,0,-9,1371903,-1378,1,1,0
100551,102080,1,Presencial,1.21,1,Mujer,Portal Web,6,490193,90.0,68,Soltero,36,2017,2,high,102035,Presencial,1.93,0,Mujer,Linkedin,18,1616000,94.0,75,Viudo,47,2016,8,high,0.72,-1,12,1125807,-195,1,11,1
102008,102107,2,Presencial,3.99,1,Mujer,Linkedin,7,405435,90.0,82,Soltero,39,2023,1,high,102069,Presencial,2.4,1,Mujer,Linkedin,8,1616000,47.0,79,Casado,63,2023,6,low,-1.5900000000000003,0,1,1210565,157,0,24,1
100002,102107,1,Presencial,1.765,9,Hombre,Portal Web,9,255791,90.0,70,Casado,40,2019,3,high,102069,Presencial,2.4,1,Mujer,Linkedin,8,1616000,47.0,79,Casado,63,2023,6,low,0.635,-8,-1,1360209,1551,0,23,1
100868,102033,1,Presencial,1.58,3,Hombre,Portal Web,10,260007,90.0,75,Casado,36,2014,9,high,102172,Presencial,6.25,2,Mujer,Portal Web,16,1616000,90.0,79,Divorciado,39,2014,5,high,4.67,-1,6,1355993,-129,1,3,0
102134,102135,2,Presencial,2.25,2,Hombre,Portal Web,5,1358450,90.0,69,Viudo,31,2012,7,high,102028,Presencial,2.04,1,Hombre,Portal Web,2,1616000,82.0,75,Divorciado,49,2017,10,high,-0.20999999999999996,-1,-3,257550,1913,0,18,0
100178,102135,1,Presencial,0.12,2,Mujer,Portal Web,10,443717,90.0,71,Casado,46,2022,6,high,102028,Presencial,2.04,1,Hombre,Portal Web,2,1616000,82.0,75,Divorciado,49,2017,10,high,1.92,-1,-8,1172283,-1708,1,3,0
101103,102075,1,Presencial,3.495,8,Mujer,Linkedin,11,282393,90.0,77,Divorciado,40,2016,4,high,102047,Presencial,2.7,1,Hombre,Referidos,11,1255430,90.0,76,Casado,30,2013,3,high,-0.7949999999999999,-7,0,973037,-1106,1,-10,1
100112,102152,1,Presencial,1.205,2,Hombre,Linkedin,4,406838,90.0,70,Casado,45,2021,10,high,102089,Presencial,2.75,5,Hombre,Portal Web,7,1616000,15.0,68,Soltero,47,2019,8,low,1.545,3,3,1209162,-767,1,2,0
100761,102115,1,Presencial,2.37,2,Mujer,Ferias & Networking,14,291440,90.0,80,Divorciado,46,2021,7,high,102116,Presencial,2.0,2,Mujer,Portal Web,4,1616000,94.0,76,Soltero,35,2018,12,high,-0.3700000000000001,0,-10,1324560,-927,1,-11,0
100781,102049,1,Presencial,4.66,0,Hombre,Referidos,5,289873,90.0,76,Viudo,39,2014,12,high,102029,Presencial,6.89,0,Mujer,Portal Web,9,1616000,19.0,77,Divorciado,49,2023,3,low,2.2299999999999995,0,4,1326127,3010,0,10,0
100407,102041,1,Presencial,1.975,5,Hombre,Linkedin,11,285527,90.0,76,Soltero,38,2014,8,high,102147,Presencial,1.29,0,Mujer,Portal Web,8,1616000,44.0,73,Casado,51,2014,5,low,-0.685,-5,-3,1330473,-97,1,13,1
100169,102047,1,Presencial,2.08,1,Mujer,Referidos,4,297118,90.0,72,Divorciado,39,2014,8,high,102089,Presencial,2.67,1,Hombre,Linkedin,4,743000,14.0,70,Casado,22,2015,11,low,0.5899999999999999,0,0,445882,465,0,-17,1
101083,102018,1,Presencial,1.885,3,Hombre,Portal Web,9,288932,90.0,74,Soltero,36,2012,7,high,102160,Presencial,5.57,5,Hombre,Portal Web,3,692000,90.0,69,Divorciado,28,2022,2,high,3.6850000000000005,2,-6,403068,3525,0,-8,0
100001,102006,1,Presencial,2.07,1,Hombre,Portal Web,5,292094,90.0,66,Divorciado,36,2012,2,high,102084,Presencial,2.58,0,Hombre,Linkedin,16,1900000,87.0,77,Viudo,57,2019,4,high,0.5100000000000002,-1,11,1607906,2616,0,21,0
101182,102131,1,Presencial,3.065,1,Mujer,Ferias & Networking,9,406305,90.0,75,Soltero,45,2019,11,high,102109,Presencial,5.54,0,Hombre,Linkedin,3,998000,39.0,77,Soltero,34,2021,12,low,2.475,-1,-6,591695,764,0,-11,1
100753,102081,1,Presencial,2.85,2,Mujer,Portal Web,7,299027,90.0,85,Viudo,42,2017,6,high,102135,Presencial,2.5,2,Hombre,Portal Web,4,488000,26.0,64,Soltero,18,2015,8,low,-0.3500000000000001,0,-3,188973,-671,1,-24,0
101199,102025,1,Presencial,2.535,0,Mujer,Portal Web,5,298155,90.0,81,Divorciado,39,2013,8,high,102132,Presencial,1.6,0,Hombre,Portal Web,9,1616000,90.0,81,Viudo,56,2018,4,high,-0.935,0,4,1317845,1688,0,17,0
102009,102116,2,Presencial,2.06,2,Hombre,Referidos,9,1461470,90.0,73,Casado,44,2022,8,high,102021,Presencial,2.32,0,Mujer,Portal Web,22,1616000,94.0,76,Casado,59,2020,7,high,0.2599999999999998,-2,13,154530,-749,1,15,0
102096,102116,2,Presencial,5.11,8,Mujer,Linkedin,13,1461470,90.0,74,Soltero,42,2021,5,high,102021,Presencial,2.32,0,Mujer,Portal Web,22,1616000,94.0,76,Casado,59,2020,7,high,-2.7900000000000005,-8,9,154530,-298,1,17,1
101564,102116,1,Presencial,1.16,0,Hombre,Linkedin,5,303640,90.0,88,Viudo,48,2021,11,high,102021,Presencial,2.32,0,Mujer,Portal Web,22,1616000,94.0,76,Casado,59,2020,7,high,1.16,0,17,1312360,-479,1,11,0
100731,102134,1,Presencial,1.835,2,Hombre,Portal Web,14,378242,90.0,81,Soltero,47,2020,9,high,102135,Presencial,2.25,2,Hombre,Portal Web,5,1358450,90.0,69,Viudo,31,2012,7,high,0.41500000000000004,0,-9,980208,-2997,1,-16,0
100629,102053,1,Presencial,2.5,1,Hombre,Headhunter,13,312419,90.0,69,Soltero,40,2014,4,high,102030,Presencial,1.29,0,Hombre,Portal Web,11,1616000,81.0,64,Soltero,36,2012,12,high,-1.21,-1,-2,1303581,-474,1,-4,0
102050,102069,2,Presencial,3.7,0,Mujer,Linkedin,11,1512980,90.0,88,Soltero,40,2017,10,high,102069,Presencial,4.64,1,Mujer,Ferias & Networking,19,1616000,47.0,74,Casado,60,2021,10,low,0.9399999999999995,1,8,103020,1474,0,20,0
100584,102069,1,Presencial,1.74,2,Hombre,Ferias & Networking,6,639377,90.0,80,Viudo,43,2015,11,high,102069,Presencial,4.64,1,Mujer,Ferias & Networking,19,1616000,47.0,74,Casado,60,2021,10,low,2.8999999999999995,-1,13,976623,2180,0,17,0
102034,102113,2,Presencial,7.84,7,Hombre,Linkedin,5,1564490,90.0,70,Casado,35,2012,9,high,102041,Presencial,2.96,2,Hombre,Portal Web,6,1152410,46.0,75,Casado,27,2012,1,low,-4.88,-5,1,-412080,-247,1,-8,1
101532,102113,1,Presencial,4.515,3,Hombre,Ferias & Networking,12,879581,90.0,80,Soltero,49,2021,4,high,102041,Presencial,2.96,2,Hombre,Portal Web,6,1152410,46.0,75,Casado,27,2012,1,low,-1.5549999999999997,-1,-6,272829,-3390,1,-22,0
100291,102077,1,Presencial,5.12,1,Mujer,Ferias & Networking,17,655443,90.0,84,Soltero,46,2018,5,high,102146,Presencial,2.27,0,Hombre,Ferias & Networking,11,1306940,31.0,64,Soltero,39,2021,6,low,-2.85,-1,-6,651497,1145,0,-7,0
101573,102064,1,Presencial,3.19,3,Mujer,Portal Web,17,676147,90.0,73,Soltero,45,2016,4,high,102067,Presencial,1.34,0,Hombre,Portal Web,6,1616000,92.0,92,Casado,43,2018,2,high,-1.8499999999999999,-3,-11,939853,666,0,-2,1
100690,102147,1,Presencial,0.95,7,Mujer,Portal Web,17,677426,90.0,77,Divorciado,52,2022,9,high,102057,Presencial,1.58,2,Hombre,Portal Web,4,1616000,90.0,80,Casado,49,2022,12,high,0.6300000000000001,-5,-13,938574,92,0,-3,1
101123,102129,1,Presencial,1.73,2,Mujer,Referidos,16,675656,90.0,75,Soltero,51,2022,1,high,102142,Presencial,2.1,2,Mujer,Linkedin,3,590000,41.0,74,Soltero,24,2020,1,low,0.3700000000000001,0,-13,-85656,-735,1,-27,0
100959,102127,1,Presencial,2.185,4,Mujer,Portal Web,11,677936,90.0,72,Soltero,50,2021,7,high,102028,Presencial,4.03,2,Mujer,Linkedin,9,1306940,88.0,78,Divorciado,32,2014,5,high,1.8450000000000002,-2,-2,629004,-2602,1,-18,1
100576,102130,1,Presencial,1.585,1,Hombre,Linkedin,13,881136,90.0,68,Soltero,50,2020,8,high,102068,Presencial,1.97,6,Hombre,Linkedin,5,1616000,84.0,73,Soltero,31,2014,4,high,0.385,5,-8,734864,-2293,1,-19,0
101278,102043,1,Presencial,1.54,5,Hombre,Portal Web,4,674828,90.0,67,Casado,43,2014,7,high,102051,Presencial,1.03,0,Hombre,Portal Web,5,1616000,60.0,76,Casado,44,2019,5,low,-0.51,-5,1,941172,1780,0,1,0
100296,102056,1,Presencial,1.305,7,Mujer,Portal Web,21,854704,90.0,78,Soltero,43,2013,11,high,102014,Presencial,5.24,1,Hombre,Ferias & Networking,16,1616000,70.0,63,Viudo,65,2023,3,low,3.9350000000000005,-6,-5,761296,3414,0,22,1
100189,102147,1,Presencial,1.555,6,Hombre,Portal Web,10,796140,90.0,80,Casado,53,2023,2,high,102057,Presencial,1.58,2,Hombre,Portal Web,4,1616000,90.0,80,Casado,49,2022,12,high,0.025000000000000133,-4,-6,819860,-50,1,-4,0
102030,102058,2,Presencial,6.34,0,Mujer,Referidos,14,1616000,90.0,76,Viudo,41,2015,4,high,102172,Presencial,1.4,2,Hombre,Ferias & Networking,11,1616000,75.0,71,Casado,59,2021,2,low,-4.9399999999999995,2,-3,0,2144,0,18,0
102067,102058,2,Presencial,0.92,1,Mujer,Portal Web,5,1616000,90.0,70,Divorciado,46,2020,8,high,102172,Presencial,1.4,2,Hombre,Ferias & Networking,11,1616000,75.0,71,Casado,59,2021,2,low,0.47999999999999987,1,6,0,175,0,13,0
101359,102058,1,Presencial,6.85,1,Hombre,Portal Web,17,840151,90.0,67,Divorciado,47,2015,6,high,102172,Presencial,1.4,2,Hombre,Ferias & Networking,11,1616000,75.0,71,Casado,59,2021,2,low,-5.449999999999999,1,-6,775849,2075,0,12,0
101527,102044,1,Presencial,1.645,10,Mujer,Portal Web,8,736114,90.0,78,Viudo,45,2013,9,high,102155,Presencial,1.54,1,Hombre,Ferias & Networking,14,1616000,56.0,68,Soltero,47,2023,3,low,-0.10499999999999998,-9,6,879886,3468,0,2,1
101991,102164,1,Presencial,1.125,1,Hombre,Linkedin,5,741910,90.0,65,Soltero,56,2023,4,high,102109,Presencial,3.78,2,Hombre,Linkedin,7,1461470,83.0,77,Casado,40,2018,9,high,2.655,1,2,719560,-1647,1,-16,0
101687,102107,1,Presencial,4.74,0,Mujer,Portal Web,3,733602,90.0,85,Divorciado,51,2018,11,high,102069,Presencial,2.4,1,Mujer,Linkedin,8,1616000,47.0,79,Casado,63,2023,6,low,-2.3400000000000003,1,5,882398,1684,0,12,0
100098,102097,1,Presencial,1.69,0,Mujer,Linkedin,5,742158,90.0,82,Divorciado,50,2017,9,high,102024,Presencial,1.95,6,Hombre,Portal Web,4,1100900,57.0,77,Soltero,31,2016,10,low,0.26,6,-1,358742,-312,1,-19,0
101286,102133,1,Presencial,1.67,9,Mujer,Portal Web,9,820441,90.0,76,Divorciado,56,2022,12,high,102151,Híbrida,2.61,2,Hombre,Linkedin,4,1255430,98.0,65,Soltero,35,2018,2,high,0.94,-7,-5,434989,-1752,1,-21,0
102122,102075,2,Presencial,1.83,4,Hombre,Portal Web,6,1616000,90.0,66,Viudo,48,2019,3,high,102047,Presencial,2.7,1,Hombre,Referidos,11,1255430,90.0,76,Casado,30,2013,3,high,0.8700000000000001,-3,5,-360570,-2184,1,-18,1
102000,102075,2,Presencial,1.9,0,Hombre,Ferias & Networking,7,1616000,90.0,70,Soltero,53,2023,2,high,102047,Presencial,2.7,1,Hombre,Referidos,11,1255430,90.0,76,Casado,30,2013,3,high,0.8000000000000003,1,4,-360570,-3621,1,-23,0
102005,102075,2,Presencial,3.25,2,Hombre,Portal Web,15,1616000,90.0,65,Soltero,47,2017,2,high,102047,Presencial,2.7,1,Hombre,Referidos,11,1255430,90.0,76,Casado,30,2013,3,high,-0.5499999999999998,-1,-4,-360570,-1408,1,-17,1
101935,102075,1,Presencial,2.89,1,Hombre,Referidos,9,877784,90.0,76,Casado,51,2015,7,high,102047,Presencial,2.7,1,Hombre,Referidos,11,1255430,90.0,76,Casado,30,2013,3,high,-0.18999999999999995,0,2,377646,-838,1,-21,0
102103,102023,2,Presencial,1.69,6,Hombre,Portal Web,3,1616000,90.0,74,Casado,45,2013,5,high,102105,Híbrida,4.9,1,Hombre,Portal Web,4,539000,80.0,65,Casado,23,2019,12,high,3.2100000000000004,-5,1,-1077000,2415,0,-22,0
101919,102023,1,Presencial,1.495,3,Hombre,Linkedin,7,916397,90.0,84,Casado,49,2012,7,high,102105,Híbrida,4.9,1,Hombre,Portal Web,4,539000,80.0,65,Casado,23,2019,12,high,3.4050000000000002,-2,-3,-377397,2721,0,-26,0
102165,102132,2,Presencial,1.99,2,Hombre,Portal Web,10,1616000,90.0,82,Viudo,60,2023,1,high,102138,Presencial,4.51,1,Hombre,Linkedin,16,1616000,25.0,80,Viudo,45,2014,3,low,2.5199999999999996,-1,6,0,-3231,1,-15,1
102025,102132,2,Presencial,1.6,0,Hombre,Portal Web,9,1616000,90.0,81,Viudo,56,2018,4,high,102138,Presencial,4.51,1,Hombre,Linkedin,16,1616000,25.0,80,Viudo,45,2014,3,low,2.9099999999999997,1,7,0,-1475,1,-11,0
103475,102132,1,Presencial,2.13,1,Hombre,Referidos,1,78999,90.0,74,Soltero,19,2022,11,high,102138,Presencial,4.51,1,Hombre,Linkedin,16,1616000,25.0,80,Viudo,45,2014,3,low,2.38,0,15,1537001,-3154,1,26,0
102551,102031,1,Presencial,1.995,1,Hombre,Linkedin,1,81129,90.0,69,Soltero,11,2014,7,high,102111,Presencial,2.95,2,Hombre,Portal Web,8,1610000,76.0,87,Casado,31,2017,7,low,0.9550000000000001,1,7,1528871,1072,0,20,0
103018,102146,1,Presencial,2.225,2,Mujer,Linkedin,1,100863,90.0,81,Soltero,19,2021,3,high,102035,Presencial,2.66,0,Mujer,Portal Web,15,1616000,77.0,78,Casado,39,2013,10,low,0.43500000000000005,-2,14,1515137,-2704,1,20,0
102745,102116,1,Presencial,5.985,2,Mujer,Ferias & Networking,1,119422,90.0,67,Soltero,19,2020,5,high,102021,Presencial,2.32,0,Mujer,Portal Web,22,1616000,94.0,76,Casado,59,2020,7,high,-3.6650000000000005,-2,21,1496578,66,0,40,0
102354,102080,1,Presencial,3.24,2,Mujer,Portal Web,1,98362,90.0,72,Soltero,16,2018,6,high,102035,Presencial,1.93,0,Mujer,Linkedin,18,1616000,94.0,75,Viudo,47,2016,8,high,-1.3100000000000003,-2,17,1517638,-680,1,31,0
102518,102080,1,Presencial,5.2,3,Mujer,Referidos,3,139074,90.0,79,Soltero,18,2018,9,high,102035,Presencial,1.93,0,Mujer,Linkedin,18,1616000,94.0,75,Viudo,47,2016,8,high,-3.2700000000000005,-3,15,1476926,-756,1,29,0
104153,102089,1,Presencial,1.1,2,Mujer,Portal Web,1,143283,90.0,75,Soltero,18,2018,6,high,102077,Presencial,2.75,1,Hombre,Ferias & Networking,6,1616000,96.0,69,Divorciado,60,2021,10,high,1.65,-1,5,1472717,1214,0,42,1
103466,102081,1,Presencial,2.745,3,Hombre,Referidos,3,141146,90.0,85,Soltero,18,2018,4,high,102135,Presencial,2.5,2,Hombre,Portal Web,4,488000,26.0,64,Soltero,18,2015,8,low,-0.2450000000000001,-1,1,346854,-976,1,0,1
102262,102108,1,Presencial,1.97,1,Mujer,Linkedin,3,143219,90.0,67,Casado,18,2018,2,high,102040,Presencial,2.92,1,Mujer,Portal Web,5,1616000,46.0,75,Casado,50,2023,5,low,0.95,0,2,1472781,1921,0,32,0
104134,102077,1,Presencial,2.01,1,Hombre,Portal Web,3,157354,90.0,76,Soltero,18,2017,7,high,102146,Presencial,2.27,0,Hombre,Ferias & Networking,11,1306940,31.0,64,Soltero,39,2021,6,low,0.26000000000000023,-1,8,1149586,1430,0,21,0
102191,102052,1,Presencial,1.455,1,Hombre,Referidos,3,135470,90.0,83,Soltero,13,2013,10,high,102093,Presencial,4.45,0,Hombre,Linkedin,5,641000,84.0,76,Divorciado,17,2012,4,high,2.995,-1,2,505530,-571,1,4,0
102868,102135,1,Presencial,5.185,2,Hombre,Ferias & Networking,3,144197,90.0,75,Soltero,22,2021,6,high,102028,Presencial,2.04,1,Hombre,Portal Web,2,1616000,82.0,75,Divorciado,49,2017,10,high,-3.1449999999999996,-1,-1,1471803,-1340,1,27,0
103464,102078,1,Presencial,1.75,1,Mujer,Portal Web,4,166981,90.0,79,Soltero,17,2015,6,high,102143,Presencial,2.17,1,Hombre,Ferias & Networking,9,998000,83.0,76,Casado,29,2017,5,high,0.41999999999999993,0,5,831019,718,0,12,0
103882,102076,1,Presencial,1.52,1,Mujer,Linkedin,2,163063,90.0,76,Soltero,20,2017,7,high,102168,Híbrida,1.95,1,Hombre,Referidos,9,1616000,95.0,82,Soltero,53,2023,9,high,0.42999999999999994,0,7,1452937,2244,0,33,1
102429,102142,1,Presencial,5.055,2,Hombre,Linkedin,3,182375,90.0,68,Casado,24,2021,9,high,102047,Presencial,2.48,2,Hombre,Portal Web,3,1255430,90.0,66,Soltero,36,2019,7,high,-2.5749999999999997,0,0,1073055,-792,1,12,0
102697,102131,1,Presencial,0.99,1,Hombre,Linkedin,1,184838,90.0,79,Soltero,23,2020,2,high,102109,Presencial,5.54,0,Hombre,Linkedin,3,998000,39.0,77,Soltero,34,2021,12,low,4.55,-1,2,813162,690,0,11,1
102355,102093,1,Presencial,1.485,1,Mujer,Headhunter,3,184807,90.0,72,Soltero,23,2020,1,high,102139,Presencial,5.41,0,Mujer,Ferias & Networking,4,488000,89.0,62,Soltero,23,2021,6,high,3.925,-1,1,303193,514,0,0,0
103963,102047,1,Presencial,3.195,6,Mujer,Linkedin,2,182855,90.0,84,Casado,16,2012,10,high,102089,Presencial,2.67,1,Hombre,Linkedin,4,743000,14.0,70,Casado,22,2015,11,low,-0.5249999999999999,-5,2,560145,1118,0,6,0
103002,102130,1,Presencial,2.295,0,Mujer,Referidos,4,193744,90.0,72,Casado,27,2022,11,high,102068,Presencial,1.97,6,Hombre,Linkedin,5,1616000,84.0,73,Soltero,31,2014,4,high,-0.32499999999999996,6,1,1422256,-3115,1,4,0
103685,102085,1,Presencial,2.34,2,Mujer,Portal Web,5,187534,90.0,74,Casado,22,2018,4,high,102145,Presencial,6.59,4,Hombre,Portal Web,12,1616000,47.0,71,Casado,39,2015,8,low,4.25,2,7,1428466,-979,1,17,0
102357,102059,1,Presencial,2.055,3,Hombre,Portal Web,1,190306,90.0,75,Casado,20,2016,4,high,102021,Presencial,2.55,2,Hombre,Portal Web,16,1616000,27.0,76,Viudo,50,2019,6,low,0.49499999999999966,-1,15,1425694,1151,0,30,1
102249,102075,1,Presencial,2.1,1,Hombre,Linkedin,4,212755,90.0,83,Soltero,23,2017,6,high,102047,Presencial,2.7,1,Hombre,Referidos,11,1255430,90.0,76,Casado,30,2013,3,high,0.6000000000000001,0,7,1042675,-1541,1,7,0
103877,102057,1,Presencial,3.685,2,Mujer,Portal Web,6,206030,90.0,78,Soltero,22,2016,10,high,102019,Presencial,1.97,4,Hombre,Portal Web,5,1616000,90.0,73,Viudo,59,2022,12,high,-1.715,2,-1,1409970,2253,0,37,1
103050,102065,1,Presencial,2.485,1,Mujer,Referidos,3,206219,90.0,80,Soltero,21,2016,2,high,102026,Presencial,2.44,2,Hombre,Ferias & Networking,13,1616000,45.0,60,Divorciado,35,2014,10,low,-0.04499999999999993,1,10,1409781,-488,1,14,0
103423,102052,1,Presencial,1.9,8,Mujer,Portal Web,5,210229,90.0,76,Casado,20,2014,11,high,102093,Presencial,4.45,0,Hombre,Linkedin,5,641000,84.0,76,Divorciado,17,2012,4,high,2.5500000000000003,-8,0,430771,-964,1,-3,0
104158,102086,1,Presencial,1.475,6,Hombre,Portal Web,5,245290,90.0,78,Soltero,23,2016,5,high,102085,Presencial,2.22,2,Mujer,Linkedin,7,1306940,87.0,68,Divorciado,39,2021,3,high,0.7450000000000001,-4,2,1061650,1764,0,16,0
103947,102142,1,Presencial,5.675,2,Mujer,Portal Web,6,269877,90.0,75,Divorciado,31,2022,12,high,102047,Presencial,2.48,2,Hombre,Portal Web,3,1255430,90.0,66,Soltero,36,2019,7,high,-3.195,0,-3,985553,-1259,1,5,1
103904,102153,1,Presencial,3.42,3,Hombre,Linkedin,2,273353,90.0,75,Soltero,31,2022,8,high,102143,Presencial,6.39,1,Mujer,Linkedin,5,1616000,90.0,68,Casado,41,2019,6,high,2.9699999999999998,-2,3,1342647,-1168,1,10,1
102496,102115,1,Presencial,1.525,3,Mujer,Linkedin,4,273643,90.0,79,Casado,27,2018,12,high,102116,Presencial,2.0,2,Mujer,Portal Web,4,1616000,94.0,76,Soltero,35,2018,12,high,0.4750000000000001,-1,0,1342357,17,0,8,0
103887,102050,1,Presencial,1.14,10,Hombre,Portal Web,6,292210,90.0,69,Soltero,23,2013,10,high,102069,Presencial,3.7,0,Mujer,Linkedin,11,1512980,90.0,88,Soltero,40,2017,10,high,2.5600000000000005,-10,5,1220770,1467,0,17,0
103982,102155,1,Presencial,3.63,1,Hombre,Ferias & Networking,6,326133,90.0,69,Casado,33,2022,10,high,102159,Presencial,1.78,1,Mujer,Ferias & Networking,1,590000,39.0,80,Soltero,20,2016,10,low,-1.8499999999999999,0,-5,263867,-2188,1,-13,0
103178,102121,1,Presencial,6.595,1,Hombre,Linkedin,8,312353,90.0,80,Divorciado,29,2019,6,high,102127,Híbrida,1.63,2,Hombre,Portal Web,4,1616000,90.0,77,Divorciado,44,2012,2,high,-4.965,1,-4,1303647,-2662,1,15,1
102661,102043,1,Presencial,2.34,2,Hombre,Linkedin,5,305964,90.0,81,Soltero,23,2013,1,high,102051,Presencial,1.03,0,Hombre,Portal Web,5,1616000,60.0,76,Casado,44,2019,5,low,-1.3099999999999998,-2,0,1310036,2322,0,21,0
103139,102094,1,Presencial,1.52,3,Mujer,Referidos,2,324731,90.0,69,Soltero,30,2018,7,high,102095,Presencial,1.32,1,Hombre,Portal Web,4,998000,90.0,85,Casado,28,2016,2,high,-0.19999999999999996,-2,2,673269,-881,1,-2,1
104036,102042,1,Presencial,2.36,9,Mujer,Linkedin,8,325189,90.0,74,Casado,23,2012,5,high,102107,Presencial,2.19,2,Hombre,Ferias & Networking,8,1616000,38.0,78,Divorciado,57,2018,6,low,-0.16999999999999993,-7,0,1290811,2234,0,34,1
102939,102091,1,Presencial,1.52,0,Hombre,Headhunter,8,372064,90.0,72,Soltero,32,2019,9,high,102149,Presencial,1.54,1,Mujer,Portal Web,4,1616000,73.0,77,Casado,39,2014,12,low,0.020000000000000018,1,-4,1243936,-1727,1,7,1
104023,102129,1,Presencial,2.255,7,Hombre,Portal Web,4,408896,90.0,78,Soltero,36,2021,12,high,102142,Presencial,2.1,2,Mujer,Linkedin,3,590000,41.0,74,Soltero,24,2020,1,low,-0.1549999999999998,-5,-1,181104,-714,1,-12,1
103679,102148,1,Presencial,1.955,1,Hombre,Portal Web,7,405657,90.0,75,Casado,38,2022,10,high,102116,Presencial,1.49,2,Mujer,Portal Web,2,539000,80.0,67,Soltero,26,2022,12,high,-0.4650000000000001,1,-5,133343,54,0,-12,0
102798,102057,1,Presencial,1.195,1,Mujer,Linkedin,9,410284,90.0,81,Casado,32,2016,8,high,102019,Presencial,1.97,4,Hombre,Portal Web,5,1616000,90.0,73,Viudo,59,2022,12,high,0.7749999999999999,3,-4,1205716,2324,0,27,0
102973,102099,1,Presencial,1.735,2,Mujer,Referidos,5,432885,90.0,70,Soltero,34,2018,4,high,102080,Presencial,1.71,0,Hombre,Portal Web,11,1616000,76.0,80,Viudo,51,2021,10,low,-0.025000000000000133,-2,6,1183115,1261,0,17,0
103630,102102,1,Presencial,2.39,2,Mujer,Portal Web,6,424862,90.0,77,Divorciado,34,2017,11,high,102018,Presencial,2.48,0,Hombre,Portal Web,5,1616000,92.0,63,Viudo,49,2019,4,high,0.08999999999999986,-2,-1,1191138,531,0,15,0
102384,102023,1,Presencial,2.04,2,Hombre,Referidos,9,425369,90.0,70,Casado,28,2012,10,high,102105,Híbrida,4.9,1,Hombre,Portal Web,4,539000,80.0,65,Casado,23,2019,12,high,2.8600000000000003,-1,-5,113631,2644,0,-5,0
103011,102124,1,Presencial,5.205,3,Mujer,Portal Web,3,466454,90.0,77,Casado,38,2021,2,high,102099,Presencial,2.84,2,Mujer,Linkedin,4,947000,90.0,70,Soltero,24,2012,10,high,-2.365,-1,1,480546,-3025,1,-14,1
102337,102052,1,Presencial,2.12,2,Hombre,Ferias & Networking,4,783576,90.0,67,Soltero,32,2014,4,high,102093,Presencial,4.45,0,Hombre,Linkedin,5,641000,84.0,76,Divorciado,17,2012,4,high,2.33,-2,1,-142576,-739,1,-15,0
104059,102144,1,Presencial,2.515,0,Hombre,Portal Web,6,491164,90.0,96,Soltero,41,2022,7,high,102156,Presencial,2.13,8,Mujer,Portal Web,11,1616000,5.0,82,Viudo,58,2015,6,low,-0.38500000000000023,8,5,1124836,-2570,1,17,1
103491,102117,1,Presencial,2.405,6,Mujer,Linkedin,3,469121,90.0,68,Casado,39,2021,2,high,102154,Presencial,4.05,1,Mujer,Linkedin,10,1616000,90.0,80,Divorciado,48,2021,1,high,1.645,-5,7,1146879,-31,1,9,0
104135,102088,1,Presencial,1.26,12,Mujer,Portal Web,10,764980,90.0,72,Soltero,35,2017,5,high,102139,Presencial,4.96,1,Mujer,Portal Web,3,488000,82.0,65,Soltero,20,2018,4,high,3.7,-11,-7,-276980,343,0,-15,0
102254,102134,1,Presencial,2.415,2,Hombre,Linkedin,8,259054,90.0,74,Divorciado,44,2022,8,high,102135,Presencial,2.25,2,Hombre,Portal Web,5,1358450,90.0,69,Viudo,31,2012,7,high,-0.16500000000000004,0,-3,1099396,-3699,1,-13,0
103487,102033,1,Presencial,1.615,4,Hombre,Portal Web,10,258545,90.0,75,Casado,36,2014,9,high,102172,Presencial,6.25,2,Mujer,Portal Web,16,1616000,90.0,79,Divorciado,39,2014,5,high,4.635,-2,6,1357455,-131,1,3,1
102274,102046,1,Presencial,5.64,2,Mujer,Ferias & Networking,11,425264,90.0,68,Casado,35,2014,3,high,102007,Presencial,1.68,0,Mujer,Portal Web,8,1616000,41.0,71,Soltero,50,2015,10,low,-3.96,-2,-3,1190736,576,0,15,0
103284,102012,1,Presencial,1.17,7,Mujer,Portal Web,9,438848,90.0,79,Soltero,34,2013,1,high,102122,Presencial,2.09,1,Mujer,Portal Web,7,1100000,90.0,80,Casado,34,2019,7,high,0.9199999999999999,-6,-2,661152,2356,0,0,0
103774,102065,1,Presencial,3.08,10,Mujer,Linkedin,11,266528,90.0,75,Casado,38,2016,3,high,102026,Presencial,2.44,2,Hombre,Ferias & Networking,13,1616000,45.0,60,Divorciado,35,2014,10,low,-0.6400000000000001,-8,2,1349472,-527,1,-3,0
102725,102046,1,Presencial,2.23,0,Hombre,Portal Web,6,407208,90.0,79,Casado,36,2014,5,high,102007,Presencial,1.68,0,Mujer,Portal Web,8,1616000,41.0,71,Soltero,50,2015,10,low,-0.55,0,2,1208792,537,0,14,0
103568,102017,1,Presencial,1.34,2,Hombre,Linkedin,10,265843,90.0,75,Soltero,35,2013,2,high,102035,Presencial,4.62,0,Mujer,Linkedin,2,641000,90.0,84,Casado,25,2019,11,high,3.2800000000000002,-2,-8,375157,2452,0,-10,0
103001,102124,1,Presencial,2.49,1,Hombre,Ferias & Networking,6,274988,90.0,72,Casado,45,2022,4,high,102099,Presencial,2.84,2,Mujer,Linkedin,4,947000,90.0,70,Soltero,24,2012,10,high,0.34999999999999964,1,-2,672012,-3460,1,-21,1
103663,102111,1,Presencial,1.94,0,Hombre,Linkedin,14,280642,90.0,76,Casado,41,2018,5,high,102097,Híbrida,2.04,1,Mujer,Referidos,15,1616000,94.0,67,Soltero,50,2021,5,high,0.10000000000000009,1,1,1335358,1089,0,9,0
104100,102045,1,Presencial,1.595,2,Mujer,Linkedin,14,282485,90.0,70,Divorciado,37,2014,2,high,102171,Presencial,3.19,3,Hombre,Portal Web,11,1616000,97.0,65,Casado,53,2023,9,high,1.595,1,-3,1333515,3518,0,16,1
102684,102115,1,Presencial,2.41,1,Mujer,Ferias & Networking,14,292080,90.0,80,Divorciado,46,2021,7,high,102116,Presencial,2.0,2,Mujer,Portal Web,4,1616000,94.0,76,Soltero,35,2018,12,high,-0.41000000000000014,1,-10,1323920,-930,1,-11,0
103219,102045,1,Presencial,3.01,1,Mujer,Portal Web,14,288260,90.0,69,Casado,38,2014,7,high,102171,Presencial,3.19,3,Hombre,Portal Web,11,1616000,97.0,65,Casado,53,2023,9,high,0.18000000000000016,2,-3,1327740,3347,0,15,0
102408,102018,1,Presencial,1.9,2,Hombre,Portal Web,9,289946,90.0,74,Soltero,36,2012,7,high,102160,Presencial,5.57,5,Hombre,Portal Web,3,692000,90.0,69,Divorciado,28,2022,2,high,3.6700000000000004,3,-6,402054,3525,0,-8,0
102437,102006,1,Presencial,2.115,1,Hombre,Portal Web,5,287749,90.0,66,Divorciado,36,2012,2,high,102084,Presencial,2.58,0,Hombre,Linkedin,16,1900000,87.0,77,Viudo,57,2019,4,high,0.46499999999999986,-1,11,1612251,2618,0,21,0
103182,102153,1,Presencial,3.755,0,Hombre,Ferias & Networking,3,395292,90.0,76,Divorciado,47,2022,8,high,102143,Presencial,6.39,1,Mujer,Linkedin,5,1616000,90.0,68,Casado,41,2019,6,high,2.635,1,2,1220708,-1150,1,-6,1
103503,102131,1,Presencial,3.095,0,Mujer,Ferias & Networking,9,407574,90.0,75,Soltero,45,2019,11,high,102109,Presencial,5.54,0,Hombre,Linkedin,3,998000,39.0,77,Soltero,34,2021,12,low,2.445,0,-6,590426,764,0,-11,0
103408,102061,1,Presencial,4.125,8,Hombre,Portal Web,15,642256,90.0,74,Casado,42,2015,8,high,102115,Presencial,2.14,2,Hombre,Ferias & Networking,10,1203920,37.0,80,Casado,29,2012,11,low,-1.9849999999999999,-6,-5,561664,-1017,1,-13,0
103788,102129,1,Presencial,1.825,2,Hombre,Ferias & Networking,13,639409,90.0,69,Soltero,48,2021,8,high,102142,Presencial,2.1,2,Mujer,Linkedin,3,590000,41.0,74,Soltero,24,2020,1,low,0.27500000000000013,0,-10,-49409,-584,1,-24,0
103356,102041,1,Presencial,2.08,3,Hombre,Ferias & Networking,15,917343,90.0,81,Soltero,43,2015,7,high,102147,Presencial,1.29,0,Mujer,Portal Web,8,1616000,44.0,73,Casado,51,2014,5,low,-0.79,-3,-7,698657,-438,1,8,1
103030,102134,1,Presencial,2.51,3,Hombre,Portal Web,16,656205,90.0,85,Viudo,52,2023,3,high,102135,Presencial,2.25,2,Hombre,Portal Web,5,1358450,90.0,69,Viudo,31,2012,7,high,-0.2599999999999998,-1,-11,702245,-3905,1,-21,0
103450,102139,1,Presencial,4.705,0,Mujer,Headhunter,4,774392,90.0,74,Soltero,50,2021,6,high,102154,Presencial,6.48,1,Hombre,Ferias & Networking,5,590000,90.0,67,Casado,25,2021,6,high,1.7750000000000004,1,1,-184392,13,0,-25,0
103851,102147,1,Presencial,0.955,6,Mujer,Portal Web,17,682407,90.0,77,Divorciado,52,2022,9,high,102057,Presencial,1.58,2,Hombre,Portal Web,4,1616000,90.0,80,Casado,49,2022,12,high,0.6250000000000001,-4,-13,933593,91,0,-3,0
102540,102140,1,Presencial,4.34,3,Mujer,Linkedin,14,674149,90.0,84,Soltero,50,2021,3,high,102040,Presencial,2.55,0,Mujer,Portal Web,16,1616000,46.0,69,Casado,39,2012,2,low,-1.79,-3,2,941851,-3331,1,-11,0
102389,102130,1,Presencial,1.595,1,Hombre,Linkedin,13,876562,90.0,68,Soltero,50,2020,8,high,102068,Presencial,1.97,6,Hombre,Linkedin,5,1616000,84.0,73,Soltero,31,2014,4,high,0.375,5,-8,739438,-2293,1,-19,0
103268,102084,1,Presencial,2.965,7,Mujer,Portal Web,9,676103,90.0,69,Casado,45,2016,4,high,102171,Presencial,2.62,3,Mujer,Portal Web,14,1616000,89.0,76,Divorciado,50,2023,7,high,-0.34499999999999975,-4,5,939897,2649,0,5,0
103600,102056,1,Presencial,1.295,6,Mujer,Portal Web,21,855066,90.0,78,Soltero,43,2013,11,high,102014,Presencial,5.24,1,Hombre,Ferias & Networking,16,1616000,70.0,63,Viudo,65,2023,3,low,3.9450000000000003,-5,-5,760934,3414,0,22,1
103655,102049,1,Presencial,3.145,3,Mujer,Linkedin,12,694357,90.0,83,Viudo,45,2015,9,high,102029,Presencial,6.89,0,Mujer,Portal Web,9,1616000,19.0,77,Divorciado,49,2023,3,low,3.7449999999999997,-3,-3,921643,2736,0,4,0
102962,102075,1,Presencial,6.22,0,Mujer,Portal Web,3,720523,90.0,83,Divorciado,47,2016,4,high,102047,Presencial,2.7,1,Hombre,Referidos,11,1255430,90.0,76,Casado,30,2013,3,high,-3.5199999999999996,1,8,534907,-1128,1,-17,0
102536,102015,1,Presencial,3.06,1,Mujer,Linkedin,9,721510,90.0,83,Casado,44,2013,6,high,102121,Presencial,6.18,1,Mujer,Referidos,10,1358450,74.0,82,Soltero,33,2014,6,low,3.1199999999999997,0,1,636940,366,0,-11,0
102573,102107,1,Presencial,4.71,1,Mujer,Portal Web,3,741140,90.0,85,Divorciado,51,2018,11,high,102069,Presencial,2.4,1,Mujer,Linkedin,8,1616000,47.0,79,Casado,63,2023,6,low,-2.31,0,5,874860,1684,0,12,1
102655,102058,1,Presencial,6.83,2,Hombre,Portal Web,17,838492,90.0,67,Divorciado,47,2015,6,high,102172,Presencial,1.4,2,Hombre,Ferias & Networking,11,1616000,75.0,71,Casado,59,2021,2,low,-5.43,0,-6,777508,2076,0,12,0
102302,102046,1,Presencial,2.945,1,Mujer,Ferias & Networking,3,853800,90.0,77,Casado,47,2015,3,high,102007,Presencial,1.68,0,Mujer,Portal Web,8,1616000,41.0,71,Soltero,50,2015,10,low,-1.265,-1,5,762200,234,0,3,0
103279,102003,1,Presencial,2.28,5,Hombre,Linkedin,19,737260,90.0,79,Casado,44,2012,3,high,102130,Presencial,4.05,12,Hombre,Portal Web,8,1616000,83.0,82,Divorciado,49,2023,2,high,1.77,7,-11,878740,4007,0,5,0
103558,102089,1,Presencial,4.545,3,Mujer,Linkedin,19,853981,90.0,73,Casado,51,2018,6,high,102077,Presencial,2.75,1,Hombre,Ferias & Networking,6,1616000,96.0,69,Divorciado,60,2021,10,high,-1.795,-2,-13,762019,1230,0,9,0
103031,102134,1,Presencial,3.795,0,Mujer,Referidos,18,895823,90.0,69,Casado,56,2022,2,high,102135,Presencial,2.25,2,Hombre,Portal Web,5,1358450,90.0,69,Viudo,31,2012,7,high,-1.545,2,-13,462627,-3493,1,-25,0
103391,102053,1,Presencial,4.665,3,Mujer,Ferias & Networking,11,873537,90.0,75,Casado,51,2014,5,high,102030,Presencial,1.29,0,Hombre,Portal Web,11,1616000,81.0,64,Soltero,36,2012,12,high,-3.375,-3,0,742463,-507,1,-15,0
100535,102132,1,Presencial,2.13,2,Hombre,Referidos,1,79605,89.0,74,Soltero,19,2022,11,high,102138,Presencial,4.51,1,Hombre,Linkedin,16,1616000,25.0,80,Viudo,45,2014,3,low,2.38,-1,15,1536395,-3153,1,26,0
100438,102110,1,Presencial,6.67,0,Hombre,Linkedin,1,96576,89.0,82,Soltero,16,2018,2,high,102045,Presencial,1.6,5,Mujer,Linkedin,2,998000,87.0,76,Soltero,29,2016,11,high,-5.07,5,1,901424,-436,1,13,0
101870,102106,1,Presencial,1.79,0,Mujer,Ferias & Networking,3,136381,89.0,71,Soltero,18,2018,4,high,102081,Presencial,1.39,1,Mujer,Ferias & Networking,5,1049000,86.0,86,Soltero,32,2019,6,high,-0.40000000000000013,1,2,912619,438,0,14,0
100136,102065,1,Presencial,2.505,1,Mujer,Referidos,3,207175,89.0,80,Soltero,21,2016,2,high,102026,Presencial,2.44,2,Hombre,Ferias & Networking,13,1616000,45.0,60,Divorciado,35,2014,10,low,-0.06499999999999995,1,10,1408825,-488,1,14,0
101155,102056,1,Presencial,5.86,7,Hombre,Portal Web,7,268102,89.0,70,Soltero,24,2016,4,high,102014,Presencial,5.24,1,Hombre,Ferias & Networking,16,1616000,70.0,63,Viudo,65,2023,3,low,-0.6200000000000001,-6,9,1347898,2531,0,41,0
102145,102116,2,Presencial,1.43,1,Mujer,Portal Web,3,692000,89.0,73,Viudo,23,2016,12,high,102021,Presencial,2.32,0,Mujer,Portal Web,22,1616000,94.0,76,Casado,59,2020,7,high,0.8899999999999999,-1,19,924000,1323,0,36,1
100038,102116,1,Presencial,2.225,2,Mujer,Referidos,6,351858,89.0,72,Casado,31,2018,10,high,102021,Presencial,2.32,0,Mujer,Portal Web,22,1616000,94.0,76,Casado,59,2020,7,high,0.09499999999999975,-2,16,1264142,631,0,28,0
101604,102075,1,Presencial,1.475,0,Hombre,Ferias & Networking,2,365151,89.0,68,Casado,31,2017,10,high,102047,Presencial,2.7,1,Hombre,Referidos,11,1255430,90.0,76,Casado,30,2013,3,high,1.225,1,9,890279,-1670,1,-1,0
100707,102139,1,Presencial,4.855,2,Mujer,Portal Web,7,408430,89.0,71,Casado,38,2023,6,high,102154,Presencial,6.48,1,Hombre,Ferias & Networking,5,590000,90.0,67,Casado,25,2021,6,high,1.625,-1,-2,181570,-722,1,-13,0
102136,102034,2,Presencial,1.78,2,Hombre,Portal Web,3,1616000,89.0,78,Casado,35,2013,1,high,102113,Presencial,7.84,7,Hombre,Linkedin,5,1564490,90.0,70,Casado,35,2012,9,high,6.06,5,2,-51510,-110,1,0,0
103083,102034,1,Presencial,2.88,8,Hombre,Portal Web,1,142488,89.0,71,Casado,13,2012,8,high,102113,Presencial,7.84,7,Hombre,Linkedin,5,1564490,90.0,70,Casado,35,2012,9,high,4.96,-1,4,1422002,47,0,22,0
104052,102025,1,Presencial,1.09,9,Mujer,Linkedin,4,309399,89.0,72,Soltero,24,2013,11,high,102132,Presencial,1.6,0,Hombre,Portal Web,9,1616000,90.0,81,Viudo,56,2018,4,high,0.51,-9,5,1306601,1602,0,32,0
102364,102099,1,Presencial,5.59,3,Hombre,Linkedin,8,784021,89.0,72,Casado,31,2017,1,high,102080,Presencial,1.71,0,Hombre,Portal Web,11,1616000,76.0,80,Viudo,51,2021,10,low,-3.88,-3,3,831979,1729,0,20,0
103000,102087,1,Presencial,2.155,0,Hombre,Referidos,6,450207,89.0,67,Casado,33,2016,5,high,102111,Presencial,7.16,9,Mujer,Linkedin,10,1616000,98.0,79,Casado,42,2012,5,high,5.005000000000001,9,4,1165793,-1464,1,9,0
101367,102025,1,Presencial,1.04,9,Mujer,Linkedin,4,306768,88.0,72,Soltero,23,2013,11,high,102132,Presencial,1.6,0,Hombre,Portal Web,9,1616000,90.0,81,Viudo,56,2018,4,high,0.56,-9,5,1309232,1603,0,33,1
100297,102158,1,Presencial,1.535,4,Mujer,Portal Web,7,285078,88.0,75,Casado,47,2022,11,high,102093,Presencial,1.79,1,Mujer,Referidos,27,1900000,87.0,74,Viudo,54,2013,9,high,0.2550000000000001,-3,20,1614922,-3356,1,7,0
101025,102108,1,Presencial,3.3,2,Mujer,Ferias & Networking,13,293468,88.0,76,Divorciado,45,2020,2,high,102040,Presencial,2.92,1,Mujer,Portal Web,5,1616000,46.0,75,Casado,50,2023,5,low,-0.3799999999999999,-1,-8,1322532,1194,0,5,0
100695,102140,1,Presencial,2.335,1,Mujer,Linkedin,3,814244,88.0,76,Viudo,50,2023,3,high,102040,Presencial,2.55,0,Mujer,Portal Web,16,1616000,46.0,69,Casado,39,2012,2,low,0.21499999999999986,-1,13,801756,-4058,1,-11,0
104160,102111,1,Presencial,5.055,2,Hombre,Ferias & Networking,1,78522,88.0,81,Soltero,18,2020,9,high,102097,Híbrida,2.04,1,Mujer,Referidos,15,1616000,94.0,67,Soltero,50,2021,5,high,-3.0149999999999997,-1,14,1537478,232,0,32,0
103876,102110,1,Presencial,6.66,0,Hombre,Linkedin,1,99167,88.0,82,Soltero,16,2018,2,high,102045,Presencial,1.6,5,Mujer,Linkedin,2,998000,87.0,76,Soltero,29,2016,11,high,-5.0600000000000005,5,1,898833,-436,1,13,0
104011,102127,1,Presencial,5.485,0,Hombre,Linkedin,15,304340,88.0,88,Soltero,47,2021,7,high,102028,Presencial,4.03,2,Mujer,Linkedin,9,1306940,88.0,78,Divorciado,32,2014,5,high,-1.455,2,-6,1002600,-2603,1,-15,1
100992,102107,1,Presencial,1.435,3,Mujer,Linkedin,9,470889,87.0,80,Casado,37,2019,1,high,102069,Presencial,2.4,1,Mujer,Linkedin,8,1616000,47.0,79,Casado,63,2023,6,low,0.9649999999999999,-2,-1,1145111,1622,0,26,0
101408,102034,1,Presencial,1.53,2,Mujer,Portal Web,5,300811,87.0,85,Soltero,37,2012,2,high,102113,Presencial,7.84,7,Hombre,Linkedin,5,1564490,90.0,70,Casado,35,2012,9,high,6.31,5,0,1263679,220,0,-2,1
101858,102172,1,Presencial,2.91,3,Mujer,Referidos,9,655535,87.0,74,Casado,51,2023,1,high,102020,Presencial,5.58,1,Hombre,Portal Web,7,1049000,57.0,70,Casado,29,2016,4,low,2.67,-2,-2,393465,-2458,1,-22,0
100962,102040,1,Presencial,1.095,2,Hombre,Portal Web,5,680979,87.0,71,Soltero,44,2015,6,high,102106,Presencial,3.21,1,Hombre,Linkedin,15,1616000,91.0,84,Soltero,45,2016,7,high,2.115,-1,10,935021,409,0,1,0
102006,102084,2,Presencial,2.58,0,Hombre,Linkedin,16,1900000,87.0,77,Viudo,57,2019,4,high,102171,Presencial,2.62,3,Mujer,Portal Web,14,1616000,89.0,76,Divorciado,50,2023,7,high,0.040000000000000036,3,-2,-284000,1545,0,-7,1
102363,102084,1,Presencial,2.19,2,Mujer,Referidos,2,145799,87.0,82,Soltero,18,2017,9,high,102171,Presencial,2.62,3,Mujer,Portal Web,14,1616000,89.0,76,Divorciado,50,2023,7,high,0.43000000000000016,1,12,1470201,2142,0,32,0
102308,102069,1,Presencial,1.685,3,Mujer,Referidos,9,408337,87.0,65,Soltero,38,2017,3,high,102069,Presencial,4.64,1,Mujer,Ferias & Networking,19,1616000,47.0,74,Casado,60,2021,10,low,2.9549999999999996,-2,10,1207663,1670,0,22,0
102561,102023,1,Presencial,6.11,8,Hombre,Portal Web,6,277952,87.0,80,Soltero,37,2014,1,high,102105,Híbrida,4.9,1,Hombre,Portal Web,4,539000,80.0,65,Casado,23,2019,12,high,-1.21,-7,-2,261048,2174,0,-14,0
102298,102108,1,Presencial,3.325,3,Mujer,Ferias & Networking,13,294704,87.0,76,Divorciado,45,2020,2,high,102040,Presencial,2.92,1,Mujer,Portal Web,5,1616000,46.0,75,Casado,50,2023,5,low,-0.40500000000000025,-2,-8,1321296,1196,0,5,0
101873,102095,1,Presencial,5.785,12,Mujer,Linkedin,5,429424,86.0,80,Divorciado,36,2019,4,high,102171,Presencial,3.28,2,Mujer,Portal Web,3,1616000,80.0,75,Soltero,42,2023,10,high,-2.5050000000000003,-10,-2,1186576,1633,0,6,0
102106,102081,2,Presencial,1.39,1,Mujer,Ferias & Networking,5,1049000,86.0,86,Soltero,32,2019,6,high,102135,Presencial,2.5,2,Hombre,Portal Web,4,488000,26.0,64,Soltero,18,2015,8,low,1.11,1,-1,-561000,-1391,1,-14,1
100777,102081,1,Presencial,4.955,1,Mujer,Ferias & Networking,5,260195,86.0,67,Casado,39,2017,8,high,102135,Presencial,2.5,2,Hombre,Portal Web,4,488000,26.0,64,Soltero,18,2015,8,low,-2.455,1,-1,227805,-714,1,-21,0
100411,102069,1,Presencial,1.69,3,Mujer,Referidos,9,406223,86.0,65,Soltero,38,2017,3,high,102069,Presencial,4.64,1,Mujer,Ferias & Networking,19,1616000,47.0,74,Casado,60,2021,10,low,2.9499999999999997,-2,10,1209777,1670,0,22,0
100424,102023,1,Presencial,6.08,7,Hombre,Portal Web,6,274855,86.0,80,Soltero,37,2014,1,high,102105,Híbrida,4.9,1,Hombre,Portal Web,4,539000,80.0,65,Casado,23,2019,12,high,-1.1799999999999997,-6,-2,264145,2174,0,-14,0
101344,102077,1,Presencial,1.795,2,Mujer,Referidos,13,289771,86.0,74,Casado,39,2015,6,high,102146,Presencial,2.27,0,Hombre,Ferias & Networking,11,1306940,31.0,64,Soltero,39,2021,6,low,0.4750000000000001,-2,-2,1017169,2215,0,0,1
100499,102051,1,Presencial,0.89,1,Mujer,Portal Web,18,813936,86.0,76,Viudo,45,2016,1,high,102075,Híbrida,1.39,1,Hombre,Portal Web,11,1616000,83.0,76,Casado,46,2019,11,high,0.4999999999999999,0,-7,802064,1398,0,1,0
100148,102118,1,Presencial,2.78,5,Hombre,Portal Web,5,921393,86.0,61,Viudo,53,2021,1,high,102171,Presencial,4.76,17,Mujer,Linkedin,4,1616000,86.0,74,Soltero,39,2023,8,high,1.98,12,-1,694607,962,0,-14,0
104110,102128,1,Presencial,4.945,2,Hombre,Linkedin,2,100062,86.0,68,Soltero,21,2022,11,high,102056,Presencial,4.11,10,Mujer,Portal Web,16,1616000,46.0,72,Soltero,55,2021,2,low,-0.835,8,14,1515938,-648,1,34,0
103505,102100,1,Presencial,6.835,2,Hombre,Portal Web,1,229475,86.0,77,Casado,24,2018,4,high,102007,Presencial,3.3,1,Mujer,Portal Web,3,1255430,21.0,59,Casado,30,2013,2,low,-3.535,-1,2,1025955,-1895,1,6,1
103285,102081,1,Presencial,6.245,2,Mujer,Portal Web,3,348957,86.0,78,Soltero,31,2018,10,high,102135,Presencial,2.5,2,Hombre,Portal Web,4,488000,26.0,64,Soltero,18,2015,8,low,-3.745,0,1,139043,-1162,1,-13,1
103348,102095,1,Presencial,5.795,11,Mujer,Linkedin,5,426759,86.0,80,Divorciado,35,2019,4,high,102171,Presencial,3.28,2,Mujer,Portal Web,3,1616000,80.0,75,Soltero,42,2023,10,high,-2.515,-9,-2,1189241,1634,0,7,0
102208,102107,1,Presencial,2.05,3,Mujer,Referidos,11,868445,86.0,77,Soltero,38,2018,11,high,102069,Presencial,2.4,1,Mujer,Linkedin,8,1616000,47.0,79,Casado,63,2023,6,low,0.3500000000000001,-2,-3,747555,1679,0,25,0
103244,102077,1,Presencial,1.81,2,Mujer,Referidos,13,289926,86.0,74,Casado,39,2015,5,high,102146,Presencial,2.27,0,Hombre,Ferias & Networking,11,1306940,31.0,64,Soltero,39,2021,6,low,0.45999999999999996,-2,-2,1017014,2217,0,0,0
103621,102016,1,Presencial,2.275,2,Hombre,Portal Web,15,289744,86.0,82,Divorciado,36,2012,1,high,102008,Híbrida,2.51,2,Mujer,Portal Web,6,1616000,40.0,80,Casado,44,2017,8,low,0.23499999999999988,0,-9,1326256,2047,0,8,1
103135,102034,1,Presencial,1.53,2,Mujer,Portal Web,5,294380,86.0,85,Viudo,37,2012,2,high,102113,Presencial,7.84,7,Hombre,Linkedin,5,1564490,90.0,70,Casado,35,2012,9,high,6.31,5,0,1270110,219,0,-2,0
101318,102074,1,Presencial,5.885,1,Mujer,Ferias & Networking,3,140559,85.0,75,Soltero,19,2018,5,high,102028,Presencial,1.35,0,Hombre,Ferias & Networking,4,1616000,80.0,83,Viudo,43,2015,12,high,-4.535,-1,1,1475441,-878,1,24,0
101314,102053,1,Presencial,1.575,2,Hombre,Portal Web,5,368110,85.0,82,Casado,27,2014,11,high,102030,Presencial,1.29,0,Hombre,Portal Web,11,1616000,81.0,64,Soltero,36,2012,12,high,-0.2849999999999999,-2,6,1247890,-682,1,9,0
100898,102004,1,Presencial,5.645,2,Hombre,Ferias & Networking,10,767946,85.0,67,Soltero,26,2012,3,high,102026,Presencial,3.13,1,Hombre,Portal Web,15,1616000,87.0,85,Viudo,49,2023,1,high,-2.5149999999999997,-1,5,848054,3935,0,23,0
101193,102072,1,Presencial,3.8,0,Mujer,Portal Web,5,430675,85.0,71,Casado,34,2017,10,high,102046,Presencial,2.61,2,Hombre,Ferias & Networking,3,947000,41.0,71,Soltero,30,2018,11,low,-1.19,2,-2,516325,423,0,-4,1
100229,102090,1,Presencial,1.765,1,Mujer,Portal Web,14,656578,85.0,75,Divorciado,45,2017,3,high,102171,Presencial,6.83,0,Hombre,Linkedin,4,488000,92.0,76,Soltero,19,2017,2,high,5.065,-1,-10,-168578,-41,1,-26,1
101177,102137,1,Presencial,3.65,3,Hombre,Portal Web,9,694569,85.0,73,Soltero,53,2023,1,high,102046,Presencial,1.18,0,Mujer,Portal Web,2,845000,37.0,79,Casado,27,2017,12,low,-2.4699999999999998,-3,-7,150431,-1837,1,-26,1
100589,102083,1,Presencial,6.24,4,Mujer,Referidos,18,839052,85.0,83,Viudo,46,2015,12,high,102147,Presencial,1.61,0,Mujer,Portal Web,5,1564490,83.0,71,Soltero,44,2021,2,high,-4.63,-4,-13,725438,1902,0,-2,0
101773,102080,1,Presencial,4.8,3,Hombre,Ferias & Networking,8,717862,85.0,70,Divorciado,46,2015,12,high,102035,Presencial,1.93,0,Mujer,Linkedin,18,1616000,94.0,75,Viudo,47,2016,8,high,-2.87,-3,10,898138,254,0,1,0
104069,102137,1,Presencial,6.445,10,Hombre,Portal Web,12,493070,85.0,75,Casado,42,2022,9,high,102046,Presencial,1.18,0,Mujer,Portal Web,2,845000,37.0,79,Casado,27,2017,12,low,-5.265000000000001,-10,-10,351930,-1729,1,-15,1
102533,102143,1,Presencial,1.79,1,Hombre,Portal Web,5,270006,85.0,75,Soltero,43,2020,11,high,102142,Presencial,1.07,2,Hombre,Portal Web,2,590000,90.0,78,Casado,25,2022,2,high,-0.72,1,-3,319994,439,0,-18,0
103270,102090,1,Presencial,1.73,0,Mujer,Portal Web,14,661012,85.0,75,Divorciado,45,2017,3,high,102171,Presencial,6.83,0,Hombre,Linkedin,4,488000,92.0,76,Soltero,19,2017,2,high,5.1,0,-10,-173012,-41,1,-26,0
102952,102051,1,Presencial,1.235,3,Mujer,Referidos,4,676335,85.0,80,Casado,44,2015,5,high,102075,Híbrida,1.39,1,Hombre,Portal Web,11,1616000,83.0,76,Casado,46,2019,11,high,0.1549999999999998,-2,7,939665,1635,0,2,0
104118,102118,1,Presencial,2.805,5,Hombre,Portal Web,3,914236,85.0,61,Viudo,53,2021,1,high,102171,Presencial,4.76,17,Mujer,Linkedin,4,1616000,86.0,74,Soltero,39,2023,8,high,1.9549999999999996,12,1,701764,962,0,-14,1
101167,102056,1,Presencial,2.875,1,Hombre,Portal Web,3,186067,84.0,82,Soltero,17,2014,2,high,102014,Presencial,5.24,1,Hombre,Ferias & Networking,16,1616000,70.0,63,Viudo,65,2023,3,low,2.365,0,13,1429933,3298,0,48,0
100797,102124,1,Presencial,7.015,2,Hombre,Referidos,6,251508,84.0,75,Soltero,28,2021,5,high,102099,Presencial,2.84,2,Mujer,Linkedin,4,947000,90.0,70,Soltero,24,2012,10,high,-4.175,0,-2,695492,-3130,1,-4,0
101630,102143,1,Presencial,1.795,0,Hombre,Portal Web,5,268287,84.0,75,Soltero,43,2020,11,high,102142,Presencial,1.07,2,Hombre,Portal Web,2,590000,90.0,78,Casado,25,2022,2,high,-0.7249999999999999,2,-3,321713,441,0,-18,0
100646,102114,1,Presencial,1.985,2,Mujer,Ferias & Networking,4,679664,84.0,67,Casado,49,2020,6,high,102050,Presencial,1.44,1,Mujer,Portal Web,5,1616000,91.0,69,Divorciado,47,2021,5,high,-0.5450000000000002,-1,1,936336,328,0,-2,0
102024,102074,2,Presencial,2.28,0,Hombre,Headhunter,9,1616000,84.0,70,Casado,48,2018,3,high,102028,Presencial,1.35,0,Hombre,Ferias & Networking,4,1616000,80.0,83,Viudo,43,2015,12,high,-0.9299999999999997,0,-5,0,-808,1,-5,0
103476,102074,1,Presencial,5.875,2,Mujer,Ferias & Networking,3,140862,84.0,75,Soltero,19,2018,5,high,102028,Presencial,1.35,0,Hombre,Ferias & Networking,4,1616000,80.0,83,Viudo,43,2015,12,high,-4.525,-2,1,1475138,-878,1,24,0
103384,102056,1,Presencial,2.835,2,Hombre,Portal Web,3,182743,84.0,82,Soltero,17,2014,2,high,102014,Presencial,5.24,1,Hombre,Ferias & Networking,16,1616000,70.0,63,Viudo,65,2023,3,low,2.4050000000000002,-1,13,1433257,3297,0,48,0
102207,102026,1,Presencial,1.435,1,Mujer,Linkedin,6,312275,84.0,71,Soltero,24,2014,3,high,102101,Presencial,2.7,1,Mujer,Portal Web,15,1616000,97.0,79,Casado,58,2017,6,high,1.2650000000000001,0,9,1303725,1183,0,34,0
102340,102059,1,Presencial,2.425,0,Hombre,Portal Web,7,678315,84.0,77,Viudo,43,2013,11,high,102021,Presencial,2.55,2,Hombre,Portal Web,16,1616000,27.0,76,Viudo,50,2019,6,low,0.125,2,9,937685,2048,0,7,0
104113,102127,1,Presencial,1.275,12,Mujer,Portal Web,18,694845,84.0,76,Soltero,52,2022,4,high,102028,Presencial,4.03,2,Mujer,Linkedin,9,1306940,88.0,78,Divorciado,32,2014,5,high,2.7550000000000003,-10,-9,612095,-2896,1,-20,0
102226,102052,1,Presencial,1.55,1,Hombre,Referidos,19,917406,84.0,81,Casado,49,2015,5,high,102093,Presencial,4.45,0,Hombre,Linkedin,5,641000,84.0,76,Divorciado,17,2012,4,high,2.9000000000000004,-1,-14,-276406,-1153,1,-32,0
101862,102171,1,Presencial,1.95,2,Mujer,Portal Web,1,118595,83.0,84,Casado,22,2023,6,high,102088,Presencial,2.57,4,Hombre,Linkedin,8,1616000,80.0,69,Casado,43,2017,10,high,0.6199999999999999,2,7,1497405,-2071,1,21,0
100624,102057,1,Presencial,1.425,6,Mujer,Portal Web,2,192285,83.0,80,Divorciado,21,2016,12,high,102019,Presencial,1.97,4,Hombre,Portal Web,5,1616000,90.0,73,Viudo,59,2022,12,high,0.5449999999999999,-2,3,1423715,2204,0,38,0
102078,102143,2,Presencial,2.17,1,Hombre,Ferias & Networking,9,998000,83.0,76,Casado,29,2017,5,high,102142,Presencial,1.07,2,Hombre,Portal Web,2,590000,90.0,78,Casado,25,2022,2,high,-1.0999999999999999,1,-7,-408000,1714,0,-4,1
100470,102143,1,Presencial,2.16,2,Hombre,Portal Web,12,757165,83.0,74,Divorciado,55,2022,4,high,102142,Presencial,1.07,2,Hombre,Portal Web,2,590000,90.0,78,Casado,25,2022,2,high,-1.09,0,-10,-167165,-72,1,-30,1
102232,102115,1,Presencial,1.39,2,Mujer,Referidos,7,250066,83.0,77,Soltero,27,2020,4,high,102116,Presencial,2.0,2,Mujer,Portal Web,4,1616000,94.0,76,Soltero,35,2018,12,high,0.6100000000000001,0,-3,1365934,-486,1,8,0
103421,102106,1,Presencial,4.95,2,Hombre,Linkedin,6,413345,83.0,72,Soltero,39,2018,5,high,102081,Presencial,1.39,1,Mujer,Ferias & Networking,5,1049000,86.0,86,Soltero,32,2019,6,high,-3.5600000000000005,-1,-1,635655,394,0,-7,0
103353,102012,1,Presencial,2.475,2,Hombre,Referidos,3,433269,83.0,77,Divorciado,38,2013,5,high,102122,Presencial,2.09,1,Mujer,Portal Web,7,1100000,90.0,80,Casado,34,2019,7,high,-0.38500000000000023,-1,4,666731,2260,0,-4,0
102294,102118,1,Presencial,1.035,1,Mujer,Linkedin,7,440845,83.0,87,Casado,47,2020,8,high,102171,Presencial,4.76,17,Mujer,Linkedin,4,1616000,86.0,74,Soltero,39,2023,8,high,3.7249999999999996,16,-3,1175155,1099,0,-8,0
101708,102115,1,Presencial,2.805,0,Hombre,Portal Web,1,116266,82.0,82,Casado,20,2020,8,high,102116,Presencial,2.0,2,Mujer,Portal Web,4,1616000,94.0,76,Soltero,35,2018,12,high,-0.8050000000000002,2,3,1499734,-603,1,15,0
100060,102159,1,Presencial,4.39,2,Hombre,Referidos,3,306895,82.0,68,Casado,32,2022,6,high,102120,Híbrida,0.98,2,Hombre,Referidos,14,808000,90.0,86,Soltero,44,2022,8,high,-3.4099999999999997,0,11,501105,60,0,12,0
100948,102141,1,Presencial,6.465,2,Hombre,Portal Web,2,369411,82.0,72,Soltero,36,2023,6,high,102134,Presencial,1.88,1,Mujer,Linkedin,3,1100900,64.0,69,Soltero,32,2018,5,low,-4.585,-1,1,731489,-1861,1,-4,0
101526,102110,1,Presencial,4.925,1,Hombre,Portal Web,7,405834,82.0,84,Casado,34,2019,11,high,102045,Presencial,1.6,5,Mujer,Linkedin,2,998000,87.0,76,Soltero,29,2016,11,high,-3.3249999999999997,4,-5,592166,-1100,1,-5,1
101575,102115,1,Presencial,2.055,3,Mujer,Portal Web,5,804378,82.0,72,Soltero,38,2018,11,high,102116,Presencial,2.0,2,Mujer,Portal Web,4,1616000,94.0,76,Soltero,35,2018,12,high,-0.05500000000000016,-1,-1,811622,52,0,-3,0
100139,102048,1,Presencial,2.555,6,Hombre,Portal Web,12,639707,82.0,77,Casado,42,2015,7,high,102092,Presencial,3.99,0,Mujer,Portal Web,5,590000,59.0,76,Soltero,20,2015,8,low,1.435,-6,-7,-49707,33,0,-22,1
100294,102021,1,Presencial,5.98,0,Hombre,Portal Web,10,696150,82.0,77,Casado,43,2012,4,high,102069,Presencial,2.25,1,Hombre,Linkedin,8,1616000,47.0,80,Casado,52,2017,3,low,-3.7300000000000004,1,-2,919850,1790,0,9,0
101599,102109,1,Presencial,2.08,1,Hombre,Portal Web,6,916619,82.0,89,Casado,58,2021,1,high,102123,Presencial,3.86,1,Mujer,Portal Web,5,998000,97.0,82,Casado,32,2019,9,high,1.7799999999999998,0,-1,81381,-464,1,-26,0
103273,102115,1,Presencial,2.815,0,Hombre,Portal Web,1,123954,82.0,82,Casado,20,2020,8,high,102116,Presencial,2.0,2,Mujer,Portal Web,4,1616000,94.0,76,Soltero,35,2018,12,high,-0.815,2,3,1492046,-600,1,15,0
102908,102111,1,Presencial,1.625,2,Mujer,Portal Web,1,143710,82.0,70,Soltero,20,2018,12,high,102097,Híbrida,2.04,1,Mujer,Referidos,15,1616000,94.0,67,Soltero,50,2021,5,high,0.41500000000000004,-1,14,1472290,881,0,30,0
103286,102110,1,Presencial,4.93,2,Hombre,Portal Web,7,411389,82.0,84,Casado,34,2019,11,high,102045,Presencial,1.6,5,Mujer,Linkedin,2,998000,87.0,76,Soltero,29,2016,11,high,-3.3299999999999996,3,-5,586611,-1100,1,-5,1
102761,102115,1,Presencial,2.07,2,Mujer,Portal Web,5,807748,82.0,72,Soltero,38,2018,11,high,102116,Presencial,2.0,2,Mujer,Portal Web,4,1616000,94.0,76,Soltero,35,2018,12,high,-0.06999999999999984,0,-1,808252,50,0,-3,0
103077,102094,1,Presencial,5.185,1,Mujer,Referidos,5,277827,82.0,82,Soltero,42,2018,8,high,102095,Presencial,1.32,1,Hombre,Portal Web,4,998000,90.0,85,Casado,28,2016,2,high,-3.8649999999999993,0,-1,720173,-934,1,-14,0
103530,102048,1,Presencial,2.575,6,Hombre,Referidos,12,642018,82.0,77,Viudo,42,2015,7,high,102092,Presencial,3.99,0,Mujer,Portal Web,5,590000,59.0,76,Soltero,20,2015,8,low,1.415,-6,-7,-52018,34,0,-22,0
103090,102102,1,Presencial,3.31,11,Hombre,Linkedin,8,800231,82.0,85,Viudo,48,2018,1,high,102018,Presencial,2.48,0,Hombre,Portal Web,5,1616000,92.0,63,Viudo,49,2019,4,high,-0.8300000000000001,-11,-3,815769,459,0,1,0
103962,102109,1,Presencial,2.1,1,Hombre,Portal Web,6,921644,82.0,89,Casado,58,2021,1,high,102123,Presencial,3.86,1,Mujer,Portal Web,5,998000,97.0,82,Casado,32,2019,9,high,1.7599999999999998,0,-1,76356,-466,1,-26,1
100372,102111,1,Presencial,1.625,3,Mujer,Portal Web,1,141936,81.0,70,Soltero,20,2018,12,high,102097,Híbrida,2.04,1,Mujer,Referidos,15,1616000,94.0,67,Soltero,50,2021,5,high,0.41500000000000004,-2,14,1474064,884,0,30,0
101785,102049,1,Presencial,5.025,2,Hombre,Linkedin,3,186569,81.0,74,Casado,18,2015,2,high,102029,Presencial,6.89,0,Mujer,Portal Web,9,1616000,19.0,77,Divorciado,49,2023,3,low,1.8649999999999993,-2,6,1429431,2965,0,31,1
100897,102035,1,Presencial,1.35,1,Hombre,Portal Web,4,191919,81.0,77,Divorciado,16,2012,3,high,102041,Presencial,2.86,1,Hombre,Portal Web,23,1900000,83.0,72,Casado,57,2013,8,high,1.5099999999999998,0,19,1708081,516,0,41,0
101563,102156,1,Presencial,2.21,1,Hombre,Portal Web,6,365410,81.0,79,Soltero,35,2022,5,high,102154,Presencial,4.23,2,Hombre,Portal Web,22,1616000,92.0,76,Soltero,63,2023,12,high,2.0200000000000005,1,16,1250590,585,0,28,0
100045,102111,1,Presencial,5.645,1,Hombre,Ferias & Networking,5,720396,81.0,78,Casado,51,2019,9,high,102097,Híbrida,2.04,1,Mujer,Referidos,15,1616000,94.0,67,Soltero,50,2021,5,high,-3.6049999999999995,0,10,895604,621,0,-1,1
101467,102067,1,Presencial,1.75,1,Mujer,Portal Web,11,893799,81.0,70,Viudo,52,2017,6,high,102058,Presencial,0.92,1,Mujer,Portal Web,5,1616000,90.0,70,Divorciado,46,2020,8,high,-0.83,0,-6,722201,1180,0,-6,0
102668,102035,1,Presencial,1.375,1,Hombre,Portal Web,4,192261,81.0,77,Divorciado,16,2012,3,high,102041,Presencial,2.86,1,Hombre,Portal Web,23,1900000,83.0,72,Casado,57,2013,8,high,1.4849999999999999,0,19,1707739,514,0,41,0
102245,102159,1,Presencial,4.365,2,Hombre,Referidos,3,310700,81.0,68,Casado,32,2022,6,high,102120,Híbrida,0.98,2,Hombre,Referidos,14,808000,90.0,86,Soltero,44,2022,8,high,-3.3850000000000002,0,11,497300,58,0,12,0
102175,102031,1,Presencial,6.79,2,Hombre,Ferias & Networking,7,281759,81.0,77,Casado,37,2014,2,high,102111,Presencial,2.95,2,Hombre,Portal Web,8,1610000,76.0,87,Casado,31,2017,7,low,-3.84,0,1,1328241,1238,0,-6,0
103914,102054,1,Presencial,3.16,3,Mujer,Portal Web,8,299521,81.0,77,Soltero,38,2013,7,high,102044,Presencial,2.91,1,Hombre,Linkedin,17,1616000,85.0,74,Divorciado,41,2012,11,high,-0.25,-2,9,1316479,-260,1,3,1
103003,102111,1,Presencial,5.65,0,Hombre,Ferias & Networking,5,714685,81.0,78,Casado,51,2019,9,high,102097,Híbrida,2.04,1,Mujer,Referidos,15,1616000,94.0,67,Soltero,50,2021,5,high,-3.6100000000000003,1,10,901315,621,0,-1,0
101071,102088,1,Presencial,3.41,2,Hombre,Linkedin,1,99186,80.0,83,Soltero,16,2018,5,high,102139,Presencial,4.96,1,Mujer,Portal Web,3,488000,82.0,65,Soltero,20,2018,4,high,1.5499999999999998,-1,2,388814,-46,1,4,0
100763,102086,1,Presencial,3.655,1,Hombre,Portal Web,6,210510,80.0,78,Soltero,23,2017,5,high,102085,Presencial,2.22,2,Mujer,Linkedin,7,1306940,87.0,68,Divorciado,39,2021,3,high,-1.4349999999999996,1,1,1096430,1387,0,16,0
100280,102129,1,Presencial,6.57,2,Mujer,Ferias & Networking,9,430494,80.0,67,Casado,39,2023,1,high,102142,Presencial,2.1,2,Mujer,Linkedin,3,590000,41.0,74,Soltero,24,2020,1,low,-4.470000000000001,0,-6,159506,-1095,1,-15,0
100362,102034,1,Presencial,5.225,1,Mujer,Referidos,6,445509,80.0,64,Soltero,31,2014,1,high,102113,Presencial,7.84,7,Hombre,Linkedin,5,1564490,90.0,70,Casado,35,2012,9,high,2.615,6,-1,1118981,-475,1,4,0
102027,102065,2,Presencial,3.27,1,Mujer,Linkedin,8,1306940,80.0,80,Casado,32,2014,2,high,102026,Presencial,2.44,2,Hombre,Ferias & Networking,13,1616000,45.0,60,Divorciado,35,2014,10,low,-0.8300000000000001,1,5,309060,234,0,3,1
100882,102065,1,Presencial,1.395,3,Hombre,Portal Web,7,433548,80.0,69,Casado,39,2016,12,high,102026,Presencial,2.44,2,Hombre,Ferias & Networking,13,1616000,45.0,60,Divorciado,35,2014,10,low,1.045,-1,6,1182452,-813,1,-4,0
101469,102054,1,Presencial,3.14,2,Mujer,Portal Web,8,293969,80.0,77,Soltero,38,2013,7,high,102044,Presencial,2.91,1,Hombre,Linkedin,17,1616000,85.0,74,Divorciado,41,2012,11,high,-0.22999999999999998,-1,9,1322031,-261,1,3,1
100023,102101,1,Presencial,1.28,11,Hombre,Portal Web,15,306176,80.0,66,Divorciado,44,2017,10,high,102089,Presencial,6.23,0,Hombre,Portal Web,26,1616000,92.0,68,Divorciado,55,2014,1,high,4.95,-11,11,1309824,-1372,1,11,1
100132,102076,1,Presencial,3.795,2,Hombre,Portal Web,4,307837,80.0,67,Casado,41,2015,9,high,102168,Híbrida,1.95,1,Hombre,Referidos,9,1616000,95.0,82,Soltero,53,2023,9,high,-1.845,-1,5,1308163,2920,0,12,0
100979,102171,1,Presencial,2.23,1,Mujer,Linkedin,3,642745,80.0,70,Divorciado,50,2022,11,high,102088,Presencial,2.57,4,Hombre,Linkedin,8,1616000,80.0,69,Casado,43,2017,10,high,0.33999999999999986,3,5,973255,-1876,1,-7,1
100363,102057,1,Presencial,2.22,2,Mujer,Portal Web,11,638836,80.0,74,Divorciado,42,2014,9,high,102019,Presencial,1.97,4,Hombre,Portal Web,5,1616000,90.0,73,Viudo,59,2022,12,high,-0.2500000000000002,2,-6,977164,3011,0,17,1
102171,102088,2,Presencial,2.57,4,Hombre,Linkedin,8,1616000,80.0,69,Casado,43,2017,10,high,102139,Presencial,4.96,1,Mujer,Portal Web,3,488000,82.0,65,Soltero,20,2018,4,high,2.39,-3,-5,-1128000,189,0,-23,1
104074,102088,1,Presencial,3.4,2,Hombre,Linkedin,1,99040,80.0,83,Soltero,16,2018,5,high,102139,Presencial,4.96,1,Mujer,Portal Web,3,488000,82.0,65,Soltero,20,2018,4,high,1.56,-1,2,388960,-49,1,4,1
103781,102156,1,Presencial,1.485,2,Hombre,Portal Web,1,120679,80.0,87,Soltero,22,2023,4,high,102154,Presencial,4.23,2,Hombre,Portal Web,22,1616000,92.0,76,Soltero,63,2023,12,high,2.745,0,21,1495321,241,0,41,0
102815,102041,1,Presencial,5.12,2,Mujer,Referidos,3,117569,80.0,64,Soltero,14,2015,5,high,102147,Presencial,1.29,0,Mujer,Portal Web,8,1616000,44.0,73,Casado,51,2014,5,low,-3.83,-2,5,1498431,-351,1,37,0
102782,102109,1,Presencial,1.765,1,Mujer,Ferias & Networking,3,182659,80.0,80,Soltero,23,2020,8,high,102123,Presencial,3.86,1,Mujer,Portal Web,5,998000,97.0,82,Casado,32,2019,9,high,2.0949999999999998,0,2,815341,-312,1,9,0
103315,102049,1,Presencial,5.04,2,Hombre,Linkedin,3,187279,80.0,74,Casado,18,2015,2,high,102029,Presencial,6.89,0,Mujer,Portal Web,9,1616000,19.0,77,Divorciado,49,2023,3,low,1.8499999999999996,-2,6,1428721,2966,0,31,0
103770,102086,1,Presencial,3.615,1,Hombre,Portal Web,6,207710,80.0,78,Soltero,23,2017,5,high,102085,Presencial,2.22,2,Mujer,Linkedin,7,1306940,87.0,68,Divorciado,39,2021,3,high,-1.395,1,1,1099230,1386,0,16,1
102601,102035,1,Presencial,2.6,2,Hombre,Portal Web,7,352315,80.0,77,Casado,26,2014,9,high,102041,Presencial,2.86,1,Hombre,Portal Web,23,1900000,83.0,72,Casado,57,2013,8,high,0.2599999999999998,-1,16,1547685,-408,1,31,0
103142,102033,1,Presencial,2.725,1,Hombre,Portal Web,9,388595,80.0,81,Casado,26,2012,7,high,102172,Presencial,6.25,2,Mujer,Portal Web,16,1616000,90.0,79,Divorciado,39,2014,5,high,3.525,1,7,1227405,669,0,13,0
102621,102034,1,Presencial,5.23,0,Mujer,Referidos,6,452707,80.0,64,Soltero,31,2014,1,high,102113,Presencial,7.84,7,Hombre,Linkedin,5,1564490,90.0,70,Casado,35,2012,9,high,2.6099999999999994,7,-1,1111783,-475,1,4,0
103171,102106,1,Presencial,5.745,1,Hombre,Linkedin,5,468190,80.0,83,Soltero,37,2019,11,high,102081,Presencial,1.39,1,Mujer,Ferias & Networking,5,1049000,86.0,86,Soltero,32,2019,6,high,-4.355,0,0,580810,-170,1,-5,1
102678,102076,1,Presencial,3.795,3,Hombre,Portal Web,4,309483,80.0,67,Casado,41,2015,9,high,102168,Híbrida,1.95,1,Hombre,Referidos,9,1616000,95.0,82,Soltero,53,2023,9,high,-1.845,-2,5,1306517,2921,0,12,0
102282,102103,1,Presencial,1.82,2,Hombre,Referidos,7,641369,80.0,74,Soltero,46,2018,12,high,102023,Presencial,1.69,6,Hombre,Portal Web,3,1616000,90.0,74,Casado,45,2013,5,high,-0.13000000000000012,4,-4,974631,-2029,1,-1,0
103910,102057,1,Presencial,2.235,3,Mujer,Portal Web,11,637557,80.0,74,Divorciado,42,2014,9,high,102019,Presencial,1.97,4,Hombre,Portal Web,5,1616000,90.0,73,Viudo,59,2022,12,high,-0.2649999999999999,1,-6,978443,3009,0,17,1
103098,102106,1,Presencial,2.065,3,Hombre,Referidos,6,798235,80.0,70,Viudo,53,2019,10,high,102081,Presencial,1.39,1,Mujer,Ferias & Networking,5,1049000,86.0,86,Soltero,32,2019,6,high,-0.675,-2,-1,250765,-130,1,-21,0
101049,102156,1,Presencial,1.495,2,Hombre,Portal Web,1,123801,79.0,87,Soltero,22,2023,4,low,102154,Presencial,4.23,2,Hombre,Portal Web,22,1616000,92.0,76,Soltero,63,2023,12,high,2.7350000000000003,0,21,1492199,241,0,41,1
101219,102132,1,Presencial,2.83,14,Mujer,Linkedin,2,136298,79.0,72,Soltero,22,2022,1,low,102138,Presencial,4.51,1,Hombre,Linkedin,16,1616000,25.0,80,Viudo,45,2014,3,low,1.6799999999999997,-13,14,1479702,-2847,1,23,1
101067,102036,1,Presencial,1.07,2,Mujer,Portal Web,4,373198,79.0,79,Casado,25,2012,6,low,102054,Presencial,1.68,8,Hombre,Portal Web,5,1616000,92.0,76,Viudo,54,2022,1,high,0.6099999999999999,6,1,1242802,3487,0,29,0
100400,102128,1,Presencial,1.565,1,Mujer,Portal Web,4,453073,79.0,72,Casado,39,2021,7,low,102056,Presencial,4.11,10,Mujer,Portal Web,16,1616000,46.0,72,Soltero,55,2021,2,low,2.5450000000000004,9,12,1162927,-149,1,16,0
101273,102072,1,Presencial,1.815,2,Hombre,Portal Web,5,268655,79.0,84,Soltero,40,2017,9,low,102046,Presencial,2.61,2,Hombre,Ferias & Networking,3,947000,41.0,71,Soltero,30,2018,11,low,0.7949999999999999,0,-2,678345,448,0,-10,0
100442,102041,1,Presencial,2.205,1,Mujer,Linkedin,3,267015,79.0,78,Casado,34,2012,4,low,102147,Presencial,1.29,0,Mujer,Portal Web,8,1616000,44.0,73,Casado,51,2014,5,low,-0.915,-1,5,1348985,766,0,17,0
101034,102069,1,Presencial,3.6,5,Hombre,Linkedin,4,682171,79.0,83,Viudo,44,2015,1,low,102069,Presencial,4.64,1,Mujer,Ferias & Networking,19,1616000,47.0,74,Casado,60,2021,10,low,1.0399999999999996,-4,15,933829,2486,0,16,0
100029,102169,1,Presencial,1.74,1,Mujer,Referidos,13,738625,79.0,75,Divorciado,55,2023,3,low,102115,Presencial,2.24,7,Mujer,Linkedin,11,1616000,93.0,74,Soltero,55,2021,4,high,0.5000000000000002,6,-2,877375,-703,1,0,0
100774,102078,1,Presencial,2.325,1,Mujer,Referidos,4,739604,79.0,83,Viudo,49,2017,4,low,102143,Presencial,2.17,1,Hombre,Ferias & Networking,9,998000,83.0,76,Casado,29,2017,5,high,-0.15500000000000025,0,5,258396,52,0,-20,0
101420,102108,1,Presencial,4.6,1,Hombre,Linkedin,14,916659,79.0,80,Divorciado,55,2018,4,low,102040,Presencial,2.92,1,Mujer,Portal Web,5,1616000,46.0,75,Casado,50,2023,5,low,-1.6799999999999997,0,-9,699341,1864,0,-5,0
103736,102049,1,Presencial,6.04,3,Hombre,Ferias & Networking,1,122832,79.0,78,Soltero,12,2013,6,low,102029,Presencial,6.89,0,Mujer,Portal Web,9,1616000,19.0,77,Divorciado,49,2023,3,low,0.8499999999999996,-3,8,1493168,3548,0,37,1
103676,102153,1,Presencial,5.875,1,Mujer,Portal Web,6,228661,79.0,78,Soltero,28,2022,8,low,102143,Presencial,6.39,1,Mujer,Linkedin,5,1616000,90.0,68,Casado,41,2019,6,high,0.5149999999999997,0,-1,1387339,-1152,1,13,0
102787,102101,1,Presencial,1.26,12,Hombre,Portal Web,15,307379,79.0,66,Divorciado,44,2017,10,low,102089,Presencial,6.23,0,Hombre,Portal Web,26,1616000,92.0,68,Divorciado,55,2014,1,high,4.970000000000001,-12,11,1308621,-1372,1,11,0
102283,102031,1,Presencial,5.4,0,Hombre,Ferias & Networking,5,700010,79.0,79,Soltero,43,2013,1,low,102111,Presencial,2.95,2,Hombre,Portal Web,8,1610000,76.0,87,Casado,31,2017,7,low,-2.45,2,3,909990,1615,0,-12,0
103106,102078,1,Presencial,2.34,1,Mujer,Referidos,4,738413,79.0,83,Viudo,49,2017,4,low,102143,Presencial,2.17,1,Hombre,Ferias & Networking,9,998000,83.0,76,Casado,29,2017,5,high,-0.16999999999999993,0,5,259587,52,0,-20,1
101327,102059,1,Presencial,5.785,0,Hombre,Ferias & Networking,2,101480,78.0,77,Soltero,15,2017,1,low,102021,Presencial,2.55,2,Hombre,Portal Web,16,1616000,27.0,76,Viudo,50,2019,6,low,-3.2350000000000003,2,14,1514520,883,0,35,0
101223,102049,1,Presencial,2.48,1,Mujer,Referidos,2,117721,78.0,85,Soltero,14,2014,11,low,102029,Presencial,6.89,0,Mujer,Portal Web,9,1616000,19.0,77,Divorciado,49,2023,3,low,4.41,-1,7,1498279,3059,0,35,0
101537,102124,1,Presencial,3.515,2,Mujer,Portal Web,1,164273,78.0,61,Soltero,24,2021,4,low,102099,Presencial,2.84,2,Mujer,Linkedin,4,947000,90.0,70,Soltero,24,2012,10,high,-0.6750000000000003,0,3,782727,-3099,1,0,0
101060,102161,1,Presencial,2.14,13,Hombre,Linkedin,2,181063,78.0,79,Soltero,27,2023,6,low,102039,Presencial,3.93,5,Mujer,Portal Web,4,1409960,85.0,77,Casado,36,2016,10,high,1.79,-8,2,1228897,-2420,1,9,1
100490,102153,1,Presencial,5.86,1,Mujer,Portal Web,6,233959,78.0,78,Soltero,28,2022,8,low,102143,Presencial,6.39,1,Mujer,Linkedin,5,1616000,90.0,68,Casado,41,2019,6,high,0.5299999999999994,0,-1,1382041,-1151,1,13,0
100409,102129,1,Presencial,1.22,2,Hombre,Portal Web,6,292105,78.0,71,Casado,30,2021,3,low,102142,Presencial,2.1,2,Mujer,Linkedin,3,590000,41.0,74,Soltero,24,2020,1,low,0.8800000000000001,0,-3,297895,-430,1,-6,0
101294,102066,1,Presencial,1.725,3,Mujer,Portal Web,6,290069,78.0,84,Soltero,25,2016,5,low,102171,Presencial,3.62,3,Hombre,Referidos,5,1616000,97.0,84,Casado,55,2023,12,high,1.895,0,-1,1325931,2759,0,30,1
101484,102044,1,Presencial,1.395,0,Hombre,Linkedin,3,289841,78.0,81,Soltero,22,2013,3,low,102155,Presencial,1.54,1,Hombre,Ferias & Networking,14,1616000,56.0,68,Soltero,47,2023,3,low,0.14500000000000002,1,11,1326159,3649,0,25,0
100814,102123,1,Presencial,2.485,10,Hombre,Linkedin,6,308121,78.0,69,Soltero,30,2019,11,low,102043,Presencial,5.5,1,Mujer,Linkedin,16,1616000,42.0,66,Soltero,51,2021,9,low,3.015,-9,10,1307879,687,0,21,1
100262,102100,1,Presencial,2.38,3,Mujer,Linkedin,4,408396,78.0,71,Soltero,34,2019,2,low,102007,Presencial,3.3,1,Mujer,Portal Web,3,1255430,21.0,59,Casado,30,2013,2,low,0.9199999999999999,-2,-1,847034,-2195,1,-4,1
100150,102124,1,Presencial,4.26,1,Mujer,Linkedin,3,430564,78.0,77,Casado,36,2019,10,low,102099,Presencial,2.84,2,Mujer,Linkedin,4,947000,90.0,70,Soltero,24,2012,10,high,-1.42,1,1,516436,-2548,1,-12,0
101248,102122,1,Presencial,2.265,1,Mujer,Linkedin,8,275455,78.0,63,Divorciado,44,2021,2,low,102075,Presencial,1.83,4,Hombre,Portal Web,6,1616000,90.0,66,Viudo,48,2019,3,high,-0.43500000000000005,3,-2,1340545,-688,1,4,1
101561,102110,1,Presencial,1.005,2,Hombre,Ferias & Networking,5,275577,78.0,72,Soltero,42,2018,8,low,102045,Presencial,1.6,5,Mujer,Linkedin,2,998000,87.0,76,Soltero,29,2016,11,high,0.5950000000000002,3,-3,722423,-637,1,-13,1
100567,102076,1,Presencial,5.25,1,Hombre,Portal Web,9,634466,78.0,82,Viudo,44,2016,4,low,102168,Híbrida,1.95,1,Hombre,Referidos,9,1616000,95.0,82,Soltero,53,2023,9,high,-3.3,0,0,981534,2711,0,9,0
101839,102139,1,Presencial,2.15,0,Mujer,Linkedin,11,698796,78.0,72,Viudo,52,2022,2,low,102154,Presencial,6.48,1,Hombre,Ferias & Networking,5,590000,90.0,67,Casado,25,2021,6,high,4.33,1,-6,-108796,-242,1,-27,0
102170,102055,2,Presencial,1.62,0,Mujer,Portal Web,8,1616000,78.0,72,Viudo,48,2013,2,low,102129,Presencial,1.92,2,Hombre,Referidos,8,1616000,97.0,63,Casado,42,2013,2,high,0.2999999999999998,2,0,0,3,0,-6,1
103085,102055,1,Presencial,1.28,1,Hombre,Portal Web,1,103518,78.0,84,Soltero,15,2016,5,low,102129,Presencial,1.92,2,Hombre,Referidos,8,1616000,97.0,63,Casado,42,2013,2,high,0.6399999999999999,1,7,1512482,-1172,1,27,0
103105,102049,1,Presencial,6.32,9,Mujer,Linkedin,1,100236,78.0,76,Soltero,12,2013,10,low,102029,Presencial,6.89,0,Mujer,Portal Web,9,1616000,19.0,77,Divorciado,49,2023,3,low,0.5699999999999994,-9,8,1515764,3432,0,37,1
103695,102126,1,Presencial,5.495,1,Hombre,Portal Web,2,144375,78.0,83,Soltero,22,2020,8,low,102141,Presencial,2.5,1,Mujer,Referidos,2,1049000,94.0,79,Casado,34,2021,1,high,-2.995,0,0,904625,162,0,12,1
103881,102161,1,Presencial,2.125,12,Hombre,Linkedin,2,184766,78.0,79,Soltero,27,2023,6,low,102039,Presencial,3.93,5,Mujer,Portal Web,4,1409960,85.0,77,Casado,36,2016,10,high,1.8050000000000002,-7,2,1225194,-2420,1,9,1
103728,102016,1,Presencial,1.92,2,Mujer,Portal Web,6,271582,78.0,83,Soltero,20,2012,11,low,102008,Híbrida,2.51,2,Mujer,Portal Web,6,1616000,40.0,80,Casado,44,2017,8,low,0.5899999999999999,0,0,1344418,1758,0,24,0
102349,102044,1,Presencial,1.38,0,Hombre,Linkedin,3,286836,78.0,81,Soltero,22,2013,3,low,102155,Presencial,1.54,1,Hombre,Ferias & Networking,14,1616000,56.0,68,Soltero,47,2023,3,low,0.16000000000000014,1,11,1329164,3648,0,25,0
102801,102141,1,Presencial,7.755,1,Mujer,Portal Web,6,350759,78.0,72,Soltero,32,2020,8,low,102134,Presencial,1.88,1,Mujer,Linkedin,3,1100900,64.0,69,Soltero,32,2018,5,low,-5.875,0,-3,750141,-803,1,0,0
102705,102040,1,Presencial,2.41,3,Hombre,Linkedin,4,372186,78.0,75,Casado,25,2012,3,low,102106,Presencial,3.21,1,Hombre,Linkedin,15,1616000,91.0,84,Soltero,45,2016,7,high,0.7999999999999998,-2,11,1243814,1576,0,20,0
102439,102041,1,Presencial,2.745,0,Mujer,Portal Web,2,387041,78.0,74,Casado,28,2013,9,low,102147,Presencial,1.29,0,Mujer,Portal Web,8,1616000,44.0,73,Casado,51,2014,5,low,-1.455,0,6,1228959,236,0,23,0
102892,102100,1,Presencial,2.405,3,Mujer,Linkedin,4,404773,78.0,71,Soltero,34,2019,2,low,102007,Presencial,3.3,1,Mujer,Portal Web,3,1255430,21.0,59,Casado,30,2013,2,low,0.895,-2,-1,850657,-2195,1,-4,1
102411,102124,1,Presencial,4.285,1,Mujer,Linkedin,3,427201,78.0,77,Casado,36,2019,10,low,102099,Presencial,2.84,2,Mujer,Linkedin,4,947000,90.0,70,Soltero,24,2012,10,high,-1.4450000000000003,1,1,519799,-2550,1,-12,1
102647,102111,1,Presencial,5.55,7,Mujer,Portal Web,3,425041,78.0,80,Casado,35,2018,12,low,102097,Híbrida,2.04,1,Mujer,Referidos,15,1616000,94.0,67,Soltero,50,2021,5,high,-3.51,-6,12,1190959,895,0,15,0
102310,102037,1,Presencial,5.125,3,Mujer,Ferias & Networking,9,449080,78.0,68,Casado,31,2014,10,low,102057,Presencial,1.12,1,Mujer,Linkedin,2,641000,50.0,76,Casado,21,2016,12,low,-4.005,-2,-7,191920,777,0,-10,0
104133,102141,1,Presencial,3.31,2,Hombre,Linkedin,12,491633,78.0,62,Soltero,41,2021,11,low,102134,Presencial,1.88,1,Mujer,Linkedin,3,1100900,64.0,69,Soltero,32,2018,5,low,-1.4300000000000002,-1,-9,609267,-1282,1,-9,0
102732,102070,1,Presencial,2.79,7,Mujer,Portal Web,5,275840,78.0,72,Casado,40,2017,1,low,102035,Presencial,1.7,1,Mujer,Referidos,4,1616000,77.0,73,Viudo,38,2013,3,low,-1.09,-6,-1,1340160,-1419,1,-2,0
103165,102070,1,Presencial,2.255,2,Mujer,Portal Web,10,292064,78.0,74,Soltero,39,2015,4,low,102035,Presencial,1.7,1,Mujer,Referidos,4,1616000,77.0,73,Viudo,38,2013,3,low,-0.5549999999999999,-1,-6,1323936,-763,1,-1,0
103145,102069,1,Presencial,1.92,1,Mujer,Linkedin,13,303520,78.0,74,Divorciado,40,2014,7,low,102069,Presencial,4.64,1,Mujer,Ferias & Networking,19,1616000,47.0,74,Casado,60,2021,10,low,2.7199999999999998,0,6,1312480,2645,0,20,0
103656,102022,1,Presencial,2.065,1,Mujer,Portal Web,5,674537,78.0,70,Viudo,42,2012,10,low,102081,Presencial,2.07,0,Hombre,Portal Web,6,1616000,94.0,66,Viudo,47,2020,5,high,0.004999999999999893,-1,1,941463,2795,0,5,0
103458,102146,1,Presencial,1.64,3,Hombre,Portal Web,8,738801,78.0,75,Casado,54,2021,10,low,102035,Presencial,2.66,0,Mujer,Portal Web,15,1616000,77.0,78,Casado,39,2013,10,low,1.0200000000000002,-3,7,877199,-2920,1,-15,1
103396,102040,1,Presencial,1.64,7,Mujer,Portal Web,10,897472,78.0,72,Divorciado,45,2012,6,low,102106,Presencial,3.21,1,Hombre,Linkedin,15,1616000,91.0,84,Soltero,45,2016,7,high,1.57,-6,5,718528,1499,0,0,0
103438,102096,1,Presencial,4.955,1,Hombre,Ferias & Networking,11,920051,78.0,80,Soltero,53,2019,4,low,102116,Presencial,5.11,8,Mujer,Linkedin,13,1461470,90.0,74,Soltero,42,2021,5,high,0.15500000000000025,7,2,541419,749,0,-11,0
100522,102078,1,Presencial,1.975,1,Hombre,Referidos,5,185650,77.0,78,Soltero,22,2018,2,low,102143,Presencial,2.17,1,Hombre,Ferias & Networking,9,998000,83.0,76,Casado,29,2017,5,high,0.19499999999999984,0,4,812350,-268,1,7,0
100160,102040,1,Presencial,6.8,3,Hombre,Ferias & Networking,5,247545,77.0,80,Casado,21,2013,10,low,102106,Presencial,3.21,1,Hombre,Linkedin,15,1616000,91.0,84,Soltero,45,2016,7,high,-3.59,-2,10,1368455,1021,0,24,0
100312,102111,1,Presencial,1.84,3,Mujer,Portal Web,3,329702,77.0,77,Casado,31,2019,8,low,102097,Híbrida,2.04,1,Mujer,Referidos,15,1616000,94.0,67,Soltero,50,2021,5,high,0.19999999999999996,-2,12,1286298,636,0,19,0
100835,102141,1,Presencial,7.725,2,Mujer,Portal Web,6,345319,77.0,72,Soltero,32,2020,8,low,102134,Presencial,1.88,1,Mujer,Linkedin,3,1100900,64.0,69,Soltero,32,2018,5,low,-5.845,-1,-3,755581,-803,1,0,1
101624,102040,1,Presencial,1.71,7,Mujer,Linkedin,7,370758,77.0,70,Soltero,28,2015,7,low,102106,Presencial,3.21,1,Hombre,Linkedin,15,1616000,91.0,84,Soltero,45,2016,7,high,1.5,-6,8,1245242,386,0,17,0
100137,102137,1,Presencial,1.265,0,Hombre,Portal Web,6,373293,77.0,62,Soltero,34,2021,1,low,102046,Presencial,1.18,0,Mujer,Portal Web,2,845000,37.0,79,Casado,27,2017,12,low,-0.08499999999999996,0,-4,471707,-1108,1,-7,1
101783,102041,1,Presencial,2.745,1,Mujer,Linkedin,3,387158,77.0,74,Casado,27,2013,9,low,102147,Presencial,1.29,0,Mujer,Portal Web,8,1616000,44.0,73,Casado,51,2014,5,low,-1.455,-1,5,1228842,236,0,24,0
100093,102114,1,Presencial,0.225,2,Mujer,Linkedin,4,828359,77.0,75,Soltero,37,2020,8,low,102050,Presencial,1.44,1,Mujer,Portal Web,5,1616000,91.0,69,Divorciado,47,2021,5,high,1.2149999999999999,-1,1,787641,289,0,10,0
101678,102111,1,Presencial,5.515,6,Mujer,Portal Web,3,429269,77.0,80,Casado,35,2018,12,low,102097,Híbrida,2.04,1,Mujer,Referidos,15,1616000,94.0,67,Soltero,50,2021,5,high,-3.4749999999999996,-5,12,1186731,895,0,15,0
101440,102037,1,Presencial,5.125,3,Mujer,Ferias & Networking,9,445786,77.0,68,Casado,31,2014,10,low,102057,Presencial,1.12,1,Mujer,Linkedin,2,641000,50.0,76,Casado,21,2016,12,low,-4.005,-2,-7,195214,778,0,-10,0
100648,102119,1,Presencial,3.53,3,Mujer,Referidos,6,259696,77.0,69,Casado,40,2018,12,low,102107,Presencial,2.22,2,Hombre,Portal Web,12,1616000,38.0,70,Divorciado,52,2021,1,low,-1.3099999999999996,-1,6,1356304,752,0,12,0
100106,102070,1,Presencial,2.8,7,Mujer,Portal Web,5,275494,77.0,72,Casado,40,2017,1,low,102035,Presencial,1.7,1,Mujer,Referidos,4,1616000,77.0,73,Viudo,38,2013,3,low,-1.0999999999999999,-6,-1,1340506,-1421,1,-2,0
100144,102133,1,Presencial,2.825,1,Hombre,Ferias & Networking,7,298131,77.0,74,Viudo,46,2021,5,low,102151,Híbrida,2.61,2,Hombre,Linkedin,4,1255430,98.0,65,Soltero,35,2018,2,high,-0.2150000000000003,1,-3,957299,-1173,1,-11,0
101709,102089,1,Presencial,1.39,1,Hombre,Referidos,8,309437,77.0,85,Divorciado,44,2018,10,low,102077,Presencial,2.75,1,Hombre,Ferias & Networking,6,1616000,96.0,69,Divorciado,60,2021,10,high,1.36,0,-2,1306563,1083,0,16,0
101659,102114,1,Presencial,3.585,1,Mujer,Portal Web,4,308810,77.0,77,Divorciado,44,2018,9,low,102050,Presencial,1.44,1,Mujer,Portal Web,5,1616000,91.0,69,Divorciado,47,2021,5,high,-2.145,0,1,1307190,972,0,3,0
102010,102035,2,Presencial,2.02,0,Mujer,Linkedin,5,1564490,77.0,73,Casado,44,2021,8,low,102041,Presencial,2.86,1,Hombre,Portal Web,23,1900000,83.0,72,Casado,57,2013,8,high,0.8399999999999999,1,18,335510,-2925,1,13,0
102146,102035,2,Presencial,2.66,0,Mujer,Portal Web,15,1616000,77.0,78,Casado,39,2013,10,low,102041,Presencial,2.86,1,Hombre,Portal Web,23,1900000,83.0,72,Casado,57,2013,8,high,0.19999999999999973,1,8,284000,-75,1,18,0
102070,102035,2,Presencial,1.7,1,Mujer,Referidos,4,1616000,77.0,73,Viudo,38,2013,3,low,102041,Presencial,2.86,1,Hombre,Portal Web,23,1900000,83.0,72,Casado,57,2013,8,high,1.16,0,19,284000,148,0,19,0
101460,102035,1,Presencial,1.985,1,Hombre,Portal Web,16,821278,77.0,78,Soltero,44,2013,11,low,102041,Presencial,2.86,1,Hombre,Portal Web,23,1900000,83.0,72,Casado,57,2013,8,high,0.8749999999999998,0,7,1078722,-112,1,13,0
101406,102146,1,Presencial,1.645,2,Hombre,Portal Web,8,738056,77.0,75,Casado,54,2021,10,low,102035,Presencial,2.66,0,Mujer,Portal Web,15,1616000,77.0,78,Casado,39,2013,10,low,1.0150000000000001,-2,7,877944,-2918,1,-15,0
101788,102069,1,Presencial,1.625,3,Mujer,Ferias & Networking,9,840026,77.0,66,Soltero,49,2016,2,low,102069,Presencial,4.64,1,Mujer,Ferias & Networking,19,1616000,47.0,74,Casado,60,2021,10,low,3.0149999999999997,-2,10,775974,2089,0,11,0
103064,102059,1,Presencial,5.775,1,Hombre,Ferias & Networking,2,96316,77.0,77,Soltero,15,2017,1,low,102021,Presencial,2.55,2,Hombre,Portal Web,16,1616000,27.0,76,Viudo,50,2019,6,low,-3.2250000000000005,1,14,1519684,882,0,35,0
102915,102110,1,Presencial,7.07,0,Mujer,Portal Web,2,116237,77.0,77,Soltero,17,2018,4,low,102045,Presencial,1.6,5,Mujer,Linkedin,2,998000,87.0,76,Soltero,29,2016,11,high,-5.470000000000001,5,0,881763,-517,1,12,0
102582,102049,1,Presencial,2.52,2,Mujer,Referidos,2,122530,77.0,85,Soltero,14,2014,11,low,102029,Presencial,6.89,0,Mujer,Portal Web,9,1616000,19.0,77,Divorciado,49,2023,3,low,4.369999999999999,-2,7,1493470,3057,0,35,0
103833,102067,1,Presencial,1.245,8,Hombre,Linkedin,3,233426,77.0,75,Divorciado,20,2014,8,low,102058,Presencial,0.92,1,Mujer,Portal Web,5,1616000,90.0,70,Divorciado,46,2020,8,high,-0.32500000000000007,-7,2,1382574,2211,0,26,0
103535,102062,1,Presencial,2.245,0,Hombre,Linkedin,5,227725,77.0,75,Soltero,21,2014,8,low,102149,Presencial,0.92,2,Mujer,Referidos,6,692000,38.0,72,Soltero,21,2014,10,low,-1.3250000000000002,2,1,464275,57,0,0,1
103743,102172,1,Presencial,2.155,1,Mujer,Ferias & Networking,4,249310,77.0,75,Casado,30,2022,8,low,102020,Presencial,5.58,1,Hombre,Portal Web,7,1049000,57.0,70,Casado,29,2016,4,low,3.4250000000000003,0,3,799690,-2305,1,-1,1
102615,102040,1,Presencial,6.805,2,Hombre,Ferias & Networking,5,246872,77.0,80,Casado,20,2013,10,low,102106,Presencial,3.21,1,Hombre,Linkedin,15,1616000,91.0,84,Soltero,45,2016,7,high,-3.5949999999999998,-1,10,1369128,1023,0,25,0
102653,102168,1,Presencial,4.41,1,Hombre,Portal Web,5,385794,77.0,74,Soltero,37,2023,3,low,102172,Presencial,6.22,1,Hombre,Referidos,15,1616000,75.0,68,Viudo,42,2012,1,low,1.8099999999999996,0,10,1230206,-4095,1,5,0
103605,102137,1,Presencial,2.205,1,Mujer,Portal Web,7,385124,77.0,83,Casado,34,2020,10,low,102046,Presencial,1.18,0,Mujer,Portal Web,2,845000,37.0,79,Casado,27,2017,12,low,-1.0250000000000001,-1,-5,459876,-1022,1,-7,0
102341,102151,1,Presencial,3.63,2,Hombre,Ferias & Networking,8,424546,77.0,78,Casado,37,2021,11,low,102105,Presencial,1.51,2,Hombre,Ferias & Networking,10,1616000,85.0,80,Divorciado,45,2021,11,high,-2.12,0,2,1191454,0,1,8,0
103596,102110,1,Presencial,1.0,2,Hombre,Ferias & Networking,5,279098,77.0,72,Soltero,42,2018,8,low,102045,Presencial,1.6,5,Mujer,Linkedin,2,998000,87.0,76,Soltero,29,2016,11,high,0.6000000000000001,3,-3,718902,-638,1,-13,1
102244,102075,1,Presencial,1.725,1,Hombre,Portal Web,13,297808,77.0,81,Viudo,43,2018,3,low,102047,Presencial,2.7,1,Hombre,Referidos,11,1255430,90.0,76,Casado,30,2013,3,high,0.9750000000000001,0,-2,957622,-1829,1,-13,0
102180,102076,1,Presencial,5.29,0,Hombre,Portal Web,7,638066,77.0,82,Viudo,43,2016,4,low,102168,Híbrida,1.95,1,Hombre,Referidos,9,1616000,95.0,82,Soltero,53,2023,9,high,-3.34,1,2,977934,2710,0,10,0
102206,102031,1,Presencial,1.895,1,Hombre,Portal Web,7,677126,77.0,82,Divorciado,43,2014,7,low,102111,Presencial,2.95,2,Hombre,Portal Web,8,1610000,76.0,87,Casado,31,2017,7,low,1.0550000000000002,1,1,932874,1082,0,-12,0
103081,102068,1,Presencial,2.04,1,Mujer,Portal Web,9,718339,77.0,79,Casado,47,2016,8,low,102043,Híbrida,2.17,3,Mujer,Referidos,4,896000,41.0,81,Soltero,23,2012,8,low,0.1299999999999999,2,-5,177661,-1448,1,-24,0
103255,102069,1,Presencial,1.62,3,Mujer,Ferias & Networking,9,838800,77.0,66,Casado,49,2016,2,low,102069,Presencial,4.64,1,Mujer,Ferias & Networking,19,1616000,47.0,74,Casado,60,2021,10,low,3.0199999999999996,-2,10,777200,2087,0,11,0
100899,102172,1,Presencial,1.37,6,Hombre,Portal Web,2,81057,76.0,72,Soltero,20,2023,2,low,102020,Presencial,5.58,1,Hombre,Portal Web,7,1049000,57.0,70,Casado,29,2016,4,low,4.21,-5,5,967943,-2481,1,9,0
101038,102097,1,Presencial,1.675,9,Mujer,Portal Web,1,122980,76.0,74,Soltero,16,2017,3,low,102024,Presencial,1.95,6,Hombre,Portal Web,4,1100900,57.0,77,Soltero,31,2016,10,low,0.2749999999999999,-3,3,977920,-139,1,15,1
101682,102098,1,Presencial,4.72,0,Hombre,Headhunter,2,141222,76.0,75,Soltero,19,2018,8,low,102049,Presencial,1.8,1,Mujer,Portal Web,16,1616000,90.0,86,Casado,46,2021,1,high,-2.92,1,14,1474778,900,0,27,0
100275,102046,1,Presencial,7.01,2,Hombre,Portal Web,4,147511,76.0,72,Soltero,16,2015,1,low,102007,Presencial,1.68,0,Mujer,Portal Web,8,1616000,41.0,71,Soltero,50,2015,10,low,-5.33,-2,4,1468489,291,0,34,1
100717,102137,1,Presencial,2.185,1,Mujer,Portal Web,7,385791,76.0,83,Casado,35,2020,10,low,102046,Presencial,1.18,0,Mujer,Portal Web,2,845000,37.0,79,Casado,27,2017,12,low,-1.0050000000000001,-1,-5,459209,-1022,1,-8,0
100747,102120,1,Presencial,2.51,2,Mujer,Ferias & Networking,5,393173,76.0,69,Soltero,34,2020,3,low,102171,Presencial,6.48,2,Hombre,Ferias & Networking,9,1616000,80.0,71,Casado,47,2023,8,high,3.9700000000000006,0,4,1222827,1236,0,13,1
100877,102142,1,Presencial,2.915,1,Mujer,Referidos,7,426080,76.0,86,Casado,38,2022,12,low,102047,Presencial,2.48,2,Hombre,Portal Web,3,1255430,90.0,66,Soltero,36,2019,7,high,-0.43500000000000005,1,-4,829350,-1258,1,-2,0
102031,102111,2,Presencial,2.95,2,Hombre,Portal Web,8,1610000,76.0,87,Casado,31,2017,7,low,102097,Híbrida,2.04,1,Mujer,Referidos,15,1616000,94.0,67,Soltero,50,2021,5,high,-0.9100000000000001,-1,7,6000,1411,0,19,1
100027,102111,1,Presencial,4.325,1,Hombre,Linkedin,4,466435,76.0,87,Casado,36,2018,4,low,102097,Híbrida,2.04,1,Mujer,Referidos,15,1616000,94.0,67,Soltero,50,2021,5,high,-2.285,0,11,1149565,1139,0,14,0
100513,102111,1,Presencial,5.545,2,Mujer,Linkedin,3,257397,76.0,69,Casado,41,2019,11,low,102097,Híbrida,2.04,1,Mujer,Referidos,15,1616000,94.0,67,Soltero,50,2021,5,high,-3.505,-1,12,1358603,559,0,9,0
100267,102021,1,Presencial,2.475,1,Hombre,Linkedin,10,401939,76.0,66,Casado,36,2013,9,low,102069,Presencial,2.25,1,Hombre,Linkedin,8,1616000,47.0,80,Casado,52,2017,3,low,-0.2250000000000001,0,-2,1214061,1282,0,16,0
100710,102071,1,Presencial,6.25,0,Mujer,Ferias & Networking,5,444629,76.0,59,Casado,41,2017,10,low,102171,Presencial,0.87,1,Hombre,Portal Web,11,1616000,85.0,72,Viudo,51,2023,11,high,-5.38,1,6,1171371,2232,0,10,0
101636,102058,1,Presencial,3.58,1,Hombre,Referidos,7,837526,76.0,78,Soltero,44,2016,7,low,102172,Presencial,1.4,2,Hombre,Ferias & Networking,11,1616000,75.0,71,Casado,59,2021,2,low,-2.18,1,4,778474,1675,0,15,0
100955,102066,1,Presencial,1.65,1,Hombre,Referidos,3,679158,76.0,69,Viudo,43,2014,5,low,102171,Presencial,3.62,3,Hombre,Referidos,5,1616000,97.0,84,Casado,55,2023,12,high,1.9700000000000002,2,2,936842,3488,0,12,0
100429,102123,1,Presencial,1.58,1,Mujer,Ferias & Networking,18,722463,76.0,75,Casado,52,2021,1,low,102043,Presencial,5.5,1,Mujer,Linkedin,16,1616000,42.0,66,Soltero,51,2021,9,low,3.92,0,-2,893537,252,0,-1,0
100146,102044,1,Presencial,4.33,2,Hombre,Linkedin,5,919389,76.0,65,Casado,48,2014,5,low,102155,Presencial,1.54,1,Hombre,Ferias & Networking,14,1616000,56.0,68,Soltero,47,2023,3,low,-2.79,-1,9,696611,3243,0,-1,0
102099,102080,2,Presencial,1.71,0,Hombre,Portal Web,11,1616000,76.0,80,Viudo,51,2021,10,low,102035,Presencial,1.93,0,Mujer,Linkedin,18,1616000,94.0,75,Viudo,47,2016,8,high,0.21999999999999997,0,7,0,-1879,1,-4,1
104014,102080,1,Presencial,2.68,3,Hombre,Linkedin,3,146458,76.0,78,Soltero,20,2018,12,low,102035,Presencial,1.93,0,Mujer,Linkedin,18,1616000,94.0,75,Viudo,47,2016,8,high,-0.7500000000000002,-3,15,1469542,-852,1,27,1
102748,102076,1,Presencial,2.14,2,Hombre,Portal Web,4,213058,76.0,72,Casado,21,2016,4,low,102168,Híbrida,1.95,1,Hombre,Referidos,9,1616000,95.0,82,Soltero,53,2023,9,high,-0.19000000000000017,-1,5,1402942,2696,0,32,0
103478,102035,1,Presencial,5.06,2,Mujer,Portal Web,4,345507,76.0,71,Casado,26,2014,1,low,102041,Presencial,2.86,1,Hombre,Portal Web,23,1900000,83.0,72,Casado,57,2013,8,high,-2.1999999999999997,-1,19,1554493,-169,1,31,0
104004,102120,1,Presencial,2.52,2,Mujer,Ferias & Networking,5,385712,76.0,69,Soltero,34,2020,3,low,102171,Presencial,6.48,2,Hombre,Ferias & Networking,9,1616000,80.0,71,Casado,47,2023,8,high,3.9600000000000004,0,4,1230288,1234,0,13,1
103831,102138,1,Presencial,2.97,6,Mujer,Portal Web,4,412893,76.0,71,Soltero,36,2020,12,low,102059,Presencial,3.26,1,Hombre,Linkedin,5,1616000,57.0,75,Soltero,44,2018,4,low,0.2899999999999996,-5,1,1203107,-995,1,8,1
103104,102142,1,Presencial,2.91,1,Mujer,Referidos,7,426050,76.0,86,Casado,39,2022,12,low,102047,Presencial,2.48,2,Hombre,Portal Web,3,1255430,90.0,66,Soltero,36,2019,7,high,-0.43000000000000016,1,-4,829380,-1261,1,-3,0
103236,102087,1,Presencial,1.195,2,Mujer,Portal Web,4,804977,76.0,79,Casado,35,2018,6,low,102111,Presencial,7.16,9,Mujer,Linkedin,10,1616000,98.0,79,Casado,42,2012,5,high,5.965,7,6,811023,-2222,1,7,0
102612,102073,1,Presencial,5.445,2,Hombre,Portal Web,4,449192,76.0,72,Casado,34,2017,2,low,102139,Presencial,1.98,2,Hombre,Portal Web,11,1306940,95.0,86,Soltero,37,2019,7,high,-3.4650000000000003,0,7,857748,863,0,3,0
102608,102132,1,Presencial,2.845,0,Hombre,Linkedin,4,468320,76.0,79,Soltero,38,2019,12,low,102138,Presencial,4.51,1,Hombre,Linkedin,16,1616000,25.0,80,Viudo,45,2014,3,low,1.6649999999999996,1,12,1147680,-2103,1,7,0
102750,102071,1,Presencial,6.28,1,Mujer,Ferias & Networking,5,446936,76.0,59,Casado,41,2017,9,low,102171,Presencial,0.87,1,Hombre,Portal Web,11,1616000,85.0,72,Viudo,51,2023,11,high,-5.41,0,6,1169064,2233,0,10,0
102522,102133,1,Presencial,2.825,1,Hombre,Ferias & Networking,7,300722,76.0,74,Viudo,46,2021,5,low,102151,Híbrida,2.61,2,Hombre,Linkedin,4,1255430,98.0,65,Soltero,35,2018,2,high,-0.2150000000000003,1,-3,954708,-1171,1,-11,0
104117,102100,1,Presencial,1.78,1,Hombre,Ferias & Networking,10,388225,76.0,83,Soltero,44,2019,7,low,102007,Presencial,3.3,1,Mujer,Portal Web,3,1255430,21.0,59,Casado,30,2013,2,low,1.5199999999999998,0,-7,867205,-2349,1,-14,1
102539,102066,1,Presencial,1.655,1,Hombre,Referidos,3,675741,76.0,69,Viudo,44,2014,5,low,102171,Presencial,3.62,3,Hombre,Referidos,5,1616000,97.0,84,Casado,55,2023,12,high,1.965,2,2,940259,3486,0,11,0
100580,102078,1,Presencial,3.26,2,Mujer,Linkedin,3,115949,75.0,75,Soltero,17,2018,7,low,102143,Presencial,2.17,1,Hombre,Ferias & Networking,9,998000,83.0,76,Casado,29,2017,5,high,-1.0899999999999999,-1,6,882051,-422,1,12,1
101230,102080,1,Presencial,2.685,2,Hombre,Linkedin,3,145990,75.0,78,Soltero,20,2018,12,low,102035,Presencial,1.93,0,Mujer,Linkedin,18,1616000,94.0,75,Viudo,47,2016,8,high,-0.7550000000000001,-2,15,1470010,-853,1,27,1
100089,102061,1,Presencial,2.31,0,Hombre,Headhunter,8,291776,75.0,77,Casado,24,2015,6,low,102115,Presencial,2.14,2,Hombre,Ferias & Networking,10,1203920,37.0,80,Casado,29,2012,11,low,-0.16999999999999993,2,2,912144,-952,1,5,0
100030,102078,1,Presencial,5.035,5,Hombre,Portal Web,5,367364,75.0,72,Casado,31,2017,10,low,102143,Presencial,2.17,1,Hombre,Ferias & Networking,9,998000,83.0,76,Casado,29,2017,5,high,-2.865,-4,4,630636,-147,1,-2,0
100958,102087,1,Presencial,1.23,2,Mujer,Portal Web,4,808481,75.0,79,Casado,35,2018,6,low,102111,Presencial,7.16,9,Mujer,Linkedin,10,1616000,98.0,79,Casado,42,2012,5,high,5.93,7,6,807519,-2222,1,7,0
101944,102073,1,Presencial,5.455,2,Hombre,Portal Web,4,453162,75.0,72,Soltero,34,2017,2,low,102139,Presencial,1.98,2,Hombre,Portal Web,11,1306940,95.0,86,Soltero,37,2019,7,high,-3.475,0,7,853778,864,0,3,0
100767,102026,1,Presencial,1.1,1,Mujer,Linkedin,13,406584,75.0,79,Casado,34,2012,7,low,102101,Presencial,2.7,1,Mujer,Portal Web,15,1616000,97.0,79,Casado,58,2017,6,high,1.6,0,2,1209416,1793,0,24,0
101333,102110,1,Presencial,2.055,1,Mujer,Portal Web,3,285594,75.0,76,Soltero,42,2018,4,low,102045,Presencial,1.6,5,Mujer,Linkedin,2,998000,87.0,76,Soltero,29,2016,11,high,-0.45500000000000007,4,-1,712406,-510,1,-13,0
100619,102117,1,Presencial,1.965,4,Mujer,Portal Web,5,294237,75.0,62,Soltero,47,2021,9,low,102154,Presencial,4.05,1,Mujer,Linkedin,10,1616000,90.0,80,Divorciado,48,2021,1,high,2.085,-3,5,1321763,-229,1,1,0
101178,102100,1,Presencial,1.825,1,Hombre,Portal Web,10,385364,75.0,83,Soltero,44,2019,7,low,102007,Presencial,3.3,1,Mujer,Portal Web,3,1255430,21.0,59,Casado,30,2013,2,low,1.4749999999999999,0,-7,870066,-2351,1,-14,1
102168,102172,2,Presencial,6.22,1,Hombre,Referidos,15,1616000,75.0,68,Viudo,42,2012,1,low,102020,Presencial,5.58,1,Hombre,Portal Web,7,1049000,57.0,70,Casado,29,2016,4,low,-0.6399999999999997,0,-8,-567000,1565,0,-13,0
102058,102172,2,Presencial,1.4,2,Hombre,Ferias & Networking,11,1616000,75.0,71,Casado,59,2021,2,low,102020,Presencial,5.58,1,Hombre,Portal Web,7,1049000,57.0,70,Casado,29,2016,4,low,4.18,-1,-4,-567000,-1766,1,-30,0
102929,102172,1,Presencial,1.375,6,Hombre,Portal Web,2,77382,75.0,72,Soltero,19,2023,2,low,102020,Presencial,5.58,1,Hombre,Portal Web,7,1049000,57.0,70,Casado,29,2016,4,low,4.205,-5,5,971618,-2483,1,10,0
103234,102085,1,Presencial,0.985,1,Mujer,Ferias & Networking,1,95752,75.0,76,Divorciado,14,2016,8,low,102145,Presencial,6.59,4,Hombre,Portal Web,12,1616000,47.0,71,Casado,39,2015,8,low,5.6049999999999995,3,11,1520248,-371,1,25,1
103089,102098,1,Presencial,4.73,1,Hombre,Headhunter,2,146451,75.0,75,Soltero,19,2018,8,low,102049,Presencial,1.8,1,Mujer,Portal Web,16,1616000,90.0,86,Casado,46,2021,1,high,-2.9300000000000006,0,14,1469549,898,0,27,0
103906,102112,1,Presencial,3.035,1,Mujer,Portal Web,4,189069,75.0,82,Soltero,22,2019,2,low,102031,Presencial,2.27,7,Hombre,Linkedin,1,692000,83.0,74,Soltero,26,2020,6,high,-0.7650000000000001,6,-3,502931,506,0,4,1
102182,102061,1,Presencial,2.345,0,Hombre,Headhunter,8,292407,75.0,77,Casado,24,2015,6,low,102115,Presencial,2.14,2,Hombre,Ferias & Networking,10,1203920,37.0,80,Casado,29,2012,11,low,-0.20500000000000007,2,2,911513,-953,1,5,0
102413,102023,1,Presencial,0.415,2,Hombre,Portal Web,5,353625,75.0,80,Soltero,24,2012,8,low,102105,Híbrida,4.9,1,Hombre,Portal Web,4,539000,80.0,65,Casado,23,2019,12,high,4.485,-1,-1,185375,2696,0,-1,0
103713,102093,1,Presencial,2.495,2,Hombre,Ferias & Networking,6,346384,75.0,83,Soltero,31,2019,3,low,102139,Presencial,5.41,0,Mujer,Ferias & Networking,4,488000,89.0,62,Soltero,23,2021,6,high,2.915,-2,-2,141616,829,0,-8,1
102881,102085,1,Presencial,3.99,1,Mujer,Referidos,3,365632,75.0,76,Casado,29,2016,4,low,102145,Presencial,6.59,4,Hombre,Portal Web,12,1616000,47.0,71,Casado,39,2015,8,low,2.5999999999999996,3,9,1250368,-238,1,10,1
103604,102075,1,Presencial,2.81,2,Mujer,Referidos,10,404731,75.0,78,Divorciado,31,2017,2,low,102047,Presencial,2.7,1,Hombre,Referidos,11,1255430,90.0,76,Casado,30,2013,3,high,-0.10999999999999988,-1,1,850699,-1406,1,-1,0
102624,102144,1,Presencial,3.345,2,Mujer,Portal Web,13,506029,75.0,71,Casado,42,2022,8,low,102156,Presencial,2.13,8,Mujer,Portal Web,11,1616000,5.0,82,Viudo,58,2015,6,low,-1.2150000000000003,6,-2,1109971,-2618,1,16,0
102872,102078,1,Presencial,3.79,9,Hombre,Linkedin,8,295026,75.0,66,Casado,42,2016,8,low,102143,Presencial,2.17,1,Hombre,Ferias & Networking,9,998000,83.0,76,Casado,29,2017,5,high,-1.62,-8,1,702974,292,0,-13,1
102652,102058,1,Presencial,3.62,1,Hombre,Referidos,7,835090,75.0,78,Soltero,44,2016,7,low,102172,Presencial,1.4,2,Hombre,Ferias & Networking,11,1616000,75.0,71,Casado,59,2021,2,low,-2.22,1,4,780910,1676,0,15,0
101262,102112,1,Presencial,3.03,0,Mujer,Portal Web,4,184158,74.0,82,Soltero,22,2019,2,low,102031,Presencial,2.27,7,Hombre,Linkedin,1,692000,83.0,74,Soltero,26,2020,6,high,-0.7599999999999998,7,-3,507842,503,0,4,1
101196,102050,1,Presencial,4.475,3,Hombre,Portal Web,2,312568,74.0,75,Casado,25,2014,10,low,102069,Presencial,3.7,0,Mujer,Linkedin,11,1512980,90.0,88,Soltero,40,2017,10,high,-0.7749999999999995,-3,9,1200412,1080,0,15,0
100633,102023,1,Presencial,0.425,1,Hombre,Portal Web,5,353350,74.0,80,Soltero,24,2012,8,low,102105,Híbrida,4.9,1,Hombre,Portal Web,4,539000,80.0,65,Casado,23,2019,12,high,4.4750000000000005,0,-1,185650,2696,0,-1,0
102015,102121,2,Presencial,6.18,1,Mujer,Referidos,10,1358450,74.0,82,Soltero,33,2014,6,low,102127,Híbrida,1.63,2,Hombre,Portal Web,4,1616000,90.0,77,Divorciado,44,2012,2,high,-4.55,1,-6,257550,-840,1,11,1
101774,102121,1,Presencial,2.855,3,Hombre,Portal Web,4,407036,74.0,64,Soltero,45,2019,4,low,102127,Híbrida,1.63,2,Hombre,Portal Web,4,1616000,90.0,77,Divorciado,44,2012,2,high,-1.225,-1,0,1208964,-2591,1,-1,1
100831,102129,1,Presencial,2.02,14,Hombre,Linkedin,14,682336,74.0,79,Soltero,52,2022,9,low,102142,Presencial,2.1,2,Mujer,Linkedin,3,590000,41.0,74,Soltero,24,2020,1,low,0.08000000000000007,-12,-11,-92336,-983,1,-28,1
102791,102121,1,Presencial,2.83,3,Hombre,Portal Web,4,409104,74.0,64,Soltero,45,2019,4,low,102127,Híbrida,1.63,2,Hombre,Portal Web,4,1616000,90.0,77,Divorciado,44,2012,2,high,-1.2000000000000002,-1,0,1206896,-2591,1,-1,0
102453,102057,1,Presencial,3.37,3,Hombre,Linkedin,10,753545,74.0,84,Viudo,43,2015,1,low,102019,Presencial,1.97,4,Hombre,Portal Web,5,1616000,90.0,73,Viudo,59,2022,12,high,-1.4000000000000001,1,-5,862455,2888,0,16,0
103247,102076,1,Presencial,5.725,0,Hombre,Linkedin,3,754798,74.0,80,Viudo,47,2017,1,low,102168,Híbrida,1.95,1,Hombre,Referidos,9,1616000,95.0,82,Soltero,53,2023,9,high,-3.7749999999999995,1,6,861202,2418,0,6,0
103894,102125,1,Presencial,3.455,1,Hombre,Portal Web,18,833565,74.0,82,Soltero,55,2022,3,low,102096,Híbrida,4.0,2,Mujer,Referidos,5,692000,87.0,82,Casado,29,2022,7,high,0.5449999999999999,1,-13,-141565,142,0,-26,1
101285,102027,1,Presencial,2.85,1,Hombre,Portal Web,5,370561,73.0,76,Casado,27,2013,9,low,102065,Presencial,3.27,1,Mujer,Linkedin,8,1306940,80.0,80,Casado,32,2014,2,high,0.41999999999999993,0,3,936379,155,0,5,0
100306,102149,1,Presencial,6.92,8,Hombre,Portal Web,4,401007,73.0,69,Soltero,46,2022,1,low,102141,Presencial,2.07,0,Mujer,Headhunter,3,1409960,90.0,86,Casado,37,2017,2,high,-4.85,-8,-1,1008953,-1788,1,-9,1
102091,102149,2,Presencial,1.54,1,Mujer,Portal Web,4,1616000,73.0,77,Casado,39,2014,12,low,102141,Presencial,2.07,0,Mujer,Headhunter,3,1409960,90.0,86,Casado,37,2017,2,high,0.5299999999999998,-1,-1,-206040,787,0,-2,0
104013,102149,1,Presencial,6.935,8,Hombre,Portal Web,4,399609,73.0,69,Soltero,46,2022,1,low,102141,Presencial,2.07,0,Mujer,Headhunter,3,1409960,90.0,86,Casado,37,2017,2,high,-4.865,-8,-1,1010351,-1788,1,-9,0
103896,102129,1,Presencial,2.005,15,Hombre,Linkedin,14,675702,73.0,79,Soltero,52,2022,9,low,102142,Presencial,2.1,2,Mujer,Linkedin,3,590000,41.0,74,Soltero,24,2020,1,low,0.0950000000000002,-13,-11,-85702,-984,1,-28,1
101633,102050,1,Presencial,2.28,11,Mujer,Portal Web,1,183395,72.0,64,Casado,19,2016,1,low,102069,Presencial,3.7,0,Mujer,Linkedin,11,1512980,90.0,88,Soltero,40,2017,10,high,1.4200000000000004,-11,10,1329585,642,0,21,0
100028,102028,1,Presencial,3.34,2,Hombre,Ferias & Networking,1,97124,71.0,83,Soltero,10,2012,6,low,102085,Presencial,1.39,2,Mujer,Linkedin,12,1358450,97.0,72,Soltero,35,2016,12,high,-1.95,0,11,1261326,1660,0,25,0
100242,102045,1,Presencial,3.8,4,Mujer,Portal Web,3,182188,71.0,82,Casado,17,2014,5,low,102171,Presencial,3.19,3,Hombre,Portal Web,11,1616000,97.0,65,Casado,53,2023,9,high,-0.6099999999999999,-1,8,1433812,3405,0,36,1
101375,102014,1,Presencial,2.395,3,Mujer,Linkedin,4,186475,71.0,78,Soltero,17,2013,4,low,102096,Presencial,1.78,1,Mujer,Portal Web,2,488000,98.0,78,Soltero,25,2023,1,high,-0.615,-2,-2,301525,3575,0,8,0
101756,102107,1,Presencial,4.665,2,Mujer,Portal Web,3,232203,71.0,66,Soltero,27,2020,8,low,102069,Presencial,2.4,1,Mujer,Linkedin,8,1616000,47.0,79,Casado,63,2023,6,low,-2.265,-1,5,1383797,1046,0,36,0
100482,102118,1,Presencial,2.29,1,Hombre,Linkedin,5,309109,71.0,67,Divorciado,31,2020,6,low,102171,Presencial,4.76,17,Mujer,Linkedin,4,1616000,86.0,74,Soltero,39,2023,8,high,2.4699999999999998,16,-1,1306891,1155,0,8,0
100022,102142,1,Presencial,2.14,10,Mujer,Linkedin,5,333295,71.0,86,Casado,33,2022,4,low,102047,Presencial,2.48,2,Hombre,Portal Web,3,1255430,90.0,66,Soltero,36,2019,7,high,0.33999999999999986,-8,-2,922135,-1016,1,3,0
101790,102148,1,Presencial,1.81,4,Mujer,Linkedin,8,431298,71.0,70,Casado,45,2022,1,low,102116,Presencial,1.49,2,Mujer,Portal Web,2,539000,80.0,67,Soltero,26,2022,12,high,-0.32000000000000006,-2,-6,107702,339,0,-19,0
101211,102109,1,Presencial,5.565,0,Mujer,Portal Web,7,876534,71.0,78,Casado,54,2018,9,low,102123,Presencial,3.86,1,Mujer,Portal Web,5,998000,97.0,82,Casado,32,2019,9,high,-1.7050000000000005,1,-2,121466,364,0,-22,0
103925,102045,1,Presencial,3.79,4,Mujer,Portal Web,3,187831,71.0,82,Casado,17,2014,5,low,102171,Presencial,3.19,3,Hombre,Portal Web,11,1616000,97.0,65,Casado,53,2023,9,high,-0.6000000000000001,-1,8,1428169,3405,0,36,1
103784,102118,1,Presencial,2.31,1,Hombre,Linkedin,5,312916,71.0,67,Divorciado,31,2020,6,low,102171,Presencial,4.76,17,Mujer,Linkedin,4,1616000,86.0,74,Soltero,39,2023,8,high,2.4499999999999997,16,-1,1303084,1153,0,8,1
102321,102080,1,Presencial,1.66,11,Mujer,Linkedin,6,372176,71.0,82,Casado,29,2016,8,low,102035,Presencial,1.93,0,Mujer,Linkedin,18,1616000,94.0,75,Viudo,47,2016,8,high,0.27,-11,12,1243824,13,0,18,0
102579,102163,1,Presencial,5.125,2,Hombre,Portal Web,7,380619,71.0,82,Casado,44,2023,4,low,102120,Presencial,7.53,9,Hombre,Linkedin,7,1616000,37.0,75,Casado,49,2019,8,low,2.4050000000000002,7,0,1235381,-1334,1,5,0
102186,102055,1,Presencial,1.585,2,Hombre,Ferias & Networking,8,716851,71.0,76,Viudo,45,2014,8,low,102129,Presencial,1.92,2,Hombre,Referidos,8,1616000,97.0,63,Casado,42,2013,2,high,0.33499999999999996,0,0,899149,-530,1,-3,0
102519,102147,1,Presencial,1.795,13,Hombre,Headhunter,4,914007,71.0,80,Casado,57,2022,11,low,102057,Presencial,1.58,2,Hombre,Portal Web,4,1616000,90.0,80,Casado,49,2022,12,high,-0.21499999999999986,-11,0,701993,35,0,-8,0
100431,102078,1,Presencial,4.285,2,Mujer,Linkedin,2,84434,70.0,72,Soltero,15,2018,8,low,102143,Presencial,2.17,1,Hombre,Ferias & Networking,9,998000,83.0,76,Casado,29,2017,5,high,-2.115,-1,7,913566,-437,1,14,0
100680,102117,1,Presencial,3.28,0,Mujer,Ferias & Networking,6,288614,70.0,74,Soltero,29,2020,5,low,102154,Presencial,4.05,1,Mujer,Linkedin,10,1616000,90.0,80,Divorciado,48,2021,1,high,0.77,1,4,1327386,251,0,19,0
100238,102120,1,Presencial,1.93,9,Hombre,Linkedin,6,289362,70.0,80,Casado,29,2020,4,low,102171,Presencial,6.48,2,Hombre,Ferias & Networking,9,1616000,80.0,71,Casado,47,2023,8,high,4.550000000000001,-7,3,1326638,1231,0,18,0
101001,102036,1,Presencial,1.965,10,Hombre,Linkedin,5,310202,70.0,75,Casado,24,2014,2,low,102054,Presencial,1.68,8,Hombre,Portal Web,5,1616000,92.0,76,Viudo,54,2022,1,high,-0.28500000000000014,-2,0,1305798,2898,0,30,0
101194,102080,1,Presencial,1.64,11,Mujer,Linkedin,6,372625,70.0,82,Casado,29,2016,7,low,102035,Presencial,1.93,0,Mujer,Linkedin,18,1616000,94.0,75,Viudo,47,2016,8,high,0.29000000000000004,-11,12,1243375,15,0,18,1
100887,102055,1,Presencial,1.55,1,Hombre,Ferias & Networking,10,721528,70.0,76,Viudo,45,2014,8,low,102129,Presencial,1.92,2,Hombre,Referidos,8,1616000,97.0,63,Casado,42,2013,2,high,0.3699999999999999,1,-2,894472,-533,1,-3,0
102056,102014,2,Presencial,5.24,1,Hombre,Ferias & Networking,16,1616000,70.0,63,Viudo,65,2023,3,low,102096,Presencial,1.78,1,Mujer,Portal Web,2,488000,98.0,78,Soltero,25,2023,1,high,-3.46,0,-14,-1128000,-50,1,-40,1
103874,102014,1,Presencial,2.41,2,Mujer,Linkedin,4,186280,70.0,78,Soltero,17,2013,4,low,102096,Presencial,1.78,1,Mujer,Portal Web,2,488000,98.0,78,Soltero,25,2023,1,high,-0.6300000000000001,-1,-2,301720,3573,0,8,0
102871,102170,1,Presencial,3.165,3,Mujer,Portal Web,2,210994,70.0,75,Soltero,28,2023,3,low,102055,Presencial,1.62,0,Mujer,Portal Web,8,1616000,78.0,72,Viudo,48,2013,2,low,-1.545,-3,6,1405006,-3670,1,20,0
103291,102120,1,Presencial,1.91,8,Hombre,Linkedin,6,289312,70.0,80,Casado,29,2020,3,low,102171,Presencial,6.48,2,Hombre,Ferias & Networking,9,1616000,80.0,71,Casado,47,2023,8,high,4.57,-6,3,1326688,1233,0,18,0
102385,102108,1,Presencial,2.38,2,Mujer,Referidos,7,390438,70.0,65,Soltero,32,2018,2,low,102040,Presencial,2.92,1,Mujer,Portal Web,5,1616000,46.0,75,Casado,50,2023,5,low,0.54,-1,-2,1225562,1935,0,18,0
102252,102109,1,Presencial,5.55,1,Mujer,Portal Web,7,879418,70.0,78,Casado,54,2018,9,low,102123,Presencial,3.86,1,Mujer,Portal Web,5,998000,97.0,82,Casado,32,2019,9,high,-1.69,0,-2,118582,365,0,-22,0
100153,102170,1,Presencial,3.15,2,Mujer,Portal Web,2,211242,69.0,75,Soltero,28,2023,3,low,102055,Presencial,1.62,0,Mujer,Portal Web,8,1616000,78.0,72,Viudo,48,2013,2,low,-1.5299999999999998,-2,6,1404758,-3670,1,20,0
101052,102037,1,Presencial,1.975,2,Hombre,Referidos,4,351380,69.0,68,Casado,25,2013,5,low,102057,Presencial,1.12,1,Mujer,Linkedin,2,641000,50.0,76,Casado,21,2016,12,low,-0.855,-1,-2,289620,1297,0,-4,0
100309,102171,1,Presencial,3.65,2,Hombre,Ferias & Networking,3,803932,69.0,80,Casado,40,2023,4,low,102088,Presencial,2.57,4,Hombre,Linkedin,8,1616000,80.0,69,Casado,43,2017,10,high,-1.08,2,5,812068,-2009,1,3,0
100918,102034,1,Presencial,3.23,1,Hombre,Ferias & Networking,9,395874,69.0,78,Viudo,39,2013,2,low,102113,Presencial,7.84,7,Hombre,Linkedin,5,1564490,90.0,70,Casado,35,2012,9,high,4.609999999999999,6,-4,1168616,-156,1,-4,0
100820,102114,1,Presencial,3.435,7,Hombre,Portal Web,4,875304,69.0,75,Casado,48,2020,9,low,102050,Presencial,1.44,1,Mujer,Portal Web,5,1616000,91.0,69,Divorciado,47,2021,5,high,-1.995,-6,1,740696,246,0,-1,0
100838,102084,1,Presencial,1.305,2,Mujer,Linkedin,9,917696,69.0,81,Divorciado,51,2018,5,low,102171,Presencial,2.62,3,Mujer,Portal Web,14,1616000,89.0,76,Divorciado,50,2023,7,high,1.3150000000000002,1,5,698304,1895,0,-1,0
103905,102096,1,Presencial,6.33,9,Hombre,Portal Web,2,96941,69.0,73,Soltero,16,2018,5,low,102116,Presencial,5.11,8,Mujer,Linkedin,13,1461470,90.0,74,Soltero,42,2021,5,high,-1.2199999999999998,-1,11,1364529,1097,0,26,0
103399,102037,1,Presencial,2.315,2,Mujer,Portal Web,9,505862,69.0,74,Casado,33,2013,8,low,102057,Presencial,1.12,1,Mujer,Linkedin,2,641000,50.0,76,Casado,21,2016,12,low,-1.1949999999999998,-1,-7,135138,1192,0,-12,0
103422,102121,1,Presencial,2.865,3,Mujer,Portal Web,11,449431,69.0,69,Casado,45,2019,11,low,102127,Híbrida,1.63,2,Hombre,Portal Web,4,1616000,90.0,77,Divorciado,44,2012,2,high,-1.2350000000000003,-1,-7,1166569,-2823,1,-1,1
103974,102114,1,Presencial,3.445,7,Hombre,Portal Web,4,875911,69.0,75,Casado,48,2020,9,low,102050,Presencial,1.44,1,Mujer,Portal Web,5,1616000,91.0,69,Divorciado,47,2021,5,high,-2.005,-6,1,740089,246,0,-1,0
102646,102050,1,Presencial,4.5,0,Mujer,Ferias & Networking,10,695288,69.0,69,Divorciado,44,2014,7,low,102069,Presencial,3.7,0,Mujer,Linkedin,11,1512980,90.0,88,Soltero,40,2017,10,high,-0.7999999999999998,0,1,817692,1169,0,-4,0
103009,102084,1,Presencial,1.325,1,Mujer,Linkedin,9,914283,69.0,81,Divorciado,51,2018,5,low,102171,Presencial,2.62,3,Mujer,Portal Web,14,1616000,89.0,76,Divorciado,50,2023,7,high,1.2950000000000002,2,5,701717,1895,0,-1,0
100177,102125,1,Presencial,3.305,1,Hombre,Referidos,4,492532,68.0,72,Soltero,38,2019,4,low,102096,Híbrida,4.0,2,Mujer,Referidos,5,692000,87.0,82,Casado,29,2022,7,high,0.6949999999999998,1,1,199468,1210,0,-9,1
100516,102037,1,Presencial,2.29,2,Mujer,Portal Web,9,512569,68.0,74,Casado,33,2013,8,low,102057,Presencial,1.12,1,Mujer,Linkedin,2,641000,50.0,76,Casado,21,2016,12,low,-1.17,-1,-7,128431,1192,0,-12,0
103659,102134,1,Presencial,1.58,2,Hombre,Linkedin,2,117891,68.0,85,Soltero,21,2021,9,low,102135,Presencial,2.25,2,Hombre,Portal Web,5,1358450,90.0,69,Viudo,31,2012,7,high,0.6699999999999999,0,3,1240559,-3365,1,10,0
104010,102172,1,Presencial,3.595,4,Mujer,Linkedin,1,136914,68.0,74,Soltero,23,2023,1,low,102020,Presencial,5.58,1,Hombre,Portal Web,7,1049000,57.0,70,Casado,29,2016,4,low,1.9849999999999999,-3,6,912086,-2474,1,6,1
103474,102039,1,Presencial,6.39,1,Mujer,Portal Web,15,299203,68.0,72,Divorciado,40,2015,4,low,102054,Presencial,3.66,0,Hombre,Referidos,5,1616000,93.0,75,Viudo,49,2018,6,high,-2.7299999999999995,-1,-10,1316797,1151,0,9,1
103660,102136,1,Presencial,4.605,2,Mujer,Ferias & Networking,14,722306,68.0,66,Divorciado,54,2023,2,low,102034,Presencial,1.78,2,Hombre,Portal Web,3,1616000,89.0,78,Casado,35,2013,1,high,-2.825,0,-11,893694,-3685,1,-19,1
100916,102090,1,Presencial,1.965,5,Mujer,Portal Web,1,104245,67.0,71,Casado,15,2017,3,low,102171,Presencial,6.83,0,Hombre,Linkedin,4,488000,92.0,76,Soltero,19,2017,2,high,4.865,-5,3,383755,-17,1,4,1
101806,102082,1,Presencial,1.765,2,Hombre,Portal Web,2,102786,67.0,73,Soltero,15,2016,7,low,102050,Presencial,5.5,2,Mujer,Linkedin,7,1616000,81.0,70,Casado,36,2018,8,high,3.7350000000000003,0,5,1513214,759,0,21,0
101515,102134,1,Presencial,1.54,2,Hombre,Linkedin,2,122871,67.0,85,Soltero,21,2021,9,low,102135,Presencial,2.25,2,Hombre,Portal Web,5,1358450,90.0,69,Viudo,31,2012,7,high,0.71,0,3,1235579,-3365,1,10,0
100476,102172,1,Presencial,3.56,4,Mujer,Linkedin,1,139209,67.0,74,Soltero,23,2023,1,low,102020,Presencial,5.58,1,Hombre,Portal Web,7,1049000,57.0,70,Casado,29,2016,4,low,2.02,-3,6,909791,-2472,1,6,1
100360,102101,1,Presencial,3.74,2,Hombre,Referidos,1,246397,67.0,82,Casado,24,2018,1,low,102089,Presencial,6.23,0,Hombre,Portal Web,26,1616000,92.0,68,Divorciado,55,2014,1,high,2.49,-2,25,1369603,-1458,1,31,0
101319,102171,1,Presencial,6.845,0,Hombre,Referidos,8,452336,67.0,75,Soltero,41,2023,6,low,102088,Presencial,2.57,4,Hombre,Linkedin,8,1616000,80.0,69,Casado,43,2017,10,high,-4.275,4,0,1163664,-2076,1,2,0
100066,102092,1,Presencial,4.605,1,Hombre,Linkedin,10,465545,67.0,71,Soltero,35,2017,10,low,102120,Presencial,1.23,6,Mujer,Linkedin,13,1616000,98.0,95,Viudo,41,2013,6,high,-3.3750000000000004,5,3,1150455,-1567,1,6,0
101308,102032,1,Presencial,2.345,5,Mujer,Referidos,5,256366,67.0,79,Soltero,34,2013,4,low,102065,Presencial,1.78,7,Hombre,Portal Web,14,1616000,42.0,71,Casado,42,2015,11,low,-0.5650000000000002,2,9,1359634,950,0,8,1
103256,102115,1,Presencial,3.89,3,Hombre,Linkedin,2,83428,67.0,75,Soltero,18,2020,10,low,102116,Presencial,2.0,2,Mujer,Portal Web,4,1616000,94.0,76,Soltero,35,2018,12,high,-1.8900000000000001,-1,2,1532572,-672,1,17,1
103951,102090,1,Presencial,1.98,5,Mujer,Portal Web,1,96115,67.0,71,Casado,15,2017,3,low,102171,Presencial,6.83,0,Hombre,Linkedin,4,488000,92.0,76,Soltero,19,2017,2,high,4.85,-5,3,391885,-19,1,4,1
102307,102101,1,Presencial,3.74,3,Hombre,Referidos,1,246290,67.0,82,Casado,24,2018,1,low,102089,Presencial,6.23,0,Hombre,Portal Web,26,1616000,92.0,68,Divorciado,55,2014,1,high,2.49,-3,25,1369710,-1458,1,31,0
102285,102038,1,Presencial,2.425,1,Hombre,Portal Web,18,894177,67.0,85,Viudo,43,2012,10,low,102125,Presencial,2.06,1,Hombre,Portal Web,12,1616000,81.0,82,Casado,44,2018,1,high,-0.36499999999999977,0,-6,721823,1910,0,1,0
102402,102028,1,Presencial,3.345,1,Mujer,Referidos,9,895809,67.0,62,Viudo,46,2014,8,low,102085,Presencial,1.39,2,Mujer,Linkedin,12,1358450,97.0,72,Soltero,35,2016,12,high,-1.9550000000000003,1,3,462641,864,0,-11,0
101032,102030,1,Presencial,4.85,6,Mujer,Linkedin,6,789603,66.0,82,Casado,30,2013,6,low,102058,Presencial,6.34,0,Mujer,Referidos,14,1616000,90.0,76,Viudo,41,2015,4,high,1.4900000000000002,-6,8,826397,672,0,11,0
101126,102143,1,Presencial,2.155,2,Mujer,Linkedin,5,641778,66.0,70,Viudo,48,2020,10,low,102142,Presencial,1.07,2,Hombre,Portal Web,2,590000,90.0,78,Casado,25,2022,2,high,-1.0849999999999997,0,-3,-51778,461,0,-23,1
103787,102081,1,Presencial,2.555,2,Mujer,Linkedin,2,211608,66.0,75,Casado,21,2016,2,low,102135,Presencial,2.5,2,Hombre,Portal Web,4,488000,26.0,64,Soltero,18,2015,8,low,-0.05500000000000016,0,2,276392,-172,1,-3,1
103931,102159,1,Presencial,3.045,2,Mujer,Portal Web,7,430956,66.0,88,Soltero,39,2022,10,low,102120,Híbrida,0.98,2,Hombre,Referidos,14,808000,90.0,86,Soltero,44,2022,8,high,-2.065,0,7,377044,-52,1,5,1
103549,102092,1,Presencial,4.59,2,Hombre,Linkedin,10,468186,66.0,71,Soltero,35,2017,10,low,102120,Presencial,1.23,6,Mujer,Linkedin,13,1616000,98.0,95,Viudo,41,2013,6,high,-3.36,4,3,1147814,-1566,1,6,1
103426,102139,1,Presencial,1.0,2,Mujer,Referidos,11,245222,66.0,76,Soltero,42,2021,10,low,102154,Presencial,6.48,1,Hombre,Ferias & Networking,5,590000,90.0,67,Casado,25,2021,6,high,5.48,-1,-6,344778,-125,1,-17,1
102675,102061,1,Presencial,2.455,0,Mujer,Ferias & Networking,8,274338,66.0,75,Casado,39,2016,11,low,102115,Presencial,2.14,2,Hombre,Ferias & Networking,10,1203920,37.0,80,Casado,29,2012,11,low,-0.31499999999999995,2,2,929582,-1454,1,-10,0
101082,102081,1,Presencial,2.56,2,Mujer,Linkedin,2,210265,65.0,75,Casado,21,2016,2,low,102135,Presencial,2.5,2,Hombre,Portal Web,4,488000,26.0,64,Soltero,18,2015,8,low,-0.06000000000000005,0,2,277735,-171,1,-3,1
101712,102139,1,Presencial,1.005,3,Mujer,Referidos,11,246357,65.0,76,Soltero,42,2021,10,low,102154,Presencial,6.48,1,Hombre,Ferias & Networking,5,590000,90.0,67,Casado,25,2021,6,high,5.4750000000000005,-2,-6,343643,-126,1,-17,0
101040,102079,1,Presencial,1.94,1,Hombre,Referidos,7,457295,65.0,78,Soltero,40,2017,12,low,102146,Presencial,2.63,1,Mujer,Portal Web,4,1358450,80.0,81,Soltero,35,2016,3,high,0.69,0,-3,901155,-651,1,-5,1
103637,102054,1,Presencial,1.94,0,Mujer,Linkedin,2,160963,65.0,71,Soltero,19,2016,6,low,102044,Presencial,2.91,1,Hombre,Linkedin,17,1616000,85.0,74,Divorciado,41,2012,11,high,0.9700000000000002,1,15,1455037,-1305,1,22,1
101750,102131,1,Presencial,1.815,1,Mujer,Portal Web,1,99302,64.0,82,Soltero,18,2020,5,low,102109,Presencial,5.54,0,Hombre,Linkedin,3,998000,39.0,77,Soltero,34,2021,12,low,3.725,-1,2,898698,579,0,16,1
100952,102128,1,Presencial,2.55,2,Hombre,Portal Web,8,310490,64.0,71,Casado,32,2021,5,low,102056,Presencial,4.11,10,Mujer,Portal Web,16,1616000,46.0,72,Soltero,55,2021,2,low,1.5600000000000005,8,8,1305510,-94,1,23,1
100288,102085,1,Presencial,2.17,1,Hombre,Ferias & Networking,6,325420,64.0,75,Soltero,28,2017,5,low,102145,Presencial,6.59,4,Hombre,Portal Web,12,1616000,47.0,71,Casado,39,2015,8,low,4.42,3,6,1290580,-649,1,11,0
100439,102099,1,Presencial,2.555,9,Mujer,Portal Web,8,389853,64.0,91,Casado,32,2017,9,low,102080,Presencial,1.71,0,Hombre,Portal Web,11,1616000,76.0,80,Viudo,51,2021,10,low,-0.8450000000000002,-9,3,1226147,1468,0,19,0
101174,102026,1,Presencial,1.18,3,Hombre,Portal Web,9,427842,64.0,71,Soltero,28,2012,3,low,102101,Presencial,2.7,1,Mujer,Portal Web,15,1616000,97.0,79,Casado,58,2017,6,high,1.5200000000000002,-2,6,1188158,1933,0,30,1
102141,102134,2,Presencial,1.88,1,Mujer,Linkedin,3,1100900,64.0,69,Soltero,32,2018,5,low,102135,Presencial,2.25,2,Hombre,Portal Web,5,1358450,90.0,69,Viudo,31,2012,7,high,0.3700000000000001,1,2,257550,-2144,1,-1,1
100293,102134,1,Presencial,2.845,0,Mujer,Portal Web,10,272029,64.0,84,Casado,43,2020,11,low,102135,Presencial,2.25,2,Hombre,Portal Web,5,1358450,90.0,69,Viudo,31,2012,7,high,-0.5950000000000002,2,-5,1086421,-3039,1,-12,0
104116,102131,1,Presencial,1.835,2,Mujer,Portal Web,1,97158,64.0,82,Soltero,18,2020,5,low,102109,Presencial,5.54,0,Hombre,Linkedin,3,998000,39.0,77,Soltero,34,2021,12,low,3.705,-2,2,900842,580,0,16,1
102236,102102,1,Presencial,5.02,6,Hombre,Portal Web,3,391094,64.0,63,Casado,35,2020,8,low,102018,Presencial,2.48,0,Hombre,Portal Web,5,1616000,92.0,63,Viudo,49,2019,4,high,-2.5399999999999996,-6,2,1224906,-482,1,14,0
103716,102133,1,Presencial,1.705,1,Mujer,Portal Web,8,505024,64.0,80,Casado,40,2020,4,low,102151,Híbrida,2.61,2,Hombre,Linkedin,4,1255430,98.0,65,Soltero,35,2018,2,high,0.9049999999999998,1,-4,750406,-780,1,-5,0
100244,102049,1,Presencial,1.78,3,Hombre,Portal Web,3,138987,63.0,78,Soltero,14,2014,3,low,102029,Presencial,6.89,0,Mujer,Portal Web,9,1616000,19.0,77,Divorciado,49,2023,3,low,5.109999999999999,-3,6,1477013,3284,0,35,1
101754,102060,1,Presencial,1.885,2,Hombre,Ferias & Networking,2,186823,63.0,62,Soltero,20,2016,2,low,102041,Presencial,4.42,3,Hombre,Referidos,16,1616000,82.0,62,Casado,45,2013,10,high,2.535,1,14,1429177,-845,1,25,0
101595,102039,1,Presencial,3.195,1,Hombre,Portal Web,8,327307,63.0,81,Casado,25,2014,7,low,102054,Presencial,3.66,0,Hombre,Referidos,5,1616000,93.0,75,Viudo,49,2018,6,high,0.4650000000000003,-1,-3,1288693,1442,0,24,0
100384,102037,1,Presencial,2.38,1,Mujer,Referidos,6,385199,63.0,76,Casado,28,2013,10,low,102057,Presencial,1.12,1,Mujer,Linkedin,2,641000,50.0,76,Casado,21,2016,12,low,-1.2599999999999998,0,-4,255801,1137,0,-7,0
101794,102077,1,Presencial,1.93,6,Hombre,Portal Web,5,787464,63.0,72,Soltero,33,2018,7,low,102146,Presencial,2.27,0,Hombre,Ferias & Networking,11,1306940,31.0,64,Soltero,39,2021,6,low,0.3400000000000001,-6,6,519476,1089,0,6,0
100511,102133,1,Presencial,1.68,2,Mujer,Portal Web,8,506392,63.0,80,Casado,40,2020,4,low,102151,Híbrida,2.61,2,Hombre,Linkedin,4,1255430,98.0,65,Soltero,35,2018,2,high,0.9299999999999999,0,-4,749038,-780,1,-5,1
102166,102135,2,Presencial,7.74,2,Hombre,Referidos,9,1306940,63.0,81,Casado,40,2022,6,low,102028,Presencial,2.04,1,Hombre,Portal Web,2,1616000,82.0,75,Divorciado,49,2017,10,high,-5.7,-1,-7,309060,-1717,1,9,1
101066,102135,1,Presencial,2.77,2,Hombre,Portal Web,12,401593,63.0,78,Soltero,44,2020,5,low,102028,Presencial,2.04,1,Hombre,Portal Web,2,1616000,82.0,75,Divorciado,49,2017,10,high,-0.73,-1,-10,1214407,-958,1,5,0
101970,102067,1,Presencial,2.93,3,Mujer,Portal Web,4,896983,63.0,75,Casado,49,2017,2,low,102058,Presencial,0.92,1,Mujer,Portal Web,5,1616000,90.0,70,Divorciado,46,2020,8,high,-2.0100000000000002,-2,1,719017,1295,0,-3,1
102785,102109,1,Presencial,2.79,2,Mujer,Linkedin,8,332158,63.0,78,Viudo,30,2019,1,low,102123,Presencial,3.86,1,Mujer,Portal Web,5,998000,97.0,82,Casado,32,2019,9,high,1.0699999999999998,-1,-3,665842,261,0,2,0
103999,102128,1,Presencial,1.455,7,Hombre,Linkedin,10,411673,63.0,77,Soltero,35,2019,9,low,102056,Presencial,4.11,10,Mujer,Portal Web,16,1616000,46.0,72,Soltero,55,2021,2,low,2.6550000000000002,3,6,1204327,534,0,20,1
102753,102100,1,Presencial,1.95,2,Mujer,Referidos,11,406341,63.0,83,Divorciado,44,2018,2,low,102007,Presencial,3.3,1,Mujer,Portal Web,3,1255430,21.0,59,Casado,30,2013,2,low,1.3499999999999999,-1,-8,849089,-1830,1,-14,0
101325,102161,1,Presencial,1.42,3,Mujer,Portal Web,2,119695,62.0,82,Soltero,22,2022,11,low,102039,Presencial,3.93,5,Mujer,Portal Web,4,1409960,85.0,77,Casado,36,2016,10,high,2.5100000000000002,2,2,1290265,-2222,1,14,1
100590,102119,1,Presencial,2.215,3,Mujer,Ferias & Networking,4,187168,62.0,86,Casado,24,2019,10,low,102107,Presencial,2.22,2,Hombre,Portal Web,12,1616000,38.0,70,Divorciado,52,2021,1,low,0.0050000000000003375,-1,8,1428832,455,0,28,1
101490,102112,1,Presencial,6.08,3,Hombre,Portal Web,2,469400,62.0,69,Casado,39,2020,10,low,102031,Presencial,2.27,7,Hombre,Linkedin,1,692000,83.0,74,Soltero,26,2020,6,high,-3.81,4,-1,222600,-115,1,-13,0
101245,102080,1,Presencial,1.33,2,Mujer,Portal Web,16,700966,62.0,72,Soltero,48,2018,6,low,102035,Presencial,1.93,0,Mujer,Linkedin,18,1616000,94.0,75,Viudo,47,2016,8,high,0.5999999999999999,-2,2,915034,-673,1,-1,0
101673,102138,1,Presencial,6.5,2,Hombre,Ferias & Networking,13,861560,62.0,70,Casado,53,2022,8,low,102059,Presencial,3.26,1,Hombre,Linkedin,5,1616000,57.0,75,Soltero,44,2018,4,low,-3.24,-1,-8,754440,-1583,1,-9,0
103160,102161,1,Presencial,1.42,3,Mujer,Portal Web,2,119952,62.0,82,Soltero,22,2022,11,low,102039,Presencial,3.93,5,Mujer,Portal Web,4,1409960,85.0,77,Casado,36,2016,10,high,2.5100000000000002,2,2,1290008,-2225,1,14,0
103379,102138,1,Presencial,1.805,1,Hombre,Portal Web,5,255391,62.0,68,Soltero,44,2022,11,low,102059,Presencial,3.26,1,Hombre,Linkedin,5,1616000,57.0,75,Soltero,44,2018,4,low,1.4549999999999998,0,0,1360609,-1676,1,0,1
103088,102007,1,Presencial,2.355,1,Hombre,Referidos,5,264884,62.0,75,Casado,34,2012,1,low,102070,Presencial,5.11,2,Mujer,Portal Web,6,1358450,96.0,62,Soltero,41,2022,4,high,2.7550000000000003,1,1,1093566,3753,0,7,0
102744,102080,1,Presencial,1.345,2,Mujer,Portal Web,16,701906,62.0,72,Soltero,48,2018,6,low,102035,Presencial,1.93,0,Mujer,Linkedin,18,1616000,94.0,75,Viudo,47,2016,8,high,0.585,-2,2,914094,-673,1,-1,0
102507,102138,1,Presencial,6.51,2,Hombre,Ferias & Networking,13,857121,62.0,70,Casado,54,2022,8,low,102059,Presencial,3.26,1,Hombre,Linkedin,5,1616000,57.0,75,Soltero,44,2018,4,low,-3.25,-1,-8,758879,-1582,1,-10,0
102934,102075,1,Presencial,1.965,2,Mujer,Referidos,8,717057,62.0,73,Casado,47,2016,5,low,102047,Presencial,2.7,1,Hombre,Referidos,11,1255430,90.0,76,Casado,30,2013,3,high,0.7350000000000001,-1,3,538373,-1133,1,-17,0
101827,102051,1,Presencial,3.03,6,Mujer,Linkedin,6,249370,61.0,76,Casado,23,2016,6,low,102075,Híbrida,1.39,1,Hombre,Portal Web,11,1616000,83.0,76,Casado,46,2019,11,high,-1.64,-5,5,1366630,1259,0,23,1
100468,102138,1,Presencial,1.82,1,Hombre,Portal Web,5,259305,61.0,68,Soltero,44,2022,11,low,102059,Presencial,3.26,1,Hombre,Linkedin,5,1616000,57.0,75,Soltero,44,2018,4,low,1.4399999999999997,0,0,1356695,-1674,1,0,1
100537,102112,1,Presencial,2.77,1,Hombre,Portal Web,5,733898,61.0,68,Soltero,51,2019,5,low,102031,Presencial,2.27,7,Hombre,Linkedin,1,692000,83.0,74,Soltero,26,2020,6,high,-0.5,6,-4,-41898,396,0,-25,0
101382,102030,1,Presencial,5.27,1,Mujer,Portal Web,7,733674,61.0,74,Divorciado,46,2013,11,low,102058,Presencial,6.34,0,Mujer,Referidos,14,1616000,90.0,76,Viudo,41,2015,4,high,1.0700000000000003,-1,7,882326,522,0,-5,0
103838,102123,1,Presencial,4.38,2,Hombre,Portal Web,2,166844,61.0,68,Casado,22,2020,8,low,102043,Presencial,5.5,1,Mujer,Linkedin,16,1616000,42.0,66,Soltero,51,2021,9,low,1.12,-1,14,1449156,393,0,29,1
103758,102119,1,Presencial,2.225,3,Mujer,Ferias & Networking,4,187140,61.0,86,Casado,24,2019,10,low,102107,Presencial,2.22,2,Hombre,Portal Web,12,1616000,38.0,70,Divorciado,52,2021,1,low,-0.004999999999999893,-1,8,1428860,454,0,28,1
102468,102083,1,Presencial,2.435,1,Mujer,Portal Web,10,372274,61.0,78,Soltero,28,2015,11,low,102147,Presencial,1.61,0,Mujer,Portal Web,5,1564490,83.0,71,Soltero,44,2021,2,high,-0.825,-1,-5,1192216,1921,0,16,0
103436,102054,1,Presencial,2.315,1,Mujer,Linkedin,13,438358,61.0,78,Casado,35,2013,11,low,102044,Presencial,2.91,1,Hombre,Linkedin,17,1616000,85.0,74,Divorciado,41,2012,11,high,0.5950000000000002,0,4,1177642,-359,1,6,1
103708,102031,1,Presencial,5.62,2,Mujer,Portal Web,14,454639,61.0,72,Divorciado,38,2012,2,low,102111,Presencial,2.95,2,Hombre,Portal Web,8,1610000,76.0,87,Casado,31,2017,7,low,-2.67,0,-6,1155361,1954,0,-7,1
103515,102171,1,Presencial,2.985,2,Hombre,Ferias & Networking,16,676046,61.0,75,Soltero,52,2022,12,low,102088,Presencial,2.57,4,Hombre,Linkedin,8,1616000,80.0,69,Casado,43,2017,10,high,-0.41500000000000004,2,-8,939954,-1885,1,-9,0
103173,102102,1,Presencial,1.865,1,Mujer,Ferias & Networking,9,814439,61.0,81,Viudo,51,2019,8,low,102018,Presencial,2.48,0,Hombre,Portal Web,5,1616000,92.0,63,Viudo,49,2019,4,high,0.615,-1,-4,801561,-112,1,-2,0
102874,102112,1,Presencial,2.79,2,Hombre,Portal Web,5,733901,61.0,68,Soltero,51,2019,5,low,102031,Presencial,2.27,7,Hombre,Linkedin,1,692000,83.0,74,Soltero,26,2020,6,high,-0.52,5,-4,-41901,394,0,-25,0
100430,102105,1,Presencial,4.43,0,Mujer,Linkedin,1,100283,60.0,65,Soltero,17,2018,6,low,102113,Híbrida,2.07,0,Hombre,Linkedin,8,1616000,85.0,71,Viudo,45,2017,3,high,-2.36,0,7,1515717,-446,1,28,1
100329,102142,1,Presencial,1.52,2,Hombre,Portal Web,3,165348,60.0,70,Soltero,24,2022,4,low,102047,Presencial,2.48,2,Hombre,Portal Web,3,1255430,90.0,66,Soltero,36,2019,7,high,0.96,0,0,1090082,-1004,1,12,0
100512,102137,1,Presencial,2.27,2,Mujer,Portal Web,3,464446,60.0,77,Soltero,40,2021,10,low,102046,Presencial,1.18,0,Mujer,Portal Web,2,845000,37.0,79,Casado,27,2017,12,low,-1.09,-2,-1,380554,-1387,1,-13,0
101664,102060,1,Presencial,2.495,2,Mujer,Ferias & Networking,8,642599,60.0,75,Viudo,44,2016,6,low,102041,Presencial,4.42,3,Hombre,Referidos,16,1616000,82.0,62,Casado,45,2013,10,high,1.9249999999999998,1,8,973401,-976,1,1,0
100878,102171,1,Presencial,2.985,2,Hombre,Ferias & Networking,16,676566,60.0,75,Soltero,52,2022,12,low,102088,Presencial,2.57,4,Hombre,Linkedin,8,1616000,80.0,69,Casado,43,2017,10,high,-0.41500000000000004,2,-8,939434,-1885,1,-9,0
102043,102051,2,Presencial,1.03,0,Hombre,Portal Web,5,1616000,60.0,76,Casado,44,2019,5,low,102075,Híbrida,1.39,1,Hombre,Portal Web,11,1616000,83.0,76,Casado,46,2019,11,high,0.3599999999999999,1,6,0,173,0,2,1
103891,102051,1,Presencial,2.995,5,Mujer,Linkedin,6,252245,60.0,76,Casado,23,2016,6,low,102075,Híbrida,1.39,1,Hombre,Portal Web,11,1616000,83.0,76,Casado,46,2019,11,high,-1.6050000000000002,-4,5,1363755,1261,0,23,1
104028,102084,1,Presencial,3.96,3,Hombre,Linkedin,8,292925,60.0,70,Casado,27,2018,2,low,102171,Presencial,2.62,3,Mujer,Portal Web,14,1616000,89.0,76,Divorciado,50,2023,7,high,-1.3399999999999999,0,6,1323075,1970,0,23,1
102048,102092,2,Presencial,3.99,0,Mujer,Portal Web,5,590000,59.0,76,Soltero,20,2015,8,low,102120,Presencial,1.23,6,Mujer,Linkedin,13,1616000,98.0,95,Viudo,41,2013,6,high,-2.7600000000000002,6,8,1026000,-793,1,21,1
102167,102092,2,Presencial,5.7,2,Hombre,Ferias & Networking,2,794000,59.0,64,Casado,27,2019,3,low,102120,Presencial,1.23,6,Mujer,Linkedin,13,1616000,98.0,95,Viudo,41,2013,6,high,-4.470000000000001,4,11,822000,-2092,1,14,1
101293,102092,1,Presencial,1.82,3,Mujer,Linkedin,5,786560,59.0,79,Casado,38,2019,11,low,102120,Presencial,1.23,6,Mujer,Linkedin,13,1616000,98.0,95,Viudo,41,2013,6,high,-0.5900000000000001,3,8,829440,-2346,1,3,0
101479,102044,1,Presencial,1.6,2,Hombre,Referidos,15,405020,59.0,71,Casado,39,2015,3,low,102155,Presencial,1.54,1,Hombre,Ferias & Networking,14,1616000,56.0,68,Soltero,47,2023,3,low,-0.06000000000000005,-1,-1,1210980,2940,0,8,0
101225,102092,1,Presencial,1.07,2,Hombre,Referidos,6,777736,59.0,81,Casado,47,2016,12,low,102120,Presencial,1.23,6,Mujer,Linkedin,13,1616000,98.0,95,Viudo,41,2013,6,high,0.15999999999999992,4,7,838264,-1258,1,-6,1
102546,102106,1,Presencial,2.5,0,Mujer,Portal Web,7,405642,59.0,65,Casado,35,2020,4,low,102081,Presencial,1.39,1,Mujer,Ferias & Networking,5,1049000,86.0,86,Soltero,32,2019,6,high,-1.11,1,-2,643358,-320,1,-3,0
102876,102092,1,Presencial,1.82,3,Mujer,Linkedin,5,787486,59.0,79,Casado,38,2019,11,low,102120,Presencial,1.23,6,Mujer,Linkedin,13,1616000,98.0,95,Viudo,41,2013,6,high,-0.5900000000000001,3,8,828514,-2348,1,3,0
102986,102168,1,Presencial,1.35,1,Hombre,Portal Web,9,257255,59.0,72,Casado,44,2023,6,low,102172,Presencial,6.22,1,Hombre,Referidos,15,1616000,75.0,68,Viudo,42,2012,1,low,4.869999999999999,0,6,1358745,-4174,1,-2,1
102179,102044,1,Presencial,1.58,3,Hombre,Referidos,12,407188,59.0,71,Casado,39,2015,3,low,102155,Presencial,1.54,1,Hombre,Ferias & Networking,14,1616000,56.0,68,Soltero,47,2023,3,low,-0.040000000000000036,-2,2,1208812,2939,0,8,0
103257,102138,1,Presencial,5.05,2,Hombre,Portal Web,14,657219,59.0,70,Divorciado,51,2023,4,low,102059,Presencial,3.26,1,Hombre,Linkedin,5,1616000,57.0,75,Soltero,44,2018,4,low,-1.79,-1,-9,958781,-1831,1,-7,1
103579,102139,1,Presencial,2.475,3,Mujer,Linkedin,11,921183,59.0,79,Viudo,59,2022,11,low,102154,Presencial,6.48,1,Hombre,Ferias & Networking,5,590000,90.0,67,Casado,25,2021,6,high,4.005000000000001,-2,-6,-331183,-509,1,-34,1
100365,102142,1,Presencial,1.61,1,Hombre,Ferias & Networking,1,97741,58.0,79,Soltero,21,2023,4,low,102047,Presencial,2.48,2,Hombre,Portal Web,3,1255430,90.0,66,Soltero,36,2019,7,high,0.8699999999999999,1,2,1157689,-1366,1,15,0
101755,102062,1,Presencial,2.4,1,Hombre,Linkedin,2,186968,58.0,76,Soltero,19,2014,12,low,102149,Presencial,0.92,2,Mujer,Referidos,6,692000,38.0,72,Soltero,21,2014,10,low,-1.48,1,4,505032,-74,1,2,1
100481,102142,1,Presencial,1.975,12,Hombre,Linkedin,7,330550,58.0,75,Casado,34,2022,8,low,102047,Presencial,2.48,2,Hombre,Portal Web,3,1255430,90.0,66,Soltero,36,2019,7,high,0.5049999999999999,-10,-4,924880,-1145,1,2,1
101392,102111,1,Presencial,1.615,0,Mujer,Referidos,2,327196,58.0,68,Soltero,32,2020,5,low,102097,Híbrida,2.04,1,Mujer,Referidos,15,1616000,94.0,67,Soltero,50,2021,5,high,0.42500000000000004,1,13,1288804,366,0,18,1
101650,102036,1,Presencial,6.72,2,Hombre,Linkedin,6,386642,58.0,84,Soltero,27,2013,4,low,102054,Presencial,1.68,8,Hombre,Portal Web,5,1616000,92.0,76,Viudo,54,2022,1,high,-5.04,6,-1,1229358,3183,0,27,0
101231,102158,1,Presencial,1.37,2,Hombre,Linkedin,10,425789,58.0,76,Casado,39,2022,3,low,102093,Presencial,1.79,1,Mujer,Referidos,27,1900000,87.0,74,Viudo,54,2013,9,high,0.41999999999999993,-1,17,1474211,-3108,1,15,1
101968,102109,1,Presencial,7.595,0,Hombre,Ferias & Networking,10,852118,58.0,75,Casado,35,2018,4,low,102123,Presencial,3.86,1,Mujer,Portal Web,5,998000,97.0,82,Casado,32,2019,9,high,-3.735,1,-5,145882,542,0,-3,0
101330,102139,1,Presencial,5.36,3,Mujer,Referidos,4,281017,58.0,69,Soltero,43,2020,6,low,102154,Presencial,6.48,1,Hombre,Ferias & Networking,5,590000,90.0,67,Casado,25,2021,6,high,1.12,-2,1,308983,385,0,-18,0
101938,102114,1,Presencial,6.065,7,Hombre,Portal Web,6,304223,58.0,77,Divorciado,46,2019,10,low,102050,Presencial,1.44,1,Mujer,Portal Web,5,1616000,91.0,69,Divorciado,47,2021,5,high,-4.625,-6,-1,1311777,589,0,1,1
101347,102130,1,Presencial,2.395,2,Hombre,Linkedin,9,695361,58.0,63,Divorciado,53,2022,10,low,102068,Presencial,1.97,6,Hombre,Linkedin,5,1616000,84.0,73,Soltero,31,2014,4,high,-0.42500000000000004,4,-4,920639,-3114,1,-22,0
101626,102031,1,Presencial,2.225,2,Mujer,Portal Web,6,894759,58.0,88,Viudo,49,2012,3,low,102111,Presencial,2.95,2,Hombre,Portal Web,8,1610000,76.0,87,Casado,31,2017,7,low,0.7250000000000001,0,2,715241,1940,0,-18,0
102268,102142,1,Presencial,1.63,2,Hombre,Ferias & Networking,1,102433,58.0,79,Soltero,21,2023,4,low,102047,Presencial,2.48,2,Hombre,Portal Web,3,1255430,90.0,66,Soltero,36,2019,7,high,0.8500000000000001,0,2,1152997,-1365,1,15,0
102842,102104,1,Presencial,6.18,3,Mujer,Portal Web,2,164962,58.0,66,Soltero,22,2020,3,low,102129,Híbrida,6.72,1,Mujer,Portal Web,6,743000,91.0,61,Soltero,30,2023,4,high,0.54,-2,4,578038,1112,0,8,1
104080,102062,1,Presencial,2.35,2,Hombre,Linkedin,2,185720,58.0,76,Soltero,19,2014,12,low,102149,Presencial,0.92,2,Mujer,Referidos,6,692000,38.0,72,Soltero,21,2014,10,low,-1.4300000000000002,0,4,506280,-71,1,2,1
103055,102111,1,Presencial,1.625,1,Mujer,Referidos,2,328663,58.0,68,Soltero,31,2020,5,low,102097,Híbrida,2.04,1,Mujer,Referidos,15,1616000,94.0,67,Soltero,50,2021,5,high,0.41500000000000004,0,13,1287337,367,0,19,0
102555,102172,1,Presencial,2.39,2,Hombre,Referidos,8,792368,58.0,64,Casado,37,2022,11,low,102020,Presencial,5.58,1,Hombre,Portal Web,7,1049000,57.0,70,Casado,29,2016,4,low,3.19,-1,-1,256632,-2399,1,-8,0
103669,102158,1,Presencial,1.35,1,Hombre,Linkedin,10,428016,58.0,76,Casado,39,2022,3,low,102093,Presencial,1.79,1,Mujer,Referidos,27,1900000,87.0,74,Viudo,54,2013,9,high,0.43999999999999995,0,17,1471984,-3108,1,15,1
103211,102058,1,Presencial,2.385,2,Mujer,Referidos,5,425609,58.0,72,Soltero,29,2013,9,low,102172,Presencial,1.4,2,Hombre,Ferias & Networking,11,1616000,75.0,71,Casado,59,2021,2,low,-0.9849999999999999,0,6,1190391,2725,0,30,0
103067,102109,1,Presencial,7.59,1,Hombre,Ferias & Networking,10,844452,58.0,75,Casado,35,2018,4,low,102123,Presencial,3.86,1,Mujer,Portal Web,5,998000,97.0,82,Casado,32,2019,9,high,-3.73,0,-5,153548,542,0,-3,1
104037,102085,1,Presencial,1.635,1,Mujer,Portal Web,9,243880,58.0,61,Casado,39,2018,8,low,102145,Presencial,6.59,4,Hombre,Portal Web,12,1616000,47.0,71,Casado,39,2015,8,low,4.955,3,3,1372120,-1106,1,0,1
104003,102140,1,Presencial,1.75,8,Hombre,Portal Web,12,286918,58.0,81,Soltero,46,2022,4,low,102040,Presencial,2.55,0,Mujer,Portal Web,16,1616000,46.0,69,Casado,39,2012,2,low,0.7999999999999998,-8,4,1329082,-3730,1,-7,1
103189,102023,1,Presencial,5.915,2,Mujer,Linkedin,12,654095,58.0,67,Soltero,42,2013,4,low,102105,Híbrida,4.9,1,Hombre,Portal Web,4,539000,80.0,65,Casado,23,2019,12,high,-1.0149999999999997,-1,-8,-115095,2442,0,-19,0
101603,102055,1,Presencial,1.85,9,Mujer,Portal Web,5,184819,57.0,71,Soltero,18,2015,2,low,102129,Presencial,1.92,2,Hombre,Referidos,8,1616000,97.0,63,Casado,42,2013,2,high,0.06999999999999984,-7,3,1431181,-713,1,24,1
101373,102127,1,Presencial,1.2,12,Hombre,Portal Web,1,209480,57.0,79,Divorciado,28,2022,7,low,102028,Presencial,4.03,2,Mujer,Linkedin,9,1306940,88.0,78,Divorciado,32,2014,5,high,2.83,-10,8,1097460,-2969,1,4,1
102172,102020,2,Presencial,5.58,1,Hombre,Portal Web,7,1049000,57.0,70,Casado,29,2016,4,low,102134,Presencial,6.63,1,Mujer,Linkedin,11,1203920,90.0,78,Casado,35,2018,12,high,1.0499999999999998,0,4,154920,961,0,6,1
101343,102020,1,Presencial,1.72,2,Mujer,Referidos,8,464724,57.0,78,Soltero,32,2013,8,low,102134,Presencial,6.63,1,Mujer,Linkedin,11,1203920,90.0,78,Casado,35,2018,12,high,4.91,-1,3,739196,1941,0,3,0
102097,102024,2,Presencial,1.95,6,Hombre,Portal Web,4,1100900,57.0,77,Soltero,31,2016,10,low,102074,Presencial,2.28,0,Hombre,Headhunter,9,1616000,84.0,70,Casado,48,2018,3,high,0.32999999999999985,-6,5,515100,509,0,17,1
100572,102024,1,Presencial,4.73,2,Mujer,Referidos,8,486169,57.0,77,Soltero,31,2012,7,low,102074,Presencial,2.28,0,Hombre,Headhunter,9,1616000,84.0,70,Casado,48,2018,3,high,-2.4500000000000006,-2,1,1129831,2067,0,17,0
100891,102081,1,Presencial,4.675,1,Mujer,Ferias & Networking,7,280389,57.0,85,Viudo,39,2016,8,low,102135,Presencial,2.5,2,Hombre,Portal Web,4,488000,26.0,64,Soltero,18,2015,8,low,-2.175,1,-3,207611,-355,1,-21,1
101345,102140,1,Presencial,1.765,9,Hombre,Portal Web,12,287021,57.0,81,Soltero,46,2022,4,low,102040,Presencial,2.55,0,Mujer,Portal Web,16,1616000,46.0,69,Casado,39,2012,2,low,0.7849999999999999,-9,4,1328979,-3728,1,-7,1
100908,102018,1,Presencial,3.92,2,Mujer,Linkedin,7,680361,57.0,75,Casado,41,2012,9,low,102160,Presencial,5.57,5,Hombre,Portal Web,3,692000,90.0,69,Divorciado,28,2022,2,high,1.6500000000000004,3,-4,11639,3461,0,-13,0
102138,102059,2,Presencial,3.26,1,Hombre,Linkedin,5,1616000,57.0,75,Soltero,44,2018,4,low,102021,Presencial,2.55,2,Hombre,Portal Web,16,1616000,27.0,76,Viudo,50,2019,6,low,-0.71,1,11,0,439,0,6,1
100954,102059,1,Presencial,2.74,2,Hombre,Ferias & Networking,16,715210,57.0,72,Viudo,45,2014,7,low,102021,Presencial,2.55,2,Hombre,Portal Web,16,1616000,27.0,76,Viudo,50,2019,6,low,-0.1900000000000004,0,0,900790,1808,0,5,0
103494,102024,1,Presencial,1.445,1,Mujer,Portal Web,3,206046,57.0,79,Divorciado,16,2012,1,low,102074,Presencial,2.28,0,Hombre,Headhunter,9,1616000,84.0,70,Casado,48,2018,3,high,0.8349999999999997,-1,6,1409954,2262,0,32,1
104127,102127,1,Presencial,1.205,13,Hombre,Portal Web,1,207984,57.0,79,Divorciado,28,2022,7,low,102028,Presencial,4.03,2,Mujer,Linkedin,9,1306940,88.0,78,Divorciado,32,2014,5,high,2.825,-11,8,1098956,-2971,1,4,1
102290,102151,1,Presencial,5.175,1,Hombre,Headhunter,4,268032,57.0,70,Casado,30,2022,9,low,102105,Presencial,1.51,2,Hombre,Ferias & Networking,10,1616000,85.0,80,Divorciado,45,2021,11,high,-3.665,1,6,1347968,-313,1,15,0
103007,102140,1,Presencial,6.57,1,Hombre,Ferias & Networking,7,286657,57.0,75,Soltero,30,2021,4,low,102040,Presencial,2.55,0,Mujer,Portal Web,16,1616000,46.0,69,Casado,39,2012,2,low,-4.0200000000000005,-1,9,1329343,-3361,1,9,1
102679,102044,1,Presencial,4.69,4,Hombre,Referidos,3,325942,57.0,72,Soltero,26,2014,11,low,102155,Presencial,1.54,1,Hombre,Ferias & Networking,14,1616000,56.0,68,Soltero,47,2023,3,low,-3.1500000000000004,-3,11,1290058,3063,0,21,1
102194,102044,1,Presencial,1.095,1,Hombre,Portal Web,8,329400,57.0,64,Casado,23,2012,8,low,102155,Presencial,1.54,1,Hombre,Ferias & Networking,14,1616000,56.0,68,Soltero,47,2023,3,low,0.44500000000000006,0,6,1286600,3869,0,24,0
103274,102075,1,Presencial,2.29,8,Hombre,Linkedin,6,393520,57.0,79,Casado,29,2015,12,low,102047,Presencial,2.7,1,Hombre,Referidos,11,1255430,90.0,76,Casado,30,2013,3,high,0.41000000000000014,-7,5,861910,-996,1,1,0
102596,102036,1,Presencial,6.69,1,Hombre,Linkedin,6,388754,57.0,84,Soltero,27,2013,4,low,102054,Presencial,1.68,8,Hombre,Portal Web,5,1616000,92.0,76,Viudo,54,2022,1,high,-5.010000000000001,7,-1,1227246,3185,0,27,0
102674,102084,1,Presencial,1.67,8,Mujer,Portal Web,4,428942,57.0,65,Casado,33,2016,7,low,102171,Presencial,2.62,3,Mujer,Portal Web,14,1616000,89.0,76,Divorciado,50,2023,7,high,0.9500000000000002,-5,10,1187058,2548,0,17,0
102327,102040,1,Presencial,1.36,2,Hombre,Referidos,5,766589,57.0,83,Soltero,30,2013,1,low,102106,Presencial,3.21,1,Hombre,Linkedin,15,1616000,91.0,84,Soltero,45,2016,7,high,1.8499999999999999,-1,10,849411,1280,0,15,0
102426,102020,1,Presencial,1.715,1,Mujer,Referidos,8,471263,57.0,78,Soltero,32,2013,8,low,102134,Presencial,6.63,1,Mujer,Linkedin,11,1203920,90.0,78,Casado,35,2018,12,high,4.915,0,3,732657,1940,0,3,0
102699,102104,1,Presencial,3.88,1,Mujer,Ferias & Networking,5,491963,57.0,76,Soltero,38,2018,4,low,102129,Híbrida,6.72,1,Mujer,Portal Web,6,743000,91.0,61,Soltero,30,2023,4,high,2.84,0,1,251037,1821,0,-8,0
104121,102059,1,Presencial,2.835,2,Mujer,Portal Web,7,489962,57.0,83,Soltero,33,2014,4,low,102021,Presencial,2.55,2,Hombre,Portal Web,16,1616000,27.0,76,Viudo,50,2019,6,low,-0.28500000000000014,0,9,1126038,1877,0,17,1
104021,102105,1,Presencial,4.1,2,Mujer,Linkedin,8,262124,57.0,79,Casado,39,2018,11,low,102113,Híbrida,2.07,0,Hombre,Linkedin,8,1616000,85.0,71,Viudo,45,2017,3,high,-2.03,-2,0,1353876,-585,1,6,1
103854,102080,1,Presencial,3.1,5,Hombre,Referidos,7,258576,57.0,82,Soltero,36,2015,7,low,102035,Presencial,1.93,0,Mujer,Linkedin,18,1616000,94.0,75,Viudo,47,2016,8,high,-1.1700000000000002,-5,11,1357424,384,0,11,0
103334,102139,1,Presencial,5.36,2,Mujer,Referidos,4,274728,57.0,69,Soltero,43,2020,6,low,102154,Presencial,6.48,1,Hombre,Ferias & Networking,5,590000,90.0,67,Casado,25,2021,6,high,1.12,-1,1,315272,385,0,-18,0
102342,102045,1,Presencial,2.425,1,Hombre,Portal Web,15,441305,57.0,70,Casado,37,2013,2,low,102171,Presencial,3.19,3,Hombre,Portal Web,11,1616000,97.0,65,Casado,53,2023,9,high,0.7650000000000001,2,-4,1174695,3870,0,16,1
104130,102065,1,Presencial,5.34,6,Mujer,Portal Web,3,838314,57.0,72,Soltero,45,2017,5,low,102026,Presencial,2.44,2,Hombre,Ferias & Networking,13,1616000,45.0,60,Divorciado,35,2014,10,low,-2.9,-4,10,777686,-961,1,-10,1
103110,102018,1,Presencial,3.89,3,Mujer,Linkedin,7,680699,57.0,75,Casado,41,2012,9,low,102160,Presencial,5.57,5,Hombre,Portal Web,3,692000,90.0,69,Divorciado,28,2022,2,high,1.6800000000000002,2,-4,11301,3458,0,-13,1
102225,102059,1,Presencial,2.78,1,Hombre,Ferias & Networking,2,715169,57.0,72,Viudo,45,2014,7,low,102021,Presencial,2.55,2,Hombre,Portal Web,16,1616000,27.0,76,Viudo,50,2019,6,low,-0.22999999999999998,1,14,900831,1808,0,5,0
102599,102081,1,Presencial,3.76,6,Hombre,Linkedin,6,901407,57.0,86,Casado,52,2017,2,low,102135,Presencial,2.5,2,Hombre,Portal Web,4,488000,26.0,64,Soltero,18,2015,8,low,-1.2599999999999998,-4,-2,-413407,-536,1,-34,1
100615,102080,1,Presencial,3.055,4,Hombre,Referidos,7,255586,56.0,82,Soltero,36,2015,7,low,102035,Presencial,1.93,0,Mujer,Linkedin,18,1616000,94.0,75,Viudo,47,2016,8,high,-1.1250000000000002,-4,11,1360414,384,0,11,1
102044,102155,2,Presencial,1.54,1,Hombre,Ferias & Networking,14,1616000,56.0,68,Soltero,47,2023,3,low,102159,Presencial,1.78,1,Mujer,Ferias & Networking,1,590000,39.0,80,Soltero,20,2016,10,low,0.24,0,-13,-1026000,-2334,1,-27,1
100198,102155,1,Presencial,1.595,12,Hombre,Linkedin,16,875725,56.0,75,Casado,52,2022,8,low,102159,Presencial,1.78,1,Mujer,Ferias & Networking,1,590000,39.0,80,Soltero,20,2016,10,low,0.18500000000000005,-11,-15,-285725,-2126,1,-32,1
102909,102043,1,Presencial,2.315,1,Mujer,Referidos,1,209631,56.0,67,Soltero,19,2014,2,low,102051,Presencial,1.03,0,Hombre,Portal Web,5,1616000,60.0,76,Casado,44,2019,5,low,-1.285,-1,4,1406369,1918,0,25,0
104005,102155,1,Presencial,1.58,13,Hombre,Linkedin,16,881553,56.0,75,Divorciado,52,2022,8,low,102159,Presencial,1.78,1,Mujer,Ferias & Networking,1,590000,39.0,80,Soltero,20,2016,10,low,0.19999999999999996,-12,-15,-291553,-2126,1,-32,1
101053,102073,1,Presencial,5.78,1,Mujer,Portal Web,9,406991,55.0,86,Casado,31,2016,6,low,102139,Presencial,1.98,2,Hombre,Portal Web,11,1306940,95.0,86,Soltero,37,2019,7,high,-3.8000000000000003,1,2,899949,1123,0,6,1
100539,102056,1,Presencial,2.5,2,Mujer,Portal Web,6,291753,55.0,77,Casado,40,2016,5,low,102014,Presencial,5.24,1,Hombre,Ferias & Networking,16,1616000,70.0,63,Viudo,65,2023,3,low,2.74,-1,10,1324247,2499,0,25,0
101270,102093,1,Presencial,2.69,3,Hombre,Portal Web,12,634299,55.0,78,Divorciado,44,2017,6,low,102139,Presencial,5.41,0,Mujer,Ferias & Networking,4,488000,89.0,62,Soltero,23,2021,6,high,2.72,-3,-8,-146299,1455,0,-21,1
100091,102028,1,Presencial,5.975,3,Mujer,Referidos,4,737063,55.0,80,Viudo,45,2012,11,low,102085,Presencial,1.39,2,Mujer,Linkedin,12,1358450,97.0,72,Soltero,35,2016,12,high,-4.585,-1,8,621387,1510,0,-10,0
103059,102115,1,Presencial,3.1,1,Hombre,Ferias & Networking,3,252976,55.0,70,Casado,26,2018,10,low,102116,Presencial,2.0,2,Mujer,Portal Web,4,1616000,94.0,76,Soltero,35,2018,12,high,-1.1,1,1,1363024,64,0,9,0
103209,102104,1,Presencial,5.055,2,Mujer,Portal Web,6,287460,55.0,71,Soltero,29,2019,6,low,102129,Híbrida,6.72,1,Mujer,Portal Web,6,743000,91.0,61,Soltero,30,2023,4,high,1.665,-1,0,455540,1386,0,1,1
103984,102040,1,Presencial,4.95,4,Hombre,Referidos,11,284165,55.0,84,Soltero,36,2012,5,low,102106,Presencial,3.21,1,Hombre,Linkedin,15,1616000,91.0,84,Soltero,45,2016,7,high,-1.7400000000000002,-3,4,1331835,1533,0,9,0
103196,102037,1,Presencial,1.83,2,Mujer,Portal Web,9,701393,55.0,73,Viudo,43,2013,7,low,102057,Presencial,1.12,1,Mujer,Linkedin,2,641000,50.0,76,Casado,21,2016,12,low,-0.71,-1,-7,-60393,1239,0,-22,0
103799,102088,1,Presencial,5.945,1,Hombre,Linkedin,16,716554,55.0,85,Viudo,49,2018,7,low,102139,Presencial,4.96,1,Mujer,Portal Web,3,488000,82.0,65,Soltero,20,2018,4,high,-0.9850000000000003,0,-13,-228554,-90,1,-29,1
102783,102028,1,Presencial,5.935,2,Mujer,Referidos,4,739016,55.0,80,Viudo,45,2012,11,low,102085,Presencial,1.39,2,Mujer,Linkedin,12,1358450,97.0,72,Soltero,35,2016,12,high,-4.545,0,8,619434,1508,0,-10,0
101395,102109,1,Presencial,5.87,2,Mujer,Referidos,1,250305,54.0,74,Soltero,27,2020,11,low,102123,Presencial,3.86,1,Mujer,Portal Web,5,998000,97.0,82,Casado,32,2019,9,high,-2.0100000000000002,-1,4,747695,-409,1,5,0
100175,102104,1,Presencial,5.09,2,Mujer,Portal Web,6,285899,54.0,71,Soltero,28,2019,6,low,102129,Híbrida,6.72,1,Mujer,Portal Web,6,743000,91.0,61,Soltero,30,2023,4,high,1.63,-1,0,457101,1387,0,2,0
100867,102066,1,Presencial,2.31,1,Mujer,Headhunter,9,871379,54.0,65,Soltero,33,2014,8,low,102171,Presencial,3.62,3,Hombre,Referidos,5,1616000,97.0,84,Casado,55,2023,12,high,1.31,2,-4,744621,3407,0,22,1
100021,102064,1,Presencial,2.485,0,Mujer,Portal Web,7,421016,54.0,76,Casado,38,2017,6,low,102067,Presencial,1.34,0,Hombre,Portal Web,6,1616000,92.0,92,Casado,43,2018,2,high,-1.1449999999999998,0,-1,1194984,221,0,5,0
100782,102040,1,Presencial,4.95,5,Hombre,Referidos,11,287219,54.0,84,Soltero,36,2012,5,low,102106,Presencial,3.21,1,Hombre,Linkedin,15,1616000,91.0,84,Soltero,45,2016,7,high,-1.7400000000000002,-4,4,1328781,1533,0,9,0
101007,102172,1,Presencial,1.615,1,Hombre,Referidos,12,315725,54.0,70,Casado,50,2023,6,low,102020,Presencial,5.58,1,Hombre,Portal Web,7,1049000,57.0,70,Casado,29,2016,4,low,3.965,0,-5,733275,-2622,1,-21,0
100623,102098,1,Presencial,3.54,2,Hombre,Ferias & Networking,13,873868,54.0,87,Divorciado,45,2017,7,low,102049,Presencial,1.8,1,Mujer,Portal Web,16,1616000,90.0,86,Casado,46,2021,1,high,-1.74,-1,3,742132,1280,0,1,0
100859,102088,1,Presencial,5.975,1,Hombre,Linkedin,16,721736,54.0,85,Viudo,49,2018,7,low,102139,Presencial,4.96,1,Mujer,Portal Web,3,488000,82.0,65,Soltero,20,2018,4,high,-1.0149999999999997,0,-13,-233736,-91,1,-29,1
102816,102154,1,Presencial,4.975,1,Hombre,Linkedin,6,227874,54.0,70,Soltero,28,2022,7,low,102172,Presencial,5.45,1,Hombre,Portal Web,7,1512980,93.0,69,Soltero,39,2017,10,high,0.47500000000000053,0,1,1285106,-1745,1,11,0
103102,102066,1,Presencial,2.3,0,Mujer,Headhunter,9,864917,54.0,65,Soltero,33,2014,8,low,102171,Presencial,3.62,3,Hombre,Referidos,5,1616000,97.0,84,Casado,55,2023,12,high,1.3200000000000003,3,-4,751083,3407,0,22,0
102993,102056,1,Presencial,2.485,2,Mujer,Portal Web,6,289582,54.0,77,Casado,40,2016,5,low,102014,Presencial,5.24,1,Hombre,Ferias & Networking,16,1616000,70.0,63,Viudo,65,2023,3,low,2.7550000000000003,-1,10,1326418,2497,0,25,0
104047,102152,1,Presencial,0.98,1,Mujer,Portal Web,5,294000,54.0,86,Divorciado,47,2021,7,low,102089,Presencial,2.75,5,Hombre,Portal Web,7,1616000,15.0,68,Soltero,47,2019,8,low,1.77,4,2,1322000,-673,1,0,1
103585,102075,1,Presencial,1.7,2,Mujer,Linkedin,3,416271,54.0,81,Viudo,41,2016,6,low,102047,Presencial,2.7,1,Hombre,Referidos,11,1255430,90.0,76,Casado,30,2013,3,high,1.0000000000000002,-1,8,839159,-1180,1,-11,1
104119,102093,1,Presencial,2.725,3,Hombre,Portal Web,12,635396,54.0,78,Divorciado,44,2017,6,low,102139,Presencial,5.41,0,Mujer,Ferias & Networking,4,488000,89.0,62,Soltero,23,2021,6,high,2.685,-3,-8,-147396,1457,0,-21,1
102480,102013,1,Presencial,1.48,3,Mujer,Portal Web,6,878834,54.0,70,Casado,46,2012,12,low,102139,Presencial,2.0,2,Mujer,Linkedin,4,743000,96.0,79,Casado,30,2022,11,high,0.52,-1,-2,-135834,3621,0,-16,1
100694,102127,1,Presencial,5.97,3,Mujer,Portal Web,1,164616,53.0,75,Soltero,22,2020,7,low,102028,Presencial,4.03,2,Mujer,Linkedin,9,1306940,88.0,78,Divorciado,32,2014,5,high,-1.9399999999999995,-1,8,1142324,-2254,1,10,1
100873,102027,1,Presencial,1.62,3,Mujer,Portal Web,6,286847,53.0,69,Casado,22,2012,11,low,102065,Presencial,3.27,1,Mujer,Linkedin,8,1306940,80.0,80,Casado,32,2014,2,high,1.65,-2,2,1020093,450,0,10,1
100862,102056,1,Presencial,1.97,1,Mujer,Linkedin,10,266062,53.0,76,Divorciado,36,2013,11,low,102014,Presencial,5.24,1,Hombre,Ferias & Networking,16,1616000,70.0,63,Viudo,65,2023,3,low,3.2700000000000005,0,6,1349938,3390,0,29,0
102537,102127,1,Presencial,5.97,3,Mujer,Portal Web,1,163294,53.0,75,Soltero,22,2020,7,low,102028,Presencial,4.03,2,Mujer,Linkedin,9,1306940,88.0,78,Divorciado,32,2014,5,high,-1.9399999999999995,-1,8,1143646,-2254,1,10,1
102937,102069,1,Presencial,3.285,3,Mujer,Portal Web,3,182963,53.0,71,Soltero,20,2017,2,low,102069,Presencial,4.64,1,Mujer,Ferias & Networking,19,1616000,47.0,74,Casado,60,2021,10,low,1.3549999999999995,-2,16,1433037,1720,0,40,1
103367,102137,1,Presencial,2.815,7,Mujer,Linkedin,2,207671,53.0,76,Casado,26,2021,2,low,102046,Presencial,1.18,0,Mujer,Portal Web,2,845000,37.0,79,Casado,27,2017,12,low,-1.635,-7,0,637329,-1139,1,1,0
102260,102027,1,Presencial,1.585,2,Mujer,Portal Web,6,285847,53.0,69,Casado,22,2012,11,low,102065,Presencial,3.27,1,Mujer,Linkedin,8,1306940,80.0,80,Casado,32,2014,2,high,1.685,-1,2,1021093,447,0,10,0
101422,102065,1,Presencial,2.015,10,Hombre,Portal Web,1,138779,52.0,76,Soltero,16,2016,3,low,102026,Presencial,2.44,2,Hombre,Ferias & Networking,13,1616000,45.0,60,Divorciado,35,2014,10,low,0.4249999999999998,-8,12,1477221,-540,1,19,1
101853,102137,1,Presencial,2.79,8,Mujer,Linkedin,2,212068,52.0,76,Casado,27,2021,2,low,102046,Presencial,1.18,0,Mujer,Portal Web,2,845000,37.0,79,Casado,27,2017,12,low,-1.61,-8,0,632932,-1139,1,0,1
102011,102048,2,Presencial,5.37,1,Hombre,Ferias & Networking,7,845000,52.0,74,Casado,22,2012,11,low,102092,Presencial,3.99,0,Mujer,Portal Web,5,590000,59.0,76,Soltero,20,2015,8,low,-1.38,-1,-2,-255000,1005,0,-2,0
100845,102048,1,Presencial,6.175,2,Mujer,Portal Web,18,735354,52.0,71,Casado,47,2015,7,low,102092,Presencial,3.99,0,Mujer,Portal Web,5,590000,59.0,76,Soltero,20,2015,8,low,-2.1849999999999996,-2,-13,-145354,29,0,-27,0
103769,102084,1,Presencial,1.435,1,Hombre,Linkedin,5,306586,52.0,64,Casado,28,2017,11,low,102171,Presencial,2.62,3,Mujer,Portal Web,14,1616000,89.0,76,Divorciado,50,2023,7,high,1.185,2,9,1309414,2069,0,22,1
100614,102076,1,Presencial,7.23,3,Mujer,Ferias & Networking,4,467268,51.0,74,Casado,36,2017,3,low,102168,Híbrida,1.95,1,Hombre,Referidos,9,1616000,95.0,82,Soltero,53,2023,9,high,-5.28,-2,5,1148732,2377,0,17,0
103640,102076,1,Presencial,7.2,2,Mujer,Ferias & Networking,4,467454,51.0,74,Casado,36,2017,3,low,102168,Híbrida,1.95,1,Hombre,Referidos,9,1616000,95.0,82,Soltero,53,2023,9,high,-5.25,-1,5,1148546,2377,0,17,1
101247,102074,1,Presencial,6.315,1,Mujer,Linkedin,5,229966,50.0,68,Casado,21,2015,6,low,102028,Presencial,1.35,0,Hombre,Ferias & Networking,4,1616000,80.0,83,Viudo,43,2015,12,high,-4.965,-1,-1,1386034,200,0,22,0
100903,102105,1,Presencial,2.765,2,Mujer,Ferias & Networking,4,270444,50.0,82,Soltero,26,2018,1,low,102113,Híbrida,2.07,0,Hombre,Linkedin,8,1616000,85.0,71,Viudo,45,2017,3,high,-0.6950000000000003,-2,4,1345556,-299,1,19,1
102037,102057,2,Presencial,1.12,1,Mujer,Linkedin,2,641000,50.0,76,Casado,21,2016,12,low,102019,Presencial,1.97,4,Hombre,Portal Web,5,1616000,90.0,73,Viudo,59,2022,12,high,0.8499999999999999,3,3,975000,2213,0,38,1
101366,102057,1,Presencial,2.005,2,Mujer,Linkedin,4,785834,50.0,77,Soltero,35,2015,6,low,102019,Presencial,1.97,4,Hombre,Portal Web,5,1616000,90.0,73,Viudo,59,2022,12,high,-0.03499999999999992,2,1,830166,2754,0,24,1
102727,102074,1,Presencial,6.315,1,Mujer,Linkedin,5,226452,50.0,68,Casado,21,2015,6,low,102028,Presencial,1.35,0,Hombre,Ferias & Networking,4,1616000,80.0,83,Viudo,43,2015,12,high,-4.965,-1,-1,1389548,199,0,22,1
103747,102105,1,Presencial,2.725,2,Mujer,Ferias & Networking,4,271203,50.0,82,Soltero,26,2018,1,low,102113,Híbrida,2.07,0,Hombre,Linkedin,8,1616000,85.0,71,Viudo,45,2017,3,high,-0.6550000000000002,-2,4,1344797,-301,1,19,1
103670,102057,1,Presencial,2.01,1,Mujer,Linkedin,4,791335,50.0,77,Soltero,35,2015,6,low,102019,Presencial,1.97,4,Hombre,Portal Web,5,1616000,90.0,73,Viudo,59,2022,12,high,-0.039999999999999813,3,1,824665,2755,0,24,0
103183,102149,1,Presencial,3.35,3,Hombre,Ferias & Networking,5,184453,49.0,66,Soltero,26,2023,1,low,102141,Presencial,2.07,0,Mujer,Headhunter,3,1409960,90.0,86,Casado,37,2017,2,high,-1.2800000000000002,-3,-2,1225507,-2142,1,11,1
102779,102036,1,Presencial,2.51,0,Hombre,Portal Web,4,714967,49.0,71,Casado,43,2012,11,low,102054,Presencial,1.68,8,Hombre,Portal Web,5,1616000,92.0,76,Viudo,54,2022,1,high,-0.8299999999999998,8,1,901033,3327,0,11,0
100327,102149,1,Presencial,3.325,3,Hombre,Ferias & Networking,5,180652,48.0,66,Soltero,26,2023,1,low,102141,Presencial,2.07,0,Mujer,Headhunter,3,1409960,90.0,86,Casado,37,2017,2,high,-1.2550000000000003,-3,-2,1229308,-2140,1,11,1
100534,102091,1,Presencial,2.52,2,Hombre,Referidos,3,226038,48.0,79,Casado,23,2017,10,low,102149,Presencial,1.54,1,Mujer,Portal Web,4,1616000,73.0,77,Casado,39,2014,12,low,-0.98,-1,1,1389962,-1036,1,16,1
101498,102069,1,Presencial,6.255,8,Mujer,Portal Web,5,350917,48.0,74,Soltero,29,2017,4,low,102069,Presencial,4.64,1,Mujer,Ferias & Networking,19,1616000,47.0,74,Casado,60,2021,10,low,-1.6150000000000002,-7,14,1265083,1637,0,31,1
100805,102041,1,Presencial,1.655,0,Mujer,Portal Web,2,391629,48.0,71,Soltero,28,2014,9,low,102147,Presencial,1.29,0,Mujer,Portal Web,8,1616000,44.0,73,Casado,51,2014,5,low,-0.365,0,6,1224371,-108,1,23,0
101921,102097,1,Presencial,4.65,0,Hombre,Linkedin,11,429690,48.0,75,Casado,35,2019,7,low,102024,Presencial,1.95,6,Hombre,Portal Web,4,1100900,57.0,77,Soltero,31,2016,10,low,-2.7,6,-7,671210,-1000,1,-4,0
101775,102083,1,Presencial,5.885,2,Hombre,Linkedin,6,465843,48.0,75,Casado,35,2016,6,low,102147,Presencial,1.61,0,Mujer,Portal Web,5,1564490,83.0,71,Soltero,44,2021,2,high,-4.2749999999999995,-2,-1,1098647,1721,0,9,1
101582,102041,1,Presencial,3.225,1,Mujer,Portal Web,11,486675,48.0,69,Divorciado,33,2013,8,low,102147,Presencial,1.29,0,Mujer,Portal Web,8,1616000,44.0,73,Casado,51,2014,5,low,-1.935,-1,-3,1129325,288,0,18,0
100677,102121,1,Presencial,1.67,5,Hombre,Portal Web,10,268508,48.0,83,Soltero,45,2022,6,low,102127,Híbrida,1.63,2,Hombre,Portal Web,4,1616000,90.0,77,Divorciado,44,2012,2,high,-0.040000000000000036,-3,-6,1347492,-3750,1,-1,1
100302,102103,1,Presencial,2.15,1,Hombre,Portal Web,12,269891,48.0,61,Soltero,41,2019,11,low,102023,Presencial,1.69,6,Hombre,Portal Web,3,1616000,90.0,74,Casado,45,2013,5,high,-0.45999999999999996,5,-9,1346109,-2380,1,4,0
101374,102088,1,Presencial,1.555,3,Mujer,Linkedin,14,310875,48.0,87,Soltero,44,2018,6,low,102139,Presencial,4.96,1,Mujer,Portal Web,3,488000,82.0,65,Soltero,20,2018,4,high,3.4050000000000002,-2,-11,177125,-78,1,-24,1
101735,102089,1,Presencial,2.04,3,Hombre,Linkedin,9,655535,48.0,76,Viudo,45,2017,7,low,102077,Presencial,2.75,1,Hombre,Ferias & Networking,6,1616000,96.0,69,Divorciado,60,2021,10,high,0.71,-2,-3,960465,1563,0,15,0
101002,102027,1,Presencial,2.055,2,Hombre,Portal Web,4,657436,48.0,72,Divorciado,41,2013,9,low,102065,Presencial,3.27,1,Mujer,Linkedin,8,1306940,80.0,80,Casado,32,2014,2,high,1.2149999999999999,-1,4,649504,148,0,-9,0
101047,102141,1,Presencial,1.705,3,Mujer,Portal Web,13,679846,48.0,80,Viudo,51,2021,11,low,102134,Presencial,1.88,1,Mujer,Linkedin,3,1100900,64.0,69,Soltero,32,2018,5,low,0.17499999999999982,-2,-10,421054,-1265,1,-19,0
101404,102081,1,Presencial,2.355,6,Hombre,Linkedin,5,817723,48.0,83,Soltero,46,2017,6,low,102135,Presencial,2.5,2,Hombre,Portal Web,4,488000,26.0,64,Soltero,18,2015,8,low,0.14500000000000002,-4,-1,-329723,-663,1,-28,1
101202,102080,1,Presencial,5.8,6,Mujer,Portal Web,18,674325,48.0,70,Viudo,44,2015,8,low,102035,Presencial,1.93,0,Mujer,Linkedin,18,1616000,94.0,75,Viudo,47,2016,8,high,-3.87,-6,0,941675,374,0,3,0
100696,102061,1,Presencial,3.69,1,Mujer,Portal Web,7,677297,48.0,78,Soltero,44,2015,2,low,102115,Presencial,2.14,2,Hombre,Ferias & Networking,10,1203920,37.0,80,Casado,29,2012,11,low,-1.5499999999999998,1,3,526623,-835,1,-15,1
100944,102124,1,Presencial,1.75,3,Hombre,Ferias & Networking,7,722474,48.0,74,Viudo,51,2019,4,low,102099,Presencial,2.84,2,Mujer,Linkedin,4,947000,90.0,70,Soltero,24,2012,10,high,1.0899999999999999,-1,-3,224526,-2360,1,-27,1
104161,102144,1,Presencial,2.26,1,Mujer,Portal Web,3,143213,48.0,68,Soltero,23,2023,3,low,102156,Presencial,2.13,8,Mujer,Portal Web,11,1616000,5.0,82,Viudo,58,2015,6,low,-0.1299999999999999,7,8,1472787,-2826,1,35,1
102807,102091,1,Presencial,2.51,1,Hombre,Referidos,3,226975,48.0,79,Casado,24,2017,10,low,102149,Presencial,1.54,1,Mujer,Portal Web,4,1616000,73.0,77,Casado,39,2014,12,low,-0.9699999999999998,0,1,1389025,-1036,1,15,1
103032,102064,1,Presencial,2.845,4,Mujer,Referidos,4,391073,48.0,70,Casado,30,2016,5,low,102067,Presencial,1.34,0,Hombre,Portal Web,6,1616000,92.0,92,Casado,43,2018,2,high,-1.5050000000000001,-4,2,1224927,619,0,13,1
102436,102123,1,Presencial,1.595,2,Mujer,Portal Web,12,849877,48.0,82,Casado,37,2019,2,low,102043,Presencial,5.5,1,Mujer,Linkedin,16,1616000,42.0,66,Soltero,51,2021,9,low,3.9050000000000002,-1,4,766123,960,0,14,0
102251,102041,1,Presencial,3.205,0,Mujer,Portal Web,11,491692,48.0,69,Divorciado,33,2013,8,low,102147,Presencial,1.29,0,Mujer,Portal Web,8,1616000,44.0,73,Casado,51,2014,5,low,-1.915,0,-3,1124308,289,0,18,0
103955,102129,1,Presencial,0.965,1,Hombre,Linkedin,11,416688,48.0,63,Viudo,46,2020,2,low,102142,Presencial,2.1,2,Mujer,Linkedin,3,590000,41.0,74,Soltero,24,2020,1,low,1.1350000000000002,1,-8,173312,-35,1,-22,1
102414,102089,1,Presencial,2.035,4,Hombre,Linkedin,9,656597,48.0,76,Viudo,45,2017,7,low,102077,Presencial,2.75,1,Hombre,Ferias & Networking,6,1616000,96.0,69,Divorciado,60,2021,10,high,0.7149999999999999,-3,-3,959403,1564,0,15,0
103006,102027,1,Presencial,2.045,1,Hombre,Portal Web,4,655184,48.0,72,Divorciado,41,2013,9,low,102065,Presencial,3.27,1,Mujer,Linkedin,8,1306940,80.0,80,Casado,32,2014,2,high,1.225,0,4,651756,149,0,-9,1
102352,102081,1,Presencial,2.32,6,Hombre,Linkedin,5,820035,48.0,83,Casado,46,2017,6,low,102135,Presencial,2.5,2,Hombre,Portal Web,4,488000,26.0,64,Soltero,18,2015,8,low,0.18000000000000016,-4,-1,-332035,-660,1,-28,0
103415,102080,1,Presencial,5.815,5,Mujer,Portal Web,18,675565,48.0,70,Viudo,44,2015,8,low,102035,Presencial,1.93,0,Mujer,Linkedin,18,1616000,94.0,75,Viudo,47,2016,8,high,-3.8850000000000007,-5,0,940435,377,0,3,1
103800,102061,1,Presencial,3.71,1,Mujer,Portal Web,7,676686,48.0,78,Soltero,44,2015,2,low,102115,Presencial,2.14,2,Hombre,Ferias & Networking,10,1203920,37.0,80,Casado,29,2012,11,low,-1.5699999999999998,1,3,527234,-837,1,-15,1
103023,102124,1,Presencial,1.79,2,Hombre,Ferias & Networking,7,716181,48.0,74,Viudo,50,2019,4,low,102099,Presencial,2.84,2,Mujer,Linkedin,4,947000,90.0,70,Soltero,24,2012,10,high,1.0499999999999998,0,-3,230819,-2359,1,-26,1
102648,102137,1,Presencial,1.865,1,Mujer,Referidos,7,741180,48.0,71,Casado,53,2021,3,low,102046,Presencial,1.18,0,Mujer,Portal Web,2,845000,37.0,79,Casado,27,2017,12,low,-0.685,-1,-5,103820,-1172,1,-26,0
100841,102089,1,Presencial,1.865,1,Mujer,Linkedin,2,82077,47.0,98,Soltero,16,2019,3,low,102077,Presencial,2.75,1,Hombre,Ferias & Networking,6,1616000,96.0,69,Divorciado,60,2021,10,high,0.885,0,4,1533923,944,0,44,1
100861,102094,1,Presencial,1.44,2,Mujer,Linkedin,1,96450,47.0,74,Soltero,16,2018,6,low,102095,Presencial,1.32,1,Hombre,Portal Web,4,998000,90.0,85,Casado,28,2016,2,high,-0.11999999999999988,-1,3,901550,-851,1,12,0
100286,102099,1,Presencial,1.485,3,Mujer,Portal Web,1,163300,47.0,66,Soltero,21,2019,11,low,102080,Presencial,1.71,0,Hombre,Portal Web,11,1616000,76.0,80,Viudo,51,2021,10,low,0.22499999999999987,-3,10,1452700,687,0,30,1
101320,102102,1,Presencial,4.535,2,Hombre,Ferias & Networking,1,231384,47.0,75,Soltero,25,2018,10,low,102018,Presencial,2.48,0,Hombre,Portal Web,5,1616000,92.0,63,Viudo,49,2019,4,high,-2.055,-2,4,1384616,186,0,24,0
100436,102026,1,Presencial,2.025,0,Mujer,Portal Web,1,226429,47.0,74,Soltero,19,2013,3,low,102101,Presencial,2.7,1,Mujer,Portal Web,15,1616000,97.0,79,Casado,58,2017,6,high,0.6750000000000003,1,14,1389571,1565,0,39,0
100070,102131,1,Presencial,4.55,2,Mujer,Portal Web,4,267475,47.0,84,Casado,29,2020,11,low,102109,Presencial,5.54,0,Hombre,Linkedin,3,998000,39.0,77,Soltero,34,2021,12,low,0.9900000000000002,-2,-1,730525,415,0,5,1
100420,102042,1,Presencial,2.09,1,Hombre,Ferias & Networking,2,311648,47.0,70,Casado,25,2015,4,low,102107,Presencial,2.19,2,Hombre,Ferias & Networking,8,1616000,38.0,78,Divorciado,57,2018,6,low,0.10000000000000009,1,6,1304352,1176,0,32,0
100963,102014,1,Presencial,4.145,0,Hombre,Ferias & Networking,2,291371,47.0,82,Casado,21,2012,10,low,102096,Presencial,1.78,1,Mujer,Portal Web,2,488000,98.0,78,Soltero,25,2023,1,high,-2.3649999999999993,1,0,196629,3736,0,4,0
100616,102042,1,Presencial,1.085,2,Mujer,Portal Web,8,348969,47.0,84,Casado,28,2015,5,low,102107,Presencial,2.19,2,Hombre,Ferias & Networking,8,1616000,38.0,78,Divorciado,57,2018,6,low,1.105,0,0,1267031,1152,0,29,0
100745,102064,1,Presencial,2.83,3,Mujer,Referidos,4,391157,47.0,70,Casado,30,2016,5,low,102067,Presencial,1.34,0,Hombre,Portal Web,6,1616000,92.0,92,Casado,43,2018,2,high,-1.49,-3,2,1224843,622,0,13,1
100573,102091,1,Presencial,5.09,3,Hombre,Referidos,7,468011,47.0,87,Soltero,35,2017,1,low,102149,Presencial,1.54,1,Mujer,Portal Web,4,1616000,73.0,77,Casado,39,2014,12,low,-3.55,-2,-3,1147989,-740,1,4,1
101093,102135,1,Presencial,1.04,3,Hombre,Portal Web,4,257457,47.0,75,Casado,42,2021,5,low,102028,Presencial,2.04,1,Hombre,Portal Web,2,1616000,82.0,75,Divorciado,49,2017,10,high,1.0,-2,-2,1358543,-1321,1,7,0
100246,102047,1,Presencial,7.21,1,Mujer,Portal Web,7,255572,47.0,82,Soltero,35,2014,4,low,102089,Presencial,2.67,1,Hombre,Linkedin,4,743000,14.0,70,Casado,22,2015,11,low,-4.54,0,-3,487428,574,0,-13,1
101239,102092,1,Presencial,5.095,0,Mujer,Referidos,12,290974,47.0,72,Soltero,41,2017,1,low,102120,Presencial,1.23,6,Mujer,Linkedin,13,1616000,98.0,95,Viudo,41,2013,6,high,-3.8649999999999998,6,1,1325026,-1298,1,0,0
100219,102061,1,Presencial,1.09,3,Hombre,Portal Web,12,309072,47.0,78,Divorciado,42,2016,3,low,102115,Presencial,2.14,2,Hombre,Ferias & Networking,10,1203920,37.0,80,Casado,29,2012,11,low,1.05,-1,-2,894848,-1228,1,-13,0
101112,102116,1,Presencial,2.04,2,Hombre,Ferias & Networking,5,640468,47.0,72,Viudo,48,2020,9,low,102021,Presencial,2.32,0,Mujer,Portal Web,22,1616000,94.0,76,Casado,59,2020,7,high,0.2799999999999998,-2,17,975532,-53,1,11,1
101954,102063,1,Presencial,1.82,2,Mujer,Portal Web,16,656693,47.0,67,Divorciado,44,2016,1,low,102135,Presencial,2.73,0,Mujer,Linkedin,1,539000,26.0,75,Soltero,24,2021,4,low,0.9099999999999999,-2,-15,-117693,1899,0,-20,1
102085,102145,2,Presencial,6.59,4,Hombre,Portal Web,12,1616000,47.0,71,Casado,39,2015,8,low,102116,Presencial,1.43,1,Mujer,Portal Web,3,692000,89.0,73,Viudo,23,2016,12,high,-5.16,-3,-9,-924000,483,0,-16,1
100359,102145,1,Presencial,1.43,1,Mujer,Ferias & Networking,17,698776,47.0,80,Casado,53,2023,2,low,102116,Presencial,1.43,1,Mujer,Portal Web,3,692000,89.0,73,Viudo,23,2016,12,high,0.0,0,-14,-6776,-2262,1,-30,0
101719,102112,1,Presencial,2.22,2,Mujer,Portal Web,4,701435,47.0,77,Casado,48,2018,8,low,102031,Presencial,2.27,7,Hombre,Linkedin,1,692000,83.0,74,Soltero,26,2020,6,high,0.04999999999999982,5,-3,-9435,679,0,-22,1
102021,102069,2,Presencial,2.25,1,Hombre,Linkedin,8,1616000,47.0,80,Casado,52,2017,3,low,102069,Presencial,4.64,1,Mujer,Ferias & Networking,19,1616000,47.0,74,Casado,60,2021,10,low,2.3899999999999997,0,11,0,1672,0,8,1
102069,102069,2,Presencial,4.64,1,Mujer,Ferias & Networking,19,1616000,47.0,74,Casado,60,2021,10,low,102069,Presencial,4.64,1,Mujer,Ferias & Networking,19,1616000,47.0,74,Casado,60,2021,10,low,0.0,0,0,0,0,1,0,1
102107,102069,2,Presencial,2.4,1,Mujer,Linkedin,8,1616000,47.0,79,Casado,63,2023,6,low,102069,Presencial,4.64,1,Mujer,Ferias & Networking,19,1616000,47.0,74,Casado,60,2021,10,low,2.2399999999999998,0,11,0,-607,1,-3,1
103017,102069,1,Presencial,1.5,3,Mujer,Portal Web,1,166406,47.0,76,Soltero,17,2015,5,low,102069,Presencial,4.64,1,Mujer,Ferias & Networking,19,1616000,47.0,74,Casado,60,2021,10,low,3.1399999999999997,-2,18,1449594,2355,0,43,0
102329,102122,1,Presencial,1.9,1,Hombre,Ferias & Networking,3,160510,47.0,76,Soltero,22,2020,5,low,102075,Presencial,1.83,4,Hombre,Portal Web,6,1616000,90.0,66,Viudo,48,2019,3,high,-0.06999999999999984,3,3,1455490,-429,1,26,0
102359,102104,1,Presencial,2.615,2,Mujer,Referidos,2,167657,47.0,75,Soltero,22,2019,12,low,102129,Híbrida,6.72,1,Mujer,Portal Web,6,743000,91.0,61,Soltero,30,2023,4,high,4.1049999999999995,-1,4,575343,1217,0,8,1
103873,102099,1,Presencial,1.495,3,Mujer,Portal Web,1,161338,47.0,66,Soltero,22,2019,11,low,102080,Presencial,1.71,0,Hombre,Portal Web,11,1616000,76.0,80,Viudo,51,2021,10,low,0.21499999999999986,-3,10,1454662,687,0,29,1
103084,102065,1,Presencial,5.71,1,Mujer,Ferias & Networking,4,232294,47.0,72,Casado,23,2017,9,low,102026,Presencial,2.44,2,Hombre,Ferias & Networking,13,1616000,45.0,60,Divorciado,35,2014,10,low,-3.27,1,9,1383706,-1088,1,12,0
104084,102094,1,Presencial,2.39,10,Mujer,Linkedin,5,269008,47.0,76,Soltero,27,2019,5,low,102095,Presencial,1.32,1,Hombre,Portal Web,4,998000,90.0,85,Casado,28,2016,2,high,-1.07,-9,-1,728992,-1185,1,1,1
102829,102014,1,Presencial,3.34,1,Hombre,Ferias & Networking,7,311577,47.0,70,Soltero,23,2013,3,low,102096,Presencial,1.78,1,Mujer,Portal Web,2,488000,98.0,78,Soltero,25,2023,1,high,-1.5599999999999998,0,-5,176423,3596,0,2,1
103133,102042,1,Presencial,1.06,2,Mujer,Portal Web,8,352225,47.0,84,Casado,28,2015,5,low,102107,Presencial,2.19,2,Hombre,Ferias & Networking,8,1616000,38.0,78,Divorciado,57,2018,6,low,1.13,0,0,1263775,1149,0,29,1
102659,102171,1,Presencial,1.39,1,Hombre,Portal Web,4,412634,47.0,72,Soltero,38,2023,6,low,102088,Presencial,2.57,4,Hombre,Linkedin,8,1616000,80.0,69,Casado,43,2017,10,high,1.18,3,4,1203366,-2084,1,5,0
102625,102052,1,Presencial,6.05,0,Mujer,Referidos,11,445978,47.0,72,Casado,32,2015,10,low,102093,Presencial,4.45,0,Hombre,Linkedin,5,641000,84.0,76,Divorciado,17,2012,4,high,-1.5999999999999996,0,-6,195022,-1298,1,-15,0
103358,102091,1,Presencial,5.055,3,Hombre,Referidos,7,465025,47.0,87,Soltero,35,2017,1,low,102149,Presencial,1.54,1,Mujer,Portal Web,4,1616000,73.0,77,Casado,39,2014,12,low,-3.5149999999999997,-2,-3,1150975,-739,1,4,0
103740,102135,1,Presencial,1.06,3,Hombre,Portal Web,4,254605,47.0,75,Casado,42,2021,5,low,102028,Presencial,2.04,1,Hombre,Portal Web,2,1616000,82.0,75,Divorciado,49,2017,10,high,0.98,-2,-2,1361395,-1321,1,7,0
103096,102120,1,Presencial,2.38,1,Hombre,Headhunter,5,440569,47.0,78,Soltero,44,2019,12,low,102171,Presencial,6.48,2,Hombre,Ferias & Networking,9,1616000,80.0,71,Casado,47,2023,8,high,4.1000000000000005,1,4,1175431,1340,0,3,1
104107,102112,1,Presencial,1.645,0,Mujer,Linkedin,15,373470,47.0,76,Divorciado,43,2018,3,low,102031,Presencial,2.27,7,Hombre,Linkedin,1,692000,83.0,74,Soltero,26,2020,6,high,0.625,7,-14,318530,837,0,-17,0
102984,102061,1,Presencial,1.095,3,Hombre,Portal Web,12,308226,47.0,78,Divorciado,42,2016,3,low,102115,Presencial,2.14,2,Hombre,Ferias & Networking,10,1203920,37.0,80,Casado,29,2012,11,low,1.0450000000000002,-1,-2,895694,-1228,1,-13,0
104054,102063,1,Presencial,1.84,1,Mujer,Portal Web,16,655806,47.0,67,Divorciado,44,2016,2,low,102135,Presencial,2.73,0,Mujer,Linkedin,1,539000,26.0,75,Soltero,24,2021,4,low,0.8899999999999999,-1,-15,-116806,1898,0,-20,0
103598,102141,1,Presencial,1.66,2,Mujer,Portal Web,13,681205,47.0,80,Viudo,51,2021,11,low,102134,Presencial,1.88,1,Mujer,Linkedin,3,1100900,64.0,69,Soltero,32,2018,5,low,0.21999999999999997,-1,-10,419695,-1265,1,-19,0
103152,102145,1,Presencial,1.405,0,Mujer,Ferias & Networking,17,701859,47.0,80,Divorciado,53,2023,2,low,102116,Presencial,1.43,1,Mujer,Portal Web,3,692000,89.0,73,Viudo,23,2016,12,high,0.02499999999999991,1,-14,-9859,-2264,1,-30,0
100241,102079,1,Presencial,2.45,1,Hombre,Referidos,1,184073,46.0,75,Soltero,21,2018,1,low,102146,Presencial,2.63,1,Mujer,Portal Web,4,1358450,80.0,81,Soltero,35,2016,3,high,0.17999999999999972,0,3,1174377,-669,1,14,1
100885,102070,1,Presencial,4.895,2,Mujer,Linkedin,1,190649,46.0,70,Soltero,21,2016,6,low,102035,Presencial,1.7,1,Mujer,Referidos,4,1616000,77.0,73,Viudo,38,2013,3,low,-3.1949999999999994,-1,3,1425351,-1186,1,17,0
101699,102131,1,Presencial,2.0,2,Mujer,Linkedin,7,246682,46.0,87,Divorciado,28,2021,4,low,102109,Presencial,5.54,0,Hombre,Linkedin,3,998000,39.0,77,Soltero,34,2021,12,low,3.54,-2,-4,751318,264,0,6,1
101235,102014,1,Presencial,3.365,0,Hombre,Ferias & Networking,7,312181,46.0,70,Soltero,23,2013,3,low,102096,Presencial,1.78,1,Mujer,Portal Web,2,488000,98.0,78,Soltero,25,2023,1,high,-1.5850000000000002,1,-5,175819,3598,0,2,0
100989,102073,1,Presencial,3.15,5,Hombre,Portal Web,3,352076,46.0,85,Casado,29,2016,11,low,102139,Presencial,1.98,2,Hombre,Portal Web,11,1306940,95.0,86,Soltero,37,2019,7,high,-1.17,-3,8,954864,977,0,8,0
101492,102064,1,Presencial,4.43,0,Mujer,Ferias & Networking,3,390250,46.0,83,Soltero,30,2016,6,low,102067,Presencial,1.34,0,Hombre,Portal Web,6,1616000,92.0,92,Casado,43,2018,2,high,-3.09,0,3,1225750,582,0,13,0
100118,102106,1,Presencial,6.215,3,Mujer,Portal Web,11,429510,46.0,80,Casado,35,2019,8,low,102081,Presencial,1.39,1,Mujer,Ferias & Networking,5,1049000,86.0,86,Soltero,32,2019,6,high,-4.825,-2,-6,619490,-55,1,-3,1
100604,102144,1,Presencial,2.1,2,Mujer,Referidos,6,432902,46.0,71,Soltero,37,2021,6,low,102156,Presencial,2.13,8,Mujer,Portal Web,11,1616000,5.0,82,Viudo,58,2015,6,low,0.029999999999999805,6,5,1183098,-2170,1,21,0
101647,102109,1,Presencial,2.525,3,Mujer,Referidos,4,472354,46.0,77,Soltero,38,2020,12,low,102123,Presencial,3.86,1,Mujer,Portal Web,5,998000,97.0,82,Casado,32,2019,9,high,1.335,-2,1,525646,-443,1,-6,0
102113,102041,2,Presencial,2.96,2,Hombre,Portal Web,6,1152410,46.0,75,Casado,27,2012,1,low,102147,Presencial,1.29,0,Mujer,Portal Web,8,1616000,44.0,73,Casado,51,2014,5,low,-1.67,-2,2,463590,852,0,24,1
100350,102041,1,Presencial,1.555,2,Mujer,Linkedin,6,512437,46.0,70,Divorciado,36,2015,10,low,102147,Presencial,1.29,0,Mujer,Portal Web,8,1616000,44.0,73,Casado,51,2014,5,low,-0.2649999999999999,-2,2,1103563,-509,1,15,0
101658,102043,1,Presencial,8.22,7,Mujer,Linkedin,5,811450,46.0,72,Casado,33,2012,8,low,102051,Presencial,1.03,0,Hombre,Portal Web,5,1616000,60.0,76,Casado,44,2019,5,low,-7.19,-7,0,804550,2473,0,11,1
101950,102051,1,Presencial,6.41,0,Mujer,Portal Web,4,285119,46.0,71,Casado,39,2015,6,low,102075,Híbrida,1.39,1,Hombre,Portal Web,11,1616000,83.0,76,Casado,46,2019,11,high,-5.0200000000000005,1,7,1330881,1624,0,7,0
101608,102120,1,Presencial,2.37,0,Hombre,Headhunter,5,440535,46.0,78,Soltero,44,2019,12,low,102171,Presencial,6.48,2,Hombre,Ferias & Networking,9,1616000,80.0,71,Casado,47,2023,8,high,4.11,2,4,1175465,1342,0,3,1
100084,102130,1,Presencial,3.43,2,Hombre,Portal Web,3,305880,46.0,67,Viudo,47,2020,10,low,102068,Presencial,1.97,6,Hombre,Linkedin,5,1616000,84.0,73,Soltero,31,2014,4,high,-1.4600000000000002,4,2,1310120,-2384,1,-16,1
100917,102008,1,Presencial,3.885,1,Mujer,Portal Web,11,431500,46.0,79,Soltero,39,2012,9,low,102107,Presencial,3.99,1,Mujer,Linkedin,7,405435,90.0,82,Soltero,39,2023,1,high,0.10500000000000043,0,-4,-26065,3777,0,0,0
100702,102144,1,Presencial,4.785,2,Mujer,Referidos,5,656552,46.0,68,Divorciado,49,2021,9,low,102156,Presencial,2.13,8,Mujer,Portal Web,11,1616000,5.0,82,Viudo,58,2015,6,low,-2.6550000000000002,6,6,959448,-2267,1,9,1
101504,102051,1,Presencial,2.715,9,Mujer,Portal Web,3,695207,46.0,77,Viudo,46,2015,10,low,102075,Híbrida,1.39,1,Hombre,Portal Web,11,1616000,83.0,76,Casado,46,2019,11,high,-1.325,-8,8,920793,1505,0,0,1
102140,102040,2,Presencial,2.55,0,Mujer,Portal Web,16,1616000,46.0,69,Casado,39,2012,2,low,102106,Presencial,3.21,1,Hombre,Linkedin,15,1616000,91.0,84,Soltero,45,2016,7,high,0.6600000000000001,1,-1,0,1626,0,6,0
102108,102040,2,Presencial,2.92,1,Mujer,Portal Web,5,1616000,46.0,75,Casado,50,2023,5,low,102106,Presencial,3.21,1,Hombre,Linkedin,15,1616000,91.0,84,Soltero,45,2016,7,high,0.29000000000000004,0,10,0,-2501,1,-5,1
100849,102040,1,Presencial,1.46,6,Mujer,Portal Web,8,817764,46.0,58,Divorciado,46,2013,6,low,102106,Presencial,3.21,1,Hombre,Linkedin,15,1616000,91.0,84,Soltero,45,2016,7,high,1.75,-5,7,798236,1132,0,-1,1
102128,102056,2,Presencial,4.11,10,Mujer,Portal Web,16,1616000,46.0,72,Soltero,55,2021,2,low,102014,Presencial,5.24,1,Hombre,Ferias & Networking,16,1616000,70.0,63,Viudo,65,2023,3,low,1.13,-9,0,0,750,0,10,1
102306,102056,1,Presencial,1.8,1,Hombre,Portal Web,3,163904,46.0,83,Casado,17,2016,3,low,102014,Presencial,5.24,1,Hombre,Ferias & Networking,16,1616000,70.0,63,Viudo,65,2023,3,low,3.4400000000000004,0,13,1452096,2539,0,48,0
103071,102050,1,Presencial,1.765,0,Hombre,Portal Web,4,412555,46.0,74,Casado,30,2015,7,low,102069,Presencial,3.7,0,Mujer,Linkedin,11,1512980,90.0,88,Soltero,40,2017,10,high,1.9350000000000003,0,7,1100425,830,0,10,0
103609,102144,1,Presencial,2.06,3,Mujer,Referidos,6,430342,46.0,71,Soltero,37,2021,6,low,102156,Presencial,2.13,8,Mujer,Portal Web,11,1616000,5.0,82,Viudo,58,2015,6,low,0.06999999999999984,5,5,1185658,-2170,1,21,0
103540,102030,1,Presencial,5.76,9,Hombre,Linkedin,4,508309,46.0,74,Divorciado,34,2014,5,low,102058,Presencial,6.34,0,Mujer,Referidos,14,1616000,90.0,76,Viudo,41,2015,4,high,0.5800000000000001,-9,10,1107691,315,0,7,1
103425,102047,1,Presencial,7.185,1,Mujer,Portal Web,7,256574,46.0,82,Soltero,35,2014,4,low,102089,Presencial,2.67,1,Hombre,Linkedin,4,743000,14.0,70,Casado,22,2015,11,low,-4.515,0,-3,486426,575,0,-13,1
102831,102124,1,Presencial,2.11,1,Mujer,Portal Web,6,309379,46.0,83,Casado,47,2021,2,low,102099,Presencial,2.84,2,Mujer,Linkedin,4,947000,90.0,70,Soltero,24,2012,10,high,0.73,1,-2,637621,-3035,1,-23,1
103072,102130,1,Presencial,3.43,2,Hombre,Portal Web,3,306544,46.0,67,Viudo,47,2020,10,low,102068,Presencial,1.97,6,Hombre,Linkedin,5,1616000,84.0,73,Soltero,31,2014,4,high,-1.4600000000000002,4,2,1309456,-2384,1,-16,0
102667,102116,1,Presencial,4.045,0,Mujer,Referidos,14,655724,46.0,72,Divorciado,47,2019,5,low,102021,Presencial,2.32,0,Mujer,Portal Web,22,1616000,94.0,76,Casado,59,2020,7,high,-1.725,0,8,960276,437,0,12,0
104050,102051,1,Presencial,2.715,8,Mujer,Portal Web,3,700286,46.0,77,Viudo,46,2015,9,low,102075,Híbrida,1.39,1,Hombre,Portal Web,11,1616000,83.0,76,Casado,46,2019,11,high,-1.325,-7,8,915714,1506,0,0,1
102505,102085,1,Presencial,5.5,2,Hombre,Portal Web,9,734154,46.0,69,Casado,51,2018,5,low,102145,Presencial,6.59,4,Hombre,Portal Web,12,1616000,47.0,71,Casado,39,2015,8,low,1.0899999999999999,2,3,881846,-1026,1,-12,1
104164,102132,1,Presencial,5.235,8,Mujer,Linkedin,6,859714,46.0,75,Divorciado,58,2021,9,low,102138,Presencial,4.51,1,Hombre,Linkedin,16,1616000,25.0,80,Viudo,45,2014,3,low,-0.7250000000000005,-7,10,756286,-2744,1,-13,1
102862,102108,1,Presencial,1.66,0,Mujer,Linkedin,10,920364,46.0,67,Divorciado,58,2020,8,low,102040,Presencial,2.92,1,Mujer,Portal Web,5,1616000,46.0,75,Casado,50,2023,5,low,1.26,1,-5,695636,1028,0,-8,1
101480,102130,1,Presencial,3.055,0,Mujer,Linkedin,1,80820,45.0,76,Soltero,19,2021,11,low,102068,Presencial,1.97,6,Hombre,Linkedin,5,1616000,84.0,73,Soltero,31,2014,4,high,-1.0850000000000002,6,4,1535180,-2776,1,12,1
101035,102057,1,Presencial,6.63,2,Mujer,Linkedin,1,99982,45.0,65,Casado,12,2013,11,low,102019,Presencial,1.97,4,Hombre,Portal Web,5,1616000,90.0,73,Viudo,59,2022,12,high,-4.66,2,4,1516018,3322,0,47,1
101321,102017,1,Presencial,4.185,1,Hombre,Linkedin,3,119605,45.0,69,Soltero,12,2013,9,low,102035,Presencial,4.62,0,Mujer,Linkedin,2,641000,90.0,84,Casado,25,2019,11,high,0.4350000000000005,-1,-1,521395,2258,0,13,1
101419,102098,1,Presencial,2.245,5,Mujer,Portal Web,4,232960,45.0,64,Soltero,23,2017,10,low,102049,Presencial,1.8,1,Mujer,Portal Web,16,1616000,90.0,86,Casado,46,2021,1,high,-0.44500000000000006,-4,12,1383040,1200,0,23,1
101701,102079,1,Presencial,1.64,3,Hombre,Portal Web,4,273797,45.0,74,Casado,27,2018,11,low,102146,Presencial,2.63,1,Mujer,Portal Web,4,1358450,80.0,81,Soltero,35,2016,3,high,0.99,-2,0,1084653,-981,1,8,1
101620,102083,1,Presencial,1.305,2,Mujer,Referidos,10,391092,45.0,67,Soltero,32,2018,5,low,102147,Presencial,1.61,0,Mujer,Portal Web,5,1564490,83.0,71,Soltero,44,2021,2,high,0.30500000000000016,-2,-5,1173398,1011,0,12,0
101282,102050,1,Presencial,1.735,0,Hombre,Portal Web,4,410364,45.0,74,Casado,30,2015,7,low,102069,Presencial,3.7,0,Mujer,Linkedin,11,1512980,90.0,88,Soltero,40,2017,10,high,1.965,0,7,1102616,829,0,10,0
100683,102135,1,Presencial,2.73,1,Hombre,Linkedin,9,411797,45.0,83,Casado,37,2022,1,low,102028,Presencial,2.04,1,Hombre,Portal Web,2,1616000,82.0,75,Divorciado,49,2017,10,high,-0.69,0,-7,1204203,-1562,1,12,0
100733,102082,1,Presencial,1.955,2,Mujer,Linkedin,10,425685,45.0,80,Soltero,35,2018,5,low,102050,Presencial,5.5,2,Mujer,Linkedin,7,1616000,81.0,70,Casado,36,2018,8,high,3.545,0,-3,1190315,92,0,1,1
101014,102122,1,Presencial,2.5,0,Mujer,Linkedin,10,492897,45.0,76,Casado,39,2019,12,low,102075,Presencial,1.83,4,Hombre,Portal Web,6,1616000,90.0,66,Viudo,48,2019,3,high,-0.6699999999999999,4,-4,1123103,-257,1,9,1
100506,102030,1,Presencial,5.71,9,Hombre,Portal Web,4,508948,45.0,74,Divorciado,34,2014,5,low,102058,Presencial,6.34,0,Mujer,Referidos,14,1616000,90.0,76,Viudo,41,2015,4,high,0.6299999999999999,-9,10,1107052,315,0,7,1
101917,102024,1,Presencial,2.035,2,Hombre,Portal Web,5,506946,45.0,63,Casado,34,2014,3,low,102074,Presencial,2.28,0,Hombre,Headhunter,9,1616000,84.0,70,Casado,48,2018,3,high,0.24499999999999966,-2,4,1109054,1460,0,14,0
100500,102032,1,Presencial,7.39,2,Mujer,Referidos,6,786315,45.0,77,Casado,33,2012,8,low,102065,Presencial,1.78,7,Hombre,Portal Web,14,1616000,42.0,71,Casado,42,2015,11,low,-5.609999999999999,5,8,829685,1182,0,9,1
101760,102131,1,Presencial,2.51,1,Hombre,Linkedin,10,256548,45.0,78,Casado,41,2020,2,low,102109,Presencial,5.54,0,Hombre,Linkedin,3,998000,39.0,77,Soltero,34,2021,12,low,3.0300000000000002,-1,-7,741452,673,0,-7,1
102065,102026,2,Presencial,2.44,2,Hombre,Ferias & Networking,13,1616000,45.0,60,Divorciado,35,2014,10,low,102101,Presencial,2.7,1,Mujer,Portal Web,15,1616000,97.0,79,Casado,58,2017,6,high,0.26000000000000023,-1,2,0,992,0,23,1
101445,102026,1,Presencial,3.92,9,Hombre,Portal Web,7,899498,45.0,79,Casado,40,2012,3,low,102101,Presencial,2.7,1,Mujer,Portal Web,15,1616000,97.0,79,Casado,58,2017,6,high,-1.2199999999999998,-8,8,716502,1923,0,18,1
101301,102069,1,Presencial,2.72,1,Hombre,Portal Web,10,675371,45.0,81,Divorciado,47,2017,10,low,102069,Presencial,4.64,1,Mujer,Ferias & Networking,19,1616000,47.0,74,Casado,60,2021,10,low,1.9199999999999995,0,9,940629,1463,0,13,0
101951,102113,1,Presencial,5.12,5,Hombre,Linkedin,12,855606,45.0,80,Casado,52,2021,1,low,102041,Presencial,2.96,2,Hombre,Portal Web,6,1152410,46.0,75,Casado,27,2012,1,low,-2.16,-3,-6,296804,-3289,1,-25,1
100193,102172,1,Presencial,2.48,1,Mujer,Portal Web,9,858347,45.0,74,Casado,55,2023,2,low,102020,Presencial,5.58,1,Hombre,Portal Web,7,1049000,57.0,70,Casado,29,2016,4,low,3.1,0,-2,190653,-2500,1,-26,1
101857,102085,1,Presencial,5.52,2,Hombre,Portal Web,9,738886,45.0,69,Casado,51,2018,6,low,102145,Presencial,6.59,4,Hombre,Portal Web,12,1616000,47.0,71,Casado,39,2015,8,low,1.0700000000000003,2,3,877114,-1028,1,-12,1
101264,102086,1,Presencial,1.235,2,Hombre,Portal Web,14,899729,45.0,73,Divorciado,52,2019,4,low,102085,Presencial,2.22,2,Mujer,Linkedin,7,1306940,87.0,68,Divorciado,39,2021,3,high,0.9850000000000001,0,-7,407211,695,0,-13,1
100037,102069,1,Presencial,2.065,2,Mujer,Portal Web,13,898297,45.0,81,Divorciado,48,2014,12,low,102069,Presencial,4.64,1,Mujer,Ferias & Networking,19,1616000,47.0,74,Casado,60,2021,10,low,2.5749999999999997,-1,6,717703,2514,0,12,0
103349,102017,1,Presencial,4.18,2,Hombre,Linkedin,3,115394,45.0,69,Soltero,12,2013,9,low,102035,Presencial,4.62,0,Mujer,Linkedin,2,641000,90.0,84,Casado,25,2019,11,high,0.4400000000000004,-2,-1,525606,2256,0,13,1
102606,102108,1,Presencial,2.77,6,Mujer,Portal Web,4,185342,45.0,80,Soltero,21,2018,5,low,102040,Presencial,2.92,1,Mujer,Portal Web,5,1616000,46.0,75,Casado,50,2023,5,low,0.1499999999999999,-5,1,1430658,1828,0,29,0
103471,102068,1,Presencial,2.035,0,Hombre,Linkedin,4,246114,45.0,77,Soltero,21,2014,8,low,102043,Híbrida,2.17,3,Mujer,Referidos,4,896000,41.0,81,Soltero,23,2012,8,low,0.1349999999999998,3,0,649886,-727,1,2,0
103858,102036,1,Presencial,2.45,5,Mujer,Portal Web,7,269353,45.0,69,Soltero,22,2014,2,low,102054,Presencial,1.68,8,Hombre,Portal Web,5,1616000,92.0,76,Viudo,54,2022,1,high,-0.7700000000000002,3,-2,1346647,2897,0,32,0
103587,102064,1,Presencial,4.41,1,Mujer,Ferias & Networking,3,392361,45.0,83,Soltero,30,2016,6,low,102067,Presencial,1.34,0,Hombre,Portal Web,6,1616000,92.0,92,Casado,43,2018,2,high,-3.0700000000000003,-1,3,1223639,583,0,13,1
102301,102106,1,Presencial,6.215,2,Mujer,Portal Web,11,427830,45.0,80,Casado,35,2019,8,low,102081,Presencial,1.39,1,Mujer,Ferias & Networking,5,1049000,86.0,86,Soltero,32,2019,6,high,-4.825,-1,-6,621170,-56,1,-3,0
103991,102043,1,Presencial,8.195,7,Mujer,Linkedin,5,805608,45.0,72,Casado,33,2012,8,low,102051,Presencial,1.03,0,Hombre,Portal Web,5,1616000,60.0,76,Casado,44,2019,5,low,-7.165,-7,0,810392,2476,0,11,1
102998,102101,1,Presencial,2.985,2,Hombre,Ferias & Networking,10,661421,45.0,68,Viudo,47,2018,8,low,102089,Presencial,6.23,0,Hombre,Portal Web,26,1616000,92.0,68,Divorciado,55,2014,1,high,3.2450000000000006,-2,16,954579,-1693,1,8,0
103201,102114,1,Presencial,1.76,10,Hombre,Portal Web,4,682058,45.0,86,Casado,50,2020,12,low,102050,Presencial,1.44,1,Mujer,Portal Web,5,1616000,91.0,69,Divorciado,47,2021,5,high,-0.32000000000000006,-9,1,933942,158,0,-3,1
100078,102036,1,Presencial,2.44,5,Mujer,Portal Web,7,270931,44.0,69,Soltero,22,2014,2,low,102054,Presencial,1.68,8,Hombre,Portal Web,5,1616000,92.0,76,Viudo,54,2022,1,high,-0.76,3,-2,1345069,2898,0,32,1
101166,102128,1,Presencial,1.735,3,Mujer,Ferias & Networking,5,392120,44.0,81,Casado,36,2021,7,low,102056,Presencial,4.11,10,Mujer,Portal Web,16,1616000,46.0,72,Soltero,55,2021,2,low,2.375,7,11,1223880,-154,1,19,0
100658,102135,1,Presencial,2.78,2,Hombre,Ferias & Networking,5,424677,44.0,77,Soltero,38,2022,11,low,102028,Presencial,2.04,1,Hombre,Portal Web,2,1616000,82.0,75,Divorciado,49,2017,10,high,-0.7399999999999998,-1,-3,1191323,-1865,1,11,1
101583,102035,1,Presencial,4.51,0,Hombre,Portal Web,5,486833,44.0,83,Casado,33,2014,2,low,102041,Presencial,2.86,1,Hombre,Portal Web,23,1900000,83.0,72,Casado,57,2013,8,high,-1.65,1,18,1413167,-188,1,24,0
100685,102044,1,Presencial,1.525,1,Hombre,Ferias & Networking,14,377854,44.0,80,Viudo,36,2012,10,low,102155,Presencial,1.54,1,Hombre,Ferias & Networking,14,1616000,56.0,68,Soltero,47,2023,3,low,0.015000000000000124,0,0,1238146,3795,0,11,0
101891,102110,1,Presencial,2.415,2,Hombre,Ferias & Networking,7,287417,44.0,76,Casado,44,2020,1,low,102045,Presencial,1.6,5,Mujer,Linkedin,2,998000,87.0,76,Soltero,29,2016,11,high,-0.815,3,-5,710583,-1146,1,-15,0
100659,102058,1,Presencial,2.1,1,Hombre,Portal Web,15,919669,44.0,77,Viudo,46,2016,5,low,102172,Presencial,1.4,2,Hombre,Ferias & Networking,11,1616000,75.0,71,Casado,59,2021,2,low,-0.7000000000000002,1,-4,696331,1751,0,13,0
101692,102083,1,Presencial,1.895,3,Hombre,Portal Web,13,776460,44.0,78,Casado,50,2019,3,low,102147,Presencial,1.61,0,Mujer,Portal Web,5,1564490,83.0,71,Soltero,44,2021,2,high,-0.2849999999999999,-3,-8,788030,722,0,-6,1
100617,102151,1,Presencial,6.675,2,Hombre,Linkedin,6,835779,44.0,72,Soltero,56,2023,5,low,102105,Presencial,1.51,2,Hombre,Ferias & Networking,10,1616000,85.0,80,Divorciado,45,2021,11,high,-5.165,0,4,780221,-544,1,-11,0
102041,102147,2,Presencial,1.29,0,Mujer,Portal Web,8,1616000,44.0,73,Casado,51,2014,5,low,102057,Presencial,1.58,2,Hombre,Portal Web,4,1616000,90.0,80,Casado,49,2022,12,high,0.29000000000000004,2,-4,0,3143,0,-2,1
104048,102147,1,Presencial,3.59,2,Mujer,Portal Web,2,118283,44.0,75,Soltero,21,2021,12,low,102057,Presencial,1.58,2,Hombre,Portal Web,4,1616000,90.0,80,Casado,49,2022,12,high,-2.01,0,2,1497717,374,0,28,1
103304,102098,1,Presencial,2.245,5,Mujer,Portal Web,4,227466,44.0,64,Soltero,23,2017,10,low,102049,Presencial,1.8,1,Mujer,Portal Web,16,1616000,90.0,86,Casado,46,2021,1,high,-0.44500000000000006,-4,12,1388534,1198,0,23,0
104169,102131,1,Presencial,4.42,10,Mujer,Linkedin,5,326256,44.0,78,Soltero,33,2021,11,low,102109,Presencial,5.54,0,Hombre,Linkedin,3,998000,39.0,77,Soltero,34,2021,12,low,1.12,-10,-2,671744,51,0,1,1
103683,102076,1,Presencial,2.015,5,Mujer,Portal Web,7,331288,44.0,85,Soltero,27,2015,12,low,102168,Híbrida,1.95,1,Hombre,Referidos,9,1616000,95.0,82,Soltero,53,2023,9,high,-0.06500000000000017,-4,2,1284712,2830,0,26,1
102832,102135,1,Presencial,2.77,1,Hombre,Ferias & Networking,5,426539,44.0,77,Soltero,38,2022,11,low,102028,Presencial,2.04,1,Hombre,Portal Web,2,1616000,82.0,75,Divorciado,49,2017,10,high,-0.73,0,-3,1189461,-1863,1,11,0
102279,102135,1,Presencial,2.7,2,Hombre,Linkedin,9,407181,44.0,83,Casado,37,2022,1,low,102028,Presencial,2.04,1,Hombre,Portal Web,2,1616000,82.0,75,Divorciado,49,2017,10,high,-0.6600000000000001,-1,-7,1208819,-1563,1,12,0
102238,102087,1,Presencial,3.02,1,Mujer,Referidos,9,786358,44.0,82,Casado,34,2016,8,low,102111,Presencial,7.16,9,Mujer,Linkedin,10,1616000,98.0,79,Casado,42,2012,5,high,4.140000000000001,8,1,829642,-1577,1,8,0
102662,102089,1,Presencial,1.605,5,Hombre,Portal Web,3,803990,44.0,92,Soltero,36,2018,5,low,102077,Presencial,2.75,1,Hombre,Ferias & Networking,6,1616000,96.0,69,Divorciado,60,2021,10,high,1.145,-4,3,812010,1243,0,24,0
103848,102073,1,Presencial,2.05,1,Mujer,Ferias & Networking,4,489145,44.0,69,Soltero,37,2018,4,low,102139,Presencial,1.98,2,Hombre,Portal Web,11,1306940,95.0,86,Soltero,37,2019,7,high,-0.06999999999999984,1,7,817795,438,0,0,1
102331,102024,1,Presencial,2.05,2,Hombre,Portal Web,5,507833,44.0,63,Casado,34,2014,3,low,102074,Presencial,2.28,0,Hombre,Headhunter,9,1616000,84.0,70,Casado,48,2018,3,high,0.22999999999999998,-2,4,1108167,1460,0,14,0
102914,102032,1,Presencial,7.44,2,Mujer,Referidos,6,789246,44.0,77,Casado,33,2012,8,low,102065,Presencial,1.78,7,Hombre,Portal Web,14,1616000,42.0,71,Casado,42,2015,11,low,-5.66,5,8,826754,1183,0,9,1
102187,102058,1,Presencial,2.07,1,Hombre,Portal Web,15,915329,44.0,77,Viudo,46,2016,5,low,102172,Presencial,1.4,2,Hombre,Ferias & Networking,11,1616000,75.0,71,Casado,59,2021,2,low,-0.6699999999999999,1,-4,700671,1752,0,13,0
101388,102117,1,Presencial,3.49,3,Hombre,Portal Web,3,115925,43.0,69,Soltero,21,2021,12,low,102154,Presencial,4.05,1,Mujer,Linkedin,10,1616000,90.0,80,Divorciado,48,2021,1,high,0.5599999999999996,-2,7,1500075,-311,1,27,1
101150,102083,1,Presencial,5.135,2,Hombre,Referidos,3,138175,43.0,63,Soltero,18,2017,7,low,102147,Presencial,1.61,0,Mujer,Portal Web,5,1564490,83.0,71,Soltero,44,2021,2,high,-3.5249999999999995,-2,2,1426315,1333,0,26,1
100744,102058,1,Presencial,4.965,2,Hombre,Linkedin,2,141767,43.0,76,Casado,15,2015,2,low,102172,Presencial,1.4,2,Hombre,Ferias & Networking,11,1616000,75.0,71,Casado,59,2021,2,low,-3.565,0,9,1474233,2212,0,44,0
100099,102030,1,Presencial,0.15,6,Hombre,Linkedin,2,140462,43.0,72,Soltero,14,2014,10,low,102058,Presencial,6.34,0,Mujer,Referidos,14,1616000,90.0,76,Viudo,41,2015,4,high,6.1899999999999995,-6,12,1475538,187,0,27,0
101904,102009,1,Presencial,3.765,2,Hombre,Portal Web,3,184734,43.0,82,Soltero,16,2013,1,low,102116,Presencial,2.06,2,Hombre,Referidos,9,1461470,90.0,73,Casado,44,2022,8,high,-1.705,0,6,1276736,3500,0,28,0
101133,102046,1,Presencial,2.84,2,Hombre,Linkedin,5,227518,43.0,86,Casado,21,2015,3,low,102007,Presencial,1.68,0,Mujer,Portal Web,8,1616000,41.0,71,Soltero,50,2015,10,low,-1.16,-2,3,1388482,214,0,29,1
101450,102063,1,Presencial,7.41,34,Hombre,Linkedin,3,326391,43.0,79,Casado,25,2014,1,low,102135,Presencial,2.73,0,Mujer,Linkedin,1,539000,26.0,75,Soltero,24,2021,4,low,-4.68,-34,-2,212609,2642,0,-1,1
101928,102120,1,Presencial,0.905,2,Hombre,Ferias & Networking,5,346571,43.0,71,Soltero,33,2021,2,low,102171,Presencial,6.48,2,Hombre,Ferias & Networking,9,1616000,80.0,71,Casado,47,2023,8,high,5.575,0,4,1269429,916,0,14,0
101690,102081,1,Presencial,4.79,1,Hombre,Linkedin,8,771496,43.0,84,Casado,32,2018,2,low,102135,Presencial,2.5,2,Hombre,Portal Web,4,488000,26.0,64,Soltero,18,2015,8,low,-2.29,1,-4,-283496,-894,1,-14,0
100311,102036,1,Presencial,1.77,3,Hombre,Referidos,12,486114,43.0,70,Casado,32,2012,11,low,102054,Presencial,1.68,8,Hombre,Portal Web,5,1616000,92.0,76,Viudo,54,2022,1,high,-0.09000000000000008,5,-7,1129886,3347,0,22,0
101137,102072,1,Presencial,3.3,1,Hombre,Referidos,9,254276,43.0,76,Soltero,38,2016,12,low,102046,Presencial,2.61,2,Hombre,Ferias & Networking,3,947000,41.0,71,Soltero,30,2018,11,low,-0.69,1,-6,692724,709,0,-8,0
100902,102022,1,Presencial,5.885,3,Hombre,Portal Web,10,291697,43.0,76,Soltero,36,2012,1,low,102081,Presencial,2.07,0,Hombre,Portal Web,6,1616000,94.0,66,Viudo,47,2020,5,high,-3.815,-3,-4,1324303,3058,0,11,0
100441,102127,1,Presencial,3.76,2,Mujer,Ferias & Networking,16,642192,43.0,72,Viudo,48,2021,5,low,102028,Presencial,4.03,2,Mujer,Linkedin,9,1306940,88.0,78,Divorciado,32,2014,5,high,0.27000000000000046,0,-7,664748,-2547,1,-16,0
101558,102099,1,Presencial,2.625,3,Mujer,Linkedin,6,718031,43.0,75,Soltero,49,2019,1,low,102080,Presencial,1.71,0,Hombre,Portal Web,11,1616000,76.0,80,Viudo,51,2021,10,low,-0.915,-3,5,897969,984,0,2,1
100779,102031,1,Presencial,1.305,8,Mujer,Portal Web,7,913616,43.0,72,Casado,45,2012,3,low,102111,Presencial,2.95,2,Hombre,Portal Web,8,1610000,76.0,87,Casado,31,2017,7,low,1.6450000000000002,-6,1,696384,1950,0,-14,1
100065,102052,1,Presencial,4.8,1,Mujer,Portal Web,3,915002,43.0,77,Viudo,49,2013,2,low,102093,Presencial,4.45,0,Hombre,Linkedin,5,641000,84.0,76,Divorciado,17,2012,4,high,-0.34999999999999964,-1,2,-274002,-327,1,-32,0
103897,102138,1,Presencial,2.525,1,Mujer,Ferias & Networking,1,80158,43.0,81,Soltero,18,2021,6,low,102059,Presencial,3.26,1,Hombre,Linkedin,5,1616000,57.0,75,Soltero,44,2018,4,low,0.7349999999999999,0,4,1535842,-1177,1,26,1
102393,102082,1,Presencial,2.755,3,Mujer,Ferias & Networking,1,96855,43.0,77,Soltero,15,2016,12,low,102050,Presencial,5.5,2,Mujer,Linkedin,7,1616000,81.0,70,Casado,36,2018,8,high,2.745,-1,6,1519145,604,0,21,0
103525,102083,1,Presencial,5.13,3,Hombre,Portal Web,3,140588,43.0,63,Soltero,18,2017,7,low,102147,Presencial,1.61,0,Mujer,Portal Web,5,1564490,83.0,71,Soltero,44,2021,2,high,-3.5199999999999996,-3,2,1423902,1333,0,26,1
103853,102154,1,Presencial,3.135,2,Mujer,Referidos,2,206208,43.0,76,Casado,27,2022,6,low,102172,Presencial,5.45,1,Hombre,Portal Web,7,1512980,93.0,69,Soltero,39,2017,10,high,2.3150000000000004,-1,5,1306772,-1704,1,12,0
103193,102134,1,Presencial,1.47,2,Hombre,Portal Web,5,229407,43.0,79,Soltero,28,2021,7,low,102135,Presencial,2.25,2,Hombre,Portal Web,5,1358450,90.0,69,Viudo,31,2012,7,high,0.78,0,0,1129043,-3299,1,3,1
103798,102046,1,Presencial,2.83,2,Hombre,Linkedin,5,230293,43.0,86,Casado,21,2015,3,low,102007,Presencial,1.68,0,Mujer,Portal Web,8,1616000,41.0,71,Soltero,50,2015,10,low,-1.1500000000000001,-2,3,1385707,212,0,29,1
102994,102043,1,Presencial,2.905,1,Mujer,Portal Web,9,430189,43.0,81,Casado,29,2012,10,low,102051,Presencial,1.03,0,Hombre,Portal Web,5,1616000,60.0,76,Casado,44,2019,5,low,-1.8749999999999998,-1,-4,1185811,2405,0,15,1
101629,102082,1,Presencial,2.74,2,Mujer,Ferias & Networking,1,98257,42.0,77,Soltero,15,2016,12,low,102050,Presencial,5.5,2,Mujer,Linkedin,7,1616000,81.0,70,Casado,36,2018,8,high,2.76,0,6,1517743,605,0,21,0
100110,102041,1,Presencial,2.72,0,Hombre,Referidos,1,97482,42.0,75,Soltero,11,2012,11,low,102147,Presencial,1.29,0,Mujer,Portal Web,8,1616000,44.0,73,Casado,51,2014,5,low,-1.4300000000000002,0,7,1518518,540,0,40,1
101974,102111,1,Presencial,2.83,1,Hombre,Referidos,3,141022,42.0,87,Soltero,20,2020,11,low,102097,Híbrida,2.04,1,Mujer,Referidos,15,1616000,94.0,67,Soltero,50,2021,5,high,-0.79,0,12,1474978,179,0,30,1
100463,102108,1,Presencial,4.635,2,Mujer,Linkedin,2,116286,42.0,77,Soltero,17,2018,8,low,102040,Presencial,2.92,1,Mujer,Portal Web,5,1616000,46.0,75,Casado,50,2023,5,low,-1.7149999999999999,-1,3,1499714,1760,0,33,0
101121,102060,1,Presencial,2.035,0,Mujer,Portal Web,2,204920,42.0,90,Casado,21,2016,12,low,102041,Presencial,4.42,3,Hombre,Referidos,16,1616000,82.0,62,Casado,45,2013,10,high,2.385,3,14,1411080,-1157,1,24,0
101195,102150,1,Presencial,4.175,8,Hombre,Portal Web,1,231855,42.0,82,Soltero,28,2021,9,low,102085,Presencial,3.9,8,Mujer,Portal Web,10,1358450,85.0,75,Casado,32,2012,12,high,-0.2749999999999999,0,9,1126595,-3178,1,4,1
100428,102145,1,Presencial,2.275,3,Mujer,Portal Web,5,271257,42.0,83,Soltero,30,2021,8,low,102116,Presencial,1.43,1,Mujer,Portal Web,3,692000,89.0,73,Viudo,23,2016,12,high,-0.845,-2,-2,420743,-1723,1,-7,1
100514,102010,1,Presencial,2.03,0,Hombre,Portal Web,2,293040,42.0,79,Soltero,22,2013,2,low,102035,Presencial,2.02,0,Mujer,Linkedin,5,1564490,77.0,73,Casado,44,2021,8,low,-0.009999999999999787,0,3,1271450,3097,0,22,0
101209,102019,1,Presencial,5.13,7,Mujer,Portal Web,3,311346,42.0,82,Casado,23,2012,11,low,102129,Presencial,2.59,7,Mujer,Portal Web,4,488000,90.0,74,Soltero,24,2021,6,high,-2.54,0,1,176654,3141,0,1,0
101823,102140,1,Presencial,3.185,3,Hombre,Ferias & Networking,4,345792,42.0,75,Casado,32,2020,8,low,102040,Presencial,2.55,0,Mujer,Portal Web,16,1616000,46.0,69,Casado,39,2012,2,low,-0.6350000000000002,-3,12,1270208,-3110,1,7,1
101769,102113,1,Presencial,2.385,1,Mujer,Referidos,8,447288,42.0,86,Casado,35,2018,6,low,102041,Presencial,2.96,2,Hombre,Portal Web,6,1152410,46.0,75,Casado,27,2012,1,low,0.5750000000000002,1,-2,705122,-2351,1,-8,1
101089,102070,1,Presencial,4.1,2,Hombre,Ferias & Networking,5,450784,42.0,80,Soltero,32,2015,4,low,102035,Presencial,1.7,1,Mujer,Referidos,4,1616000,77.0,73,Viudo,38,2013,3,low,-2.3999999999999995,-1,-1,1165216,-771,1,6,0
100591,102043,1,Presencial,2.91,1,Mujer,Portal Web,9,428418,42.0,81,Casado,29,2012,10,low,102051,Presencial,1.03,0,Hombre,Portal Web,5,1616000,60.0,76,Casado,44,2019,5,low,-1.8800000000000001,-1,-4,1187582,2407,0,15,1
100348,102139,1,Presencial,1.65,1,Mujer,Portal Web,8,810898,42.0,88,Soltero,41,2022,7,low,102154,Presencial,6.48,1,Hombre,Ferias & Networking,5,590000,90.0,67,Casado,25,2021,6,high,4.83,0,-3,-220898,-392,1,-16,1
101865,102111,1,Presencial,2.525,0,Mujer,Referidos,13,507511,42.0,69,Casado,39,2018,12,low,102097,Híbrida,2.04,1,Mujer,Referidos,15,1616000,94.0,67,Soltero,50,2021,5,high,-0.4849999999999999,1,2,1108489,883,0,11,0
101509,102085,1,Presencial,4.01,1,Hombre,Portal Web,10,275634,42.0,70,Soltero,40,2016,12,low,102145,Presencial,6.59,4,Hombre,Portal Web,12,1616000,47.0,71,Casado,39,2015,8,low,2.58,3,2,1340366,-492,1,-1,0
101751,102123,1,Presencial,2.405,0,Mujer,Portal Web,5,289036,42.0,82,Divorciado,46,2021,10,low,102043,Presencial,5.5,1,Mujer,Linkedin,16,1616000,42.0,66,Soltero,51,2021,9,low,3.095,1,11,1326964,-36,1,5,0
100316,102093,1,Presencial,2.32,7,Mujer,Portal Web,13,454869,42.0,74,Viudo,42,2018,1,low,102139,Presencial,5.41,0,Mujer,Ferias & Networking,4,488000,89.0,62,Soltero,23,2021,6,high,3.0900000000000003,-7,-9,33131,1248,0,-19,1
100206,102138,1,Presencial,1.38,2,Mujer,Referidos,15,293568,42.0,70,Soltero,48,2022,12,low,102059,Presencial,3.26,1,Hombre,Linkedin,5,1616000,57.0,75,Soltero,44,2018,4,low,1.88,-1,-10,1322432,-1722,1,-4,1
100833,102122,1,Presencial,1.645,4,Hombre,Referidos,8,660870,42.0,79,Casado,47,2019,3,low,102075,Presencial,1.83,4,Hombre,Portal Web,6,1616000,90.0,66,Viudo,48,2019,3,high,0.18500000000000005,0,-2,955130,0,1,1,0
102032,102065,2,Presencial,1.78,7,Hombre,Portal Web,14,1616000,42.0,71,Casado,42,2015,11,low,102026,Presencial,2.44,2,Hombre,Ferias & Networking,13,1616000,45.0,60,Divorciado,35,2014,10,low,0.6599999999999999,-5,-1,0,-405,1,-7,1
101987,102065,1,Presencial,2.025,3,Mujer,Portal Web,9,879632,42.0,78,Viudo,50,2017,6,low,102026,Presencial,2.44,2,Hombre,Ferias & Networking,13,1616000,45.0,60,Divorciado,35,2014,10,low,0.41500000000000004,-1,4,736368,-971,1,-15,1
102123,102043,2,Presencial,5.5,1,Mujer,Linkedin,16,1616000,42.0,66,Soltero,51,2021,9,low,102051,Presencial,1.03,0,Hombre,Portal Web,5,1616000,60.0,76,Casado,44,2019,5,low,-4.47,-1,-11,0,-852,1,-7,1
103513,102043,1,Presencial,2.45,0,Mujer,Portal Web,1,142386,42.0,85,Divorciado,14,2014,8,low,102051,Presencial,1.03,0,Hombre,Portal Web,5,1616000,60.0,76,Casado,44,2019,5,low,-1.4200000000000002,0,4,1473614,1730,0,30,1
102793,102058,1,Presencial,4.925,1,Hombre,Linkedin,2,137924,42.0,76,Soltero,15,2015,2,low,102172,Presencial,1.4,2,Hombre,Ferias & Networking,11,1616000,75.0,71,Casado,59,2021,2,low,-3.525,1,9,1478076,2211,0,44,0
103915,102070,1,Presencial,2.025,8,Hombre,Portal Web,4,287679,42.0,76,Casado,27,2017,9,low,102035,Presencial,1.7,1,Mujer,Referidos,4,1616000,77.0,73,Viudo,38,2013,3,low,-0.32499999999999996,-7,0,1328321,-1657,1,11,1
104109,102063,1,Presencial,7.425,35,Hombre,Portal Web,3,325520,42.0,79,Casado,24,2014,1,low,102135,Presencial,2.73,0,Mujer,Linkedin,1,539000,26.0,75,Soltero,24,2021,4,low,-4.695,-35,-2,213480,2642,0,0,1
102508,102019,1,Presencial,5.165,8,Mujer,Portal Web,3,304819,42.0,82,Casado,23,2012,11,low,102129,Presencial,2.59,7,Mujer,Portal Web,4,488000,90.0,74,Soltero,24,2021,6,high,-2.575,-1,1,183181,3142,0,1,0
103883,102144,1,Presencial,2.69,3,Hombre,Referidos,7,366093,42.0,75,Soltero,35,2022,4,low,102156,Presencial,2.13,8,Mujer,Portal Web,11,1616000,5.0,82,Viudo,58,2015,6,low,-0.56,5,4,1249907,-2493,1,23,1
103737,102093,1,Presencial,1.89,2,Hombre,Ferias & Networking,6,405203,42.0,76,Divorciado,34,2018,11,low,102139,Presencial,5.41,0,Mujer,Ferias & Networking,4,488000,89.0,62,Soltero,23,2021,6,high,3.5200000000000005,-2,-2,82797,944,0,-11,1
103753,102139,1,Presencial,1.625,0,Mujer,Portal Web,8,811427,42.0,88,Soltero,41,2022,7,low,102154,Presencial,6.48,1,Hombre,Ferias & Networking,5,590000,90.0,67,Casado,25,2021,6,high,4.855,1,-3,-221427,-389,1,-16,1
102196,102036,1,Presencial,1.72,2,Hombre,Referidos,12,491965,42.0,70,Casado,32,2012,11,low,102054,Presencial,1.68,8,Hombre,Portal Web,5,1616000,92.0,76,Viudo,54,2022,1,high,-0.040000000000000036,6,-7,1124035,3349,0,22,0
102190,102111,1,Presencial,2.5,0,Mujer,Portal Web,13,512793,42.0,69,Casado,39,2018,12,low,102097,Híbrida,2.04,1,Mujer,Referidos,15,1616000,94.0,67,Soltero,50,2021,5,high,-0.45999999999999996,1,2,1103207,883,0,11,1
102189,102019,1,Presencial,2.74,3,Mujer,Portal Web,7,510701,42.0,85,Casado,32,2012,2,low,102129,Presencial,2.59,7,Mujer,Portal Web,4,488000,90.0,74,Soltero,24,2021,6,high,-0.15000000000000036,4,-3,-22701,3402,0,-8,0
102927,102147,1,Presencial,2.495,2,Mujer,Portal Web,12,276470,42.0,69,Casado,45,2022,4,low,102057,Presencial,1.58,2,Hombre,Portal Web,4,1616000,90.0,80,Casado,49,2022,12,high,-0.915,0,-8,1339530,241,0,4,1
103329,102022,1,Presencial,5.86,2,Hombre,Portal Web,10,285544,42.0,76,Soltero,36,2012,1,low,102081,Presencial,2.07,0,Hombre,Portal Web,6,1616000,94.0,66,Viudo,47,2020,5,high,-3.7900000000000005,-2,-4,1330456,3059,0,11,0
103644,102138,1,Presencial,1.385,1,Mujer,Referidos,14,302116,42.0,70,Soltero,47,2022,12,low,102059,Presencial,3.26,1,Hombre,Linkedin,5,1616000,57.0,75,Soltero,44,2018,4,low,1.8749999999999998,0,-9,1313884,-1721,1,-3,1
103148,102101,1,Presencial,1.065,1,Hombre,Linkedin,10,678993,42.0,80,Divorciado,48,2019,6,low,102089,Presencial,6.23,0,Hombre,Portal Web,26,1616000,92.0,68,Divorciado,55,2014,1,high,5.165000000000001,-1,16,937007,-1994,1,7,1
103124,102172,1,Presencial,2.645,2,Mujer,Ferias & Networking,4,694385,42.0,79,Viudo,54,2023,6,low,102020,Presencial,5.58,1,Hombre,Portal Web,7,1049000,57.0,70,Casado,29,2016,4,low,2.935,-1,3,354615,-2611,1,-25,0
103184,102050,1,Presencial,3.74,2,Hombre,Linkedin,11,761163,42.0,70,Casado,46,2014,1,low,102069,Presencial,3.7,0,Mujer,Linkedin,11,1512980,90.0,88,Soltero,40,2017,10,high,-0.040000000000000036,-2,0,751817,1376,0,-6,0
103602,102031,1,Presencial,1.315,8,Mujer,Portal Web,7,915589,42.0,72,Soltero,45,2012,3,low,102111,Presencial,2.95,2,Hombre,Portal Web,8,1610000,76.0,87,Casado,31,2017,7,low,1.6350000000000002,-6,1,694411,1951,0,-14,1
101353,102119,1,Presencial,1.865,1,Mujer,Linkedin,1,81040,41.0,70,Soltero,18,2020,12,low,102107,Presencial,2.22,2,Hombre,Portal Web,12,1616000,38.0,70,Divorciado,52,2021,1,low,0.3550000000000002,1,11,1534960,22,0,34,1
101780,102026,1,Presencial,5.835,1,Hombre,Portal Web,2,192670,41.0,75,Soltero,18,2013,9,low,102101,Presencial,2.7,1,Mujer,Portal Web,15,1616000,97.0,79,Casado,58,2017,6,high,-3.135,0,13,1423330,1376,0,40,1
102129,102142,2,Presencial,2.1,2,Mujer,Linkedin,3,590000,41.0,74,Soltero,24,2020,1,low,102047,Presencial,2.48,2,Hombre,Portal Web,3,1255430,90.0,66,Soltero,36,2019,7,high,0.3799999999999999,0,0,665430,-183,1,12,1
100107,102142,1,Presencial,2.3,2,Mujer,Portal Web,4,292226,41.0,68,Casado,30,2021,7,low,102047,Presencial,2.48,2,Hombre,Portal Web,3,1255430,90.0,66,Soltero,36,2019,7,high,0.18000000000000016,0,-1,963204,-736,1,6,1
101514,102039,1,Presencial,1.985,6,Mujer,Portal Web,4,352214,41.0,74,Soltero,27,2015,2,low,102054,Presencial,3.66,0,Hombre,Referidos,5,1616000,93.0,75,Viudo,49,2018,6,high,1.675,-6,1,1263786,1203,0,22,1
100126,102171,1,Presencial,1.98,0,Hombre,Linkedin,6,371131,41.0,77,Casado,36,2023,1,low,102088,Presencial,2.57,4,Hombre,Linkedin,8,1616000,80.0,69,Casado,43,2017,10,high,0.5899999999999999,4,2,1244869,-1929,1,7,0
101831,102098,1,Presencial,5.16,2,Mujer,Portal Web,7,372974,41.0,72,Soltero,33,2020,5,low,102049,Presencial,1.8,1,Mujer,Portal Web,16,1616000,90.0,86,Casado,46,2021,1,high,-3.3600000000000003,-1,9,1243026,273,0,13,0
101328,102039,1,Presencial,5.1,8,Hombre,Portal Web,2,391237,41.0,79,Casado,29,2014,6,low,102054,Presencial,3.66,0,Hombre,Referidos,5,1616000,93.0,75,Viudo,49,2018,6,high,-1.4399999999999995,-8,3,1224763,1450,0,20,1
101654,102154,1,Presencial,1.45,0,Hombre,Portal Web,10,411872,41.0,70,Casado,37,2022,5,low,102172,Presencial,5.45,1,Hombre,Portal Web,7,1512980,93.0,69,Soltero,39,2017,10,high,4.0,1,-3,1101108,-1685,1,2,0
101898,102102,1,Presencial,2.2,3,Hombre,Linkedin,10,405560,41.0,78,Soltero,34,2019,8,low,102018,Presencial,2.48,0,Hombre,Portal Web,5,1616000,92.0,63,Viudo,49,2019,4,high,0.2799999999999998,-3,-5,1210440,-125,1,15,1
101227,102093,1,Presencial,1.85,2,Hombre,Ferias & Networking,6,408272,41.0,76,Divorciado,34,2018,11,low,102139,Presencial,5.41,0,Mujer,Ferias & Networking,4,488000,89.0,62,Soltero,23,2021,6,high,3.56,-2,-2,79728,943,0,-11,1
102072,102046,2,Presencial,2.61,2,Hombre,Ferias & Networking,3,947000,41.0,71,Soltero,30,2018,11,low,102007,Presencial,1.68,0,Mujer,Portal Web,8,1616000,41.0,71,Soltero,50,2015,10,low,-0.9299999999999999,-2,5,669000,-1127,1,20,1
100487,102046,1,Presencial,4.815,3,Mujer,Portal Web,8,452743,41.0,76,Casado,30,2013,2,low,102007,Presencial,1.68,0,Mujer,Portal Web,8,1616000,41.0,71,Soltero,50,2015,10,low,-3.1350000000000007,-3,0,1163257,976,0,20,1
100334,102074,1,Presencial,1.365,2,Mujer,Referidos,9,493145,41.0,67,Soltero,37,2018,2,low,102028,Presencial,1.35,0,Hombre,Ferias & Networking,4,1616000,80.0,83,Viudo,43,2015,12,high,-0.014999999999999902,-2,-5,1122855,-781,1,6,1
101016,102077,1,Presencial,3.64,2,Hombre,Portal Web,8,504618,41.0,78,Divorciado,35,2015,5,low,102146,Presencial,2.27,0,Hombre,Ferias & Networking,11,1306940,31.0,64,Soltero,39,2021,6,low,-1.37,-2,3,802322,2238,0,4,0
100720,102019,1,Presencial,2.74,3,Mujer,Portal Web,7,507869,41.0,85,Casado,32,2012,2,low,102129,Presencial,2.59,7,Mujer,Portal Web,4,488000,90.0,74,Soltero,24,2021,6,high,-0.15000000000000036,4,-3,-19869,3404,0,-8,1
101552,102158,1,Presencial,2.575,2,Hombre,Ferias & Networking,10,258197,41.0,82,Casado,44,2023,2,low,102093,Presencial,1.79,1,Mujer,Referidos,27,1900000,87.0,74,Viudo,54,2013,9,high,-0.7850000000000001,-1,17,1641803,-3431,1,10,1
100337,102151,1,Presencial,3.51,5,Mujer,Portal Web,5,438572,41.0,69,Soltero,45,2023,2,low,102105,Presencial,1.51,2,Hombre,Ferias & Networking,10,1616000,85.0,80,Divorciado,45,2021,11,high,-1.9999999999999998,-3,5,1177428,-443,1,0,1
101736,102069,1,Presencial,2.195,4,Hombre,Linkedin,8,269124,41.0,76,Casado,39,2016,11,low,102069,Presencial,4.64,1,Mujer,Ferias & Networking,19,1616000,47.0,74,Casado,60,2021,10,low,2.445,-3,11,1346876,1816,0,21,1
100383,102147,1,Presencial,2.495,3,Mujer,Portal Web,12,282442,41.0,69,Casado,45,2022,4,low,102057,Presencial,1.58,2,Hombre,Portal Web,4,1616000,90.0,80,Casado,49,2022,12,high,-0.915,-1,-8,1333558,242,0,4,0
100651,102092,1,Presencial,1.98,2,Hombre,Referidos,4,450254,41.0,75,Soltero,40,2016,9,low,102120,Presencial,1.23,6,Mujer,Linkedin,13,1616000,98.0,95,Viudo,41,2013,6,high,-0.75,4,9,1165746,-1189,1,1,1
100180,102172,1,Presencial,2.98,0,Hombre,Portal Web,7,391739,41.0,75,Divorciado,48,2023,5,low,102020,Presencial,5.58,1,Hombre,Portal Web,7,1049000,57.0,70,Casado,29,2016,4,low,2.6,1,0,657261,-2594,1,-19,0
101491,102078,1,Presencial,2.02,0,Mujer,Ferias & Networking,11,307384,41.0,62,Casado,44,2017,7,low,102143,Presencial,2.17,1,Hombre,Ferias & Networking,9,998000,83.0,76,Casado,29,2017,5,high,0.1499999999999999,1,-2,690616,-42,1,-15,1
100890,102033,1,Presencial,2.015,11,Hombre,Portal Web,15,640569,41.0,75,Casado,40,2013,10,low,102172,Presencial,6.25,2,Mujer,Portal Web,16,1616000,90.0,79,Divorciado,39,2014,5,high,4.234999999999999,-9,1,975431,208,0,-1,1
100161,102108,1,Presencial,3.44,1,Hombre,Portal Web,18,917520,41.0,83,Divorciado,50,2019,1,low,102040,Presencial,2.92,1,Mujer,Portal Web,5,1616000,46.0,75,Casado,50,2023,5,low,-0.52,0,-13,698480,1592,0,0,1
102046,102007,2,Presencial,1.68,0,Mujer,Portal Web,8,1616000,41.0,71,Soltero,50,2015,10,low,102070,Presencial,5.11,2,Mujer,Portal Web,6,1358450,96.0,62,Soltero,41,2022,4,high,3.4300000000000006,2,-2,-257550,2365,0,-9,1
102532,102007,1,Presencial,4.59,1,Mujer,Linkedin,2,98809,41.0,72,Soltero,10,2012,4,low,102070,Presencial,5.11,2,Mujer,Portal Web,6,1358450,96.0,62,Soltero,41,2022,4,high,0.5200000000000005,1,4,1259641,3657,0,31,0
103350,102108,1,Presencial,4.63,3,Mujer,Linkedin,2,120295,41.0,77,Soltero,18,2018,8,low,102040,Presencial,2.92,1,Mujer,Portal Web,5,1616000,46.0,75,Casado,50,2023,5,low,-1.71,-2,3,1495705,1759,0,32,0
103301,102159,1,Presencial,3.265,1,Hombre,Ferias & Networking,2,143823,41.0,79,Soltero,22,2022,4,low,102120,Híbrida,0.98,2,Hombre,Referidos,14,808000,90.0,86,Soltero,44,2022,8,high,-2.285,1,12,664177,117,0,22,0
103849,102111,1,Presencial,2.85,2,Hombre,Referidos,3,138919,41.0,87,Soltero,21,2020,11,low,102097,Híbrida,2.04,1,Mujer,Referidos,15,1616000,94.0,67,Soltero,50,2021,5,high,-0.81,-1,12,1477081,177,0,29,1
103672,102044,1,Presencial,3.97,2,Mujer,Portal Web,4,168134,41.0,74,Soltero,16,2014,9,low,102155,Presencial,1.54,1,Hombre,Ferias & Networking,14,1616000,56.0,68,Soltero,47,2023,3,low,-2.43,-1,10,1447866,3107,0,31,1
103276,102069,1,Presencial,6.885,0,Hombre,Portal Web,5,249860,41.0,81,Casado,25,2017,8,low,102069,Presencial,4.64,1,Mujer,Ferias & Networking,19,1616000,47.0,74,Casado,60,2021,10,low,-2.245,1,14,1366140,1520,0,35,0
103477,102136,1,Presencial,1.595,3,Mujer,Referidos,4,268664,41.0,78,Casado,31,2022,4,low,102034,Presencial,1.78,2,Hombre,Portal Web,3,1616000,89.0,78,Casado,35,2013,1,high,0.18500000000000005,-1,-1,1347336,-3375,1,4,1
104019,102145,1,Presencial,2.26,4,Mujer,Portal Web,5,271191,41.0,83,Soltero,30,2021,8,low,102116,Presencial,1.43,1,Mujer,Portal Web,3,692000,89.0,73,Viudo,23,2016,12,high,-0.8299999999999998,-3,-2,420809,-1723,1,-7,1
103404,102142,1,Presencial,2.305,1,Mujer,Portal Web,4,286399,41.0,68,Casado,30,2021,7,low,102047,Presencial,2.48,2,Hombre,Portal Web,3,1255430,90.0,66,Soltero,36,2019,7,high,0.17499999999999982,1,-1,969031,-735,1,6,1
102847,102140,1,Presencial,3.195,2,Hombre,Ferias & Networking,4,350740,41.0,75,Casado,32,2020,8,low,102040,Presencial,2.55,0,Mujer,Portal Web,16,1616000,46.0,69,Casado,39,2012,2,low,-0.645,-2,12,1265260,-3110,1,7,1
102742,102090,1,Presencial,1.615,2,Hombre,Portal Web,6,331531,41.0,76,Soltero,29,2018,5,low,102171,Presencial,6.83,0,Hombre,Linkedin,4,488000,92.0,76,Soltero,19,2017,2,high,5.215,-2,-2,156469,-457,1,-10,0
104152,102039,1,Presencial,2.0,7,Mujer,Portal Web,5,345684,41.0,74,Soltero,27,2015,2,low,102054,Presencial,3.66,0,Hombre,Referidos,5,1616000,93.0,75,Viudo,49,2018,6,high,1.6600000000000001,-7,0,1270316,1203,0,22,1
103922,102102,1,Presencial,2.18,3,Hombre,Linkedin,10,412779,41.0,78,Soltero,34,2019,8,low,102018,Presencial,2.48,0,Hombre,Portal Web,5,1616000,92.0,63,Viudo,49,2019,4,high,0.2999999999999998,-3,-5,1203221,-125,1,15,0
102755,102029,1,Presencial,3.82,1,Hombre,Linkedin,4,490409,41.0,77,Casado,33,2013,8,low,102132,Presencial,5.79,2,Hombre,Portal Web,16,1616000,80.0,84,Casado,49,2017,9,high,1.9700000000000002,1,12,1125591,1505,0,16,0
103365,102158,1,Presencial,2.565,2,Hombre,Ferias & Networking,10,261286,41.0,82,Casado,44,2023,2,low,102093,Presencial,1.79,1,Mujer,Referidos,27,1900000,87.0,74,Viudo,54,2013,9,high,-0.7749999999999999,-1,17,1638714,-3434,1,10,1
104111,102151,1,Presencial,3.49,5,Mujer,Portal Web,5,433498,41.0,69,Soltero,45,2023,2,low,102105,Presencial,1.51,2,Hombre,Ferias & Networking,10,1616000,85.0,80,Divorciado,45,2021,11,high,-1.9800000000000002,-3,5,1182502,-444,1,0,1
103418,102123,1,Presencial,2.405,1,Mujer,Portal Web,5,287576,41.0,82,Divorciado,45,2021,10,low,102043,Presencial,5.5,1,Mujer,Linkedin,16,1616000,42.0,66,Soltero,51,2021,9,low,3.095,0,11,1328424,-38,1,6,0
103674,102092,1,Presencial,2.005,2,Hombre,Referidos,4,448229,41.0,75,Soltero,40,2016,9,low,102120,Presencial,1.23,6,Mujer,Linkedin,13,1616000,98.0,95,Viudo,41,2013,6,high,-0.7749999999999999,4,9,1167771,-1188,1,1,1
103176,102008,1,Presencial,3.885,2,Hombre,Portal Web,14,856535,41.0,70,Casado,41,2012,3,low,102107,Presencial,3.99,1,Mujer,Linkedin,7,405435,90.0,82,Soltero,39,2023,1,high,0.10500000000000043,-1,-7,-451100,3952,0,-2,1
103641,102108,1,Presencial,3.46,0,Hombre,Portal Web,19,917210,41.0,83,Divorciado,50,2019,1,low,102040,Presencial,2.92,1,Mujer,Portal Web,5,1616000,46.0,75,Casado,50,2023,5,low,-0.54,1,-14,698790,1594,0,0,1
102177,102040,1,Presencial,7.375,3,Hombre,Linkedin,7,719365,41.0,68,Casado,44,2013,7,low,102106,Presencial,3.21,1,Hombre,Linkedin,15,1616000,91.0,84,Soltero,45,2016,7,high,-4.165,-2,8,896635,1108,0,1,0
103968,102053,1,Presencial,3.34,5,Hombre,Portal Web,10,736297,41.0,76,Divorciado,45,2013,7,low,102030,Presencial,1.29,0,Hombre,Portal Web,11,1616000,81.0,64,Soltero,36,2012,12,high,-2.05,-5,1,879703,-208,1,-9,0
102923,102111,1,Presencial,1.41,1,Mujer,Portal Web,13,913587,41.0,77,Soltero,55,2021,2,low,102097,Híbrida,2.04,1,Mujer,Referidos,15,1616000,94.0,67,Soltero,50,2021,5,high,0.6300000000000001,0,2,702413,88,0,-5,0
101143,102135,1,Presencial,2.705,1,Hombre,Referidos,2,188856,40.0,78,Soltero,24,2021,2,low,102028,Presencial,2.04,1,Hombre,Portal Web,2,1616000,82.0,75,Divorciado,49,2017,10,high,-0.665,0,0,1427144,-1223,1,25,0
100526,102036,1,Presencial,2.93,1,Hombre,Ferias & Networking,1,167270,40.0,75,Soltero,15,2012,7,low,102054,Presencial,1.68,8,Hombre,Portal Web,5,1616000,92.0,76,Viudo,54,2022,1,high,-1.2500000000000002,7,4,1448730,3455,0,39,1
100007,102118,1,Presencial,3.45,5,Mujer,Portal Web,1,212921,40.0,85,Casado,26,2021,1,low,102171,Presencial,4.76,17,Mujer,Linkedin,4,1616000,86.0,74,Soltero,39,2023,8,high,1.3099999999999996,12,3,1403079,953,0,13,0
101813,102125,1,Presencial,3.735,6,Hombre,Portal Web,1,269587,40.0,79,Soltero,30,2022,6,low,102096,Híbrida,4.0,2,Mujer,Referidos,5,692000,87.0,82,Casado,29,2022,7,high,0.2650000000000001,-4,4,422413,44,0,-1,1
101936,102059,1,Presencial,1.3,35,Hombre,Headhunter,4,269393,40.0,83,Soltero,22,2014,3,low,102021,Presencial,2.55,2,Hombre,Portal Web,16,1616000,27.0,76,Viudo,50,2019,6,low,1.2499999999999998,-33,12,1346607,1932,0,28,0
100837,102090,1,Presencial,1.605,2,Hombre,Portal Web,6,326208,40.0,76,Soltero,29,2018,5,low,102171,Presencial,6.83,0,Hombre,Linkedin,4,488000,92.0,76,Soltero,19,2017,2,high,5.225,-2,-2,161792,-459,1,-10,0
100151,102106,1,Presencial,3.43,1,Hombre,Linkedin,3,387657,40.0,78,Divorciado,32,2018,6,low,102081,Presencial,1.39,1,Mujer,Ferias & Networking,5,1049000,86.0,86,Soltero,32,2019,6,high,-2.04,0,2,661343,375,0,0,0
101507,102005,1,Presencial,1.45,1,Mujer,Ferias & Networking,10,471923,40.0,78,Casado,31,2012,5,low,102075,Presencial,3.25,2,Hombre,Portal Web,15,1616000,90.0,65,Soltero,47,2017,2,high,1.8,1,5,1144077,1732,0,16,1
100792,102115,1,Presencial,3.085,2,Mujer,Portal Web,6,510433,40.0,75,Casado,38,2018,7,low,102116,Presencial,2.0,2,Mujer,Portal Web,4,1616000,94.0,76,Soltero,35,2018,12,high,-1.085,0,-2,1105567,175,0,-3,0
100422,102032,1,Presencial,1.465,1,Hombre,Portal Web,3,510877,40.0,74,Casado,35,2014,9,low,102065,Presencial,1.78,7,Hombre,Portal Web,14,1616000,42.0,71,Casado,42,2015,11,low,0.31499999999999995,6,11,1105123,430,0,7,0
100734,102093,1,Presencial,3.36,9,Hombre,Portal Web,7,431465,40.0,84,Soltero,38,2016,10,low,102139,Presencial,5.41,0,Mujer,Ferias & Networking,4,488000,89.0,62,Soltero,23,2021,6,high,2.0500000000000003,-9,-3,56535,1690,0,-15,1
100961,102088,1,Presencial,3.175,0,Hombre,Portal Web,7,446587,40.0,71,Soltero,37,2016,10,low,102139,Presencial,4.96,1,Mujer,Portal Web,3,488000,82.0,65,Soltero,20,2018,4,high,1.7850000000000001,1,-4,41413,540,0,-17,1
101722,102072,1,Presencial,4.315,3,Mujer,Portal Web,5,264616,40.0,71,Casado,38,2015,10,low,102046,Presencial,2.61,2,Hombre,Ferias & Networking,3,947000,41.0,71,Soltero,30,2018,11,low,-1.7050000000000005,-1,-2,682384,1130,0,-8,1
100305,102172,1,Presencial,4.405,2,Hombre,Portal Web,4,281679,40.0,82,Soltero,46,2022,10,low,102020,Presencial,5.58,1,Hombre,Portal Web,7,1049000,57.0,70,Casado,29,2016,4,low,1.1749999999999998,-1,3,767321,-2370,1,-17,1
100697,102022,1,Presencial,2.16,3,Mujer,Linkedin,5,455145,40.0,66,Casado,38,2013,12,low,102081,Presencial,2.07,0,Hombre,Portal Web,6,1616000,94.0,66,Viudo,47,2020,5,high,-0.0900000000000003,-3,1,1160855,2346,0,9,0
101459,102128,1,Presencial,2.055,3,Mujer,Referidos,6,440963,40.0,75,Casado,46,2020,8,low,102056,Presencial,4.11,10,Mujer,Portal Web,16,1616000,46.0,72,Soltero,55,2021,2,low,2.055,7,10,1175037,189,0,9,0
100914,102059,1,Presencial,3.15,9,Hombre,Portal Web,8,874896,40.0,72,Casado,44,2015,4,low,102021,Presencial,2.55,2,Hombre,Portal Web,16,1616000,27.0,76,Viudo,50,2019,6,low,-0.6000000000000001,-7,8,741104,1527,0,6,1
100425,102040,1,Presencial,7.38,3,Hombre,Ferias & Networking,8,717471,40.0,68,Casado,45,2013,7,low,102106,Presencial,3.21,1,Hombre,Linkedin,15,1616000,91.0,84,Soltero,45,2016,7,high,-4.17,-2,7,898529,1105,0,0,0
103868,102119,1,Presencial,1.84,0,Mujer,Linkedin,3,79032,40.0,70,Soltero,18,2020,12,low,102107,Presencial,2.22,2,Hombre,Portal Web,12,1616000,38.0,70,Divorciado,52,2021,1,low,0.3800000000000001,2,9,1536968,25,0,34,1
103629,102061,1,Presencial,1.4,0,Mujer,Portal Web,1,84405,40.0,81,Soltero,12,2014,12,low,102115,Presencial,2.14,2,Hombre,Ferias & Networking,10,1203920,37.0,80,Casado,29,2012,11,low,0.7400000000000002,2,9,1119515,-779,1,17,1
103456,102026,1,Presencial,5.87,1,Hombre,Portal Web,2,188848,40.0,75,Soltero,18,2013,9,low,102101,Presencial,2.7,1,Mujer,Portal Web,15,1616000,97.0,79,Casado,58,2017,6,high,-3.17,0,13,1427152,1378,0,40,1
103662,102091,1,Presencial,5.035,6,Hombre,Portal Web,2,230474,40.0,79,Casado,23,2016,9,low,102149,Presencial,1.54,1,Mujer,Portal Web,4,1616000,73.0,77,Casado,39,2014,12,low,-3.495,-5,2,1385526,-619,1,16,0
104104,102159,1,Presencial,4.15,2,Mujer,Linkedin,7,265702,40.0,69,Soltero,31,2022,5,low,102120,Híbrida,0.98,2,Hombre,Referidos,14,808000,90.0,86,Soltero,44,2022,8,high,-3.1700000000000004,0,7,542298,90,0,13,1
103058,102059,1,Presencial,1.32,34,Hombre,Headhunter,4,270624,40.0,83,Soltero,22,2014,3,low,102021,Presencial,2.55,2,Hombre,Portal Web,16,1616000,27.0,76,Viudo,50,2019,6,low,1.2299999999999998,-32,12,1345376,1932,0,28,0
103647,102133,1,Presencial,2.705,8,Mujer,Linkedin,7,289947,40.0,76,Soltero,31,2022,4,low,102151,Híbrida,2.61,2,Hombre,Linkedin,4,1255430,98.0,65,Soltero,35,2018,2,high,-0.0950000000000002,-6,-3,965483,-1508,1,4,1
102602,102089,1,Presencial,1.68,2,Hombre,Ferias & Networking,6,333042,40.0,68,Casado,29,2018,6,low,102077,Presencial,2.75,1,Hombre,Ferias & Networking,6,1616000,96.0,69,Divorciado,60,2021,10,high,1.07,-1,0,1282958,1213,0,31,0
103626,102139,1,Presencial,2.185,6,Mujer,Linkedin,7,351438,40.0,88,Casado,32,2020,6,low,102154,Presencial,6.48,1,Hombre,Ferias & Networking,5,590000,90.0,67,Casado,25,2021,6,high,4.295,-5,-2,238562,370,0,-7,1
103380,102089,1,Presencial,1.665,1,Mujer,Portal Web,3,407225,40.0,76,Casado,32,2017,7,low,102077,Presencial,2.75,1,Hombre,Ferias & Networking,6,1616000,96.0,69,Divorciado,60,2021,10,high,1.085,0,3,1208775,1548,0,28,1
103431,102074,1,Presencial,1.37,3,Mujer,Referidos,9,485133,40.0,67,Soltero,37,2018,2,low,102028,Presencial,1.35,0,Hombre,Ferias & Networking,4,1616000,80.0,83,Viudo,43,2015,12,high,-0.020000000000000018,-3,-5,1130867,-781,1,6,0
103723,102115,1,Presencial,3.115,3,Mujer,Portal Web,6,505015,40.0,75,Casado,38,2018,7,low,102116,Presencial,2.0,2,Mujer,Portal Web,4,1616000,94.0,76,Soltero,35,2018,12,high,-1.1150000000000002,-1,-2,1110985,175,0,-3,0
103553,102172,1,Presencial,4.385,2,Hombre,Portal Web,4,279912,40.0,82,Soltero,46,2022,10,low,102020,Presencial,5.58,1,Hombre,Portal Web,7,1049000,57.0,70,Casado,29,2016,4,low,1.1950000000000003,-1,3,769088,-2370,1,-17,1
103583,102022,1,Presencial,2.18,3,Mujer,Linkedin,5,453421,40.0,66,Casado,38,2013,12,low,102081,Presencial,2.07,0,Hombre,Portal Web,6,1616000,94.0,66,Viudo,47,2020,5,high,-0.11000000000000032,-3,1,1162579,2344,0,9,1
103496,102058,1,Presencial,0.55,1,Mujer,Portal Web,8,434557,40.0,71,Soltero,42,2016,10,low,102172,Presencial,1.4,2,Hombre,Ferias & Networking,11,1616000,75.0,71,Casado,59,2021,2,low,0.8499999999999999,1,3,1181443,1581,0,17,1
102479,102078,1,Presencial,2.01,1,Mujer,Ferias & Networking,11,309006,40.0,62,Casado,44,2017,7,low,102143,Presencial,2.17,1,Hombre,Ferias & Networking,9,998000,83.0,76,Casado,29,2017,5,high,0.16000000000000014,0,-2,688994,-45,1,-15,0
103759,102131,1,Presencial,1.8,1,Hombre,Portal Web,15,796842,40.0,86,Divorciado,51,2023,2,low,102109,Presencial,5.54,0,Hombre,Linkedin,3,998000,39.0,77,Soltero,34,2021,12,low,3.74,-1,-12,201158,-433,1,-17,0
102201,102124,1,Presencial,1.115,2,Mujer,Ferias & Networking,9,779881,40.0,75,Viudo,53,2021,3,low,102099,Presencial,2.84,2,Mujer,Linkedin,4,947000,90.0,70,Soltero,24,2012,10,high,1.7249999999999999,0,-5,167119,-3072,1,-29,0
102325,102009,1,Presencial,2.02,0,Mujer,Referidos,8,881452,40.0,79,Casado,48,2012,7,low,102116,Presencial,2.06,2,Hombre,Referidos,9,1461470,90.0,73,Casado,44,2022,8,high,0.040000000000000036,2,1,580018,3659,0,-4,0
101348,102116,1,Presencial,2.0,5,Mujer,Linkedin,3,187090,39.0,74,Casado,22,2019,7,low,102021,Presencial,2.32,0,Mujer,Portal Web,22,1616000,94.0,76,Casado,59,2020,7,high,0.31999999999999984,-5,19,1428910,383,0,37,1
101338,102010,1,Presencial,5.915,1,Hombre,Portal Web,2,188659,39.0,79,Soltero,15,2012,6,low,102035,Presencial,2.02,0,Mujer,Linkedin,5,1564490,77.0,73,Casado,44,2021,8,low,-3.895,-1,3,1375831,3334,0,29,1
100076,102115,1,Presencial,1.715,2,Mujer,Referidos,4,232899,39.0,71,Casado,24,2018,10,low,102116,Presencial,2.0,2,Mujer,Portal Web,4,1616000,94.0,76,Soltero,35,2018,12,high,0.2849999999999999,0,0,1383101,79,0,11,0
101095,102075,1,Presencial,7.915,1,Mujer,Referidos,2,230043,39.0,70,Soltero,23,2017,3,low,102047,Presencial,2.7,1,Hombre,Referidos,11,1255430,90.0,76,Casado,30,2013,3,high,-5.215,0,9,1025387,-1441,1,7,1
101645,102091,1,Presencial,5.025,6,Hombre,Portal Web,2,227405,39.0,79,Casado,23,2016,9,low,102149,Presencial,1.54,1,Mujer,Portal Web,4,1616000,73.0,77,Casado,39,2014,12,low,-3.4850000000000003,-5,2,1388595,-618,1,16,1
101079,102086,1,Presencial,2.17,2,Mujer,Portal Web,3,269217,39.0,84,Casado,25,2018,1,low,102085,Presencial,2.22,2,Mujer,Linkedin,7,1306940,87.0,68,Divorciado,39,2021,3,high,0.050000000000000266,0,4,1037723,1137,0,14,0
102155,102159,2,Presencial,1.78,1,Mujer,Ferias & Networking,1,590000,39.0,80,Soltero,20,2016,10,low,102120,Híbrida,0.98,2,Hombre,Referidos,14,808000,90.0,86,Soltero,44,2022,8,high,-0.8,1,13,218000,2117,0,24,1
100546,102159,1,Presencial,4.14,2,Mujer,Linkedin,7,271530,39.0,69,Soltero,30,2022,5,low,102120,Híbrida,0.98,2,Hombre,Referidos,14,808000,90.0,86,Soltero,44,2022,8,high,-3.1599999999999997,0,7,536470,91,0,14,1
100103,102084,1,Presencial,2.795,1,Hombre,Linkedin,3,348149,39.0,80,Soltero,30,2019,2,low,102171,Presencial,2.62,3,Mujer,Portal Web,14,1616000,89.0,76,Divorciado,50,2023,7,high,-0.17499999999999982,2,11,1267851,1619,0,20,1
100283,102046,1,Presencial,1.545,1,Hombre,Headhunter,2,392705,39.0,81,Casado,27,2012,8,low,102007,Presencial,1.68,0,Mujer,Portal Web,8,1616000,41.0,71,Soltero,50,2015,10,low,0.135,-1,6,1223295,1177,0,23,1
100048,102085,1,Presencial,2.405,1,Mujer,Ferias & Networking,4,412997,39.0,77,Casado,32,2016,4,low,102145,Presencial,6.59,4,Hombre,Portal Web,12,1616000,47.0,71,Casado,39,2015,8,low,4.1850000000000005,3,8,1203003,-250,1,7,1
102131,102109,2,Presencial,5.54,0,Hombre,Linkedin,3,998000,39.0,77,Soltero,34,2021,12,low,102123,Presencial,3.86,1,Mujer,Portal Web,5,998000,97.0,82,Casado,32,2019,9,high,-1.6800000000000002,1,2,0,-817,1,-2,1
100545,102109,1,Presencial,3.335,0,Mujer,Portal Web,12,416415,39.0,69,Soltero,40,2018,8,low,102123,Presencial,3.86,1,Mujer,Portal Web,5,998000,97.0,82,Casado,32,2019,9,high,0.5249999999999999,1,-7,581585,412,0,-8,0
101009,102045,1,Presencial,2.43,0,Mujer,Referidos,5,277350,39.0,78,Casado,36,2013,10,low,102171,Presencial,3.19,3,Hombre,Portal Web,11,1616000,97.0,65,Casado,53,2023,9,high,0.7599999999999998,3,6,1338650,3645,0,17,0
101316,102159,1,Presencial,1.895,2,Mujer,Portal Web,4,273794,39.0,77,Casado,46,2022,11,low,102120,Híbrida,0.98,2,Hombre,Referidos,14,808000,90.0,86,Soltero,44,2022,8,high,-0.915,0,10,534206,-95,1,-2,1
100726,102095,1,Presencial,5.54,2,Hombre,Ferias & Networking,16,308899,39.0,72,Viudo,43,2017,2,low,102171,Presencial,3.28,2,Mujer,Portal Web,3,1616000,80.0,75,Soltero,42,2023,10,high,-2.2600000000000002,0,-13,1307101,2438,0,-1,1
101151,102131,1,Presencial,1.835,0,Hombre,Portal Web,15,798105,39.0,86,Divorciado,51,2023,2,low,102109,Presencial,5.54,0,Hombre,Linkedin,3,998000,39.0,77,Soltero,34,2021,12,low,3.705,0,-12,199895,-432,1,-17,0
100323,102156,1,Presencial,1.835,2,Mujer,Referidos,12,657811,39.0,70,Viudo,50,2022,8,low,102154,Presencial,4.23,2,Hombre,Portal Web,22,1616000,92.0,76,Soltero,63,2023,12,high,2.3950000000000005,0,10,958189,488,0,13,1
101549,102115,1,Presencial,6.685,1,Hombre,Referidos,11,694950,39.0,81,Soltero,50,2020,5,low,102116,Presencial,2.0,2,Mujer,Portal Web,4,1616000,94.0,76,Soltero,35,2018,12,high,-4.685,1,-7,921050,-496,1,-15,1
101585,102115,1,Presencial,2.675,0,Mujer,Portal Web,15,878134,39.0,69,Soltero,51,2019,2,low,102116,Presencial,2.0,2,Mujer,Portal Web,4,1616000,94.0,76,Soltero,35,2018,12,high,-0.6749999999999998,2,-11,737866,-58,1,-16,1
103132,102084,1,Presencial,3.07,2,Mujer,Ferias & Networking,1,167455,39.0,74,Soltero,21,2018,8,low,102171,Presencial,2.62,3,Mujer,Portal Web,14,1616000,89.0,76,Divorciado,50,2023,7,high,-0.44999999999999973,1,13,1448545,1790,0,29,0
102824,102010,1,Presencial,5.89,1,Hombre,Portal Web,2,183227,39.0,79,Soltero,15,2012,6,low,102035,Presencial,2.02,0,Mujer,Linkedin,5,1564490,77.0,73,Casado,44,2021,8,low,-3.8699999999999997,-1,3,1381263,3334,0,29,0
104073,102113,1,Presencial,2.51,2,Mujer,Portal Web,2,226746,39.0,65,Casado,27,2021,1,low,102041,Presencial,2.96,2,Hombre,Portal Web,6,1152410,46.0,75,Casado,27,2012,1,low,0.4500000000000002,0,4,925664,-3282,1,0,1
103843,102151,1,Presencial,1.5,0,Mujer,Linkedin,5,288729,39.0,70,Soltero,31,2022,7,low,102105,Presencial,1.51,2,Hombre,Ferias & Networking,10,1616000,85.0,80,Divorciado,45,2021,11,high,0.010000000000000009,2,5,1327271,-251,1,14,1
102450,102145,1,Presencial,2.475,3,Mujer,Portal Web,6,448657,39.0,69,Casado,37,2020,11,low,102116,Presencial,1.43,1,Mujer,Portal Web,3,692000,89.0,73,Viudo,23,2016,12,high,-1.0450000000000002,-2,-3,243343,-1436,1,-14,0
103046,102005,1,Presencial,1.48,1,Mujer,Ferias & Networking,10,468262,39.0,78,Casado,31,2012,5,low,102075,Presencial,3.25,2,Hombre,Portal Web,15,1616000,90.0,65,Soltero,47,2017,2,high,1.77,1,5,1147738,1733,0,16,0
102946,102116,1,Presencial,1.73,1,Mujer,Portal Web,10,447760,39.0,76,Soltero,43,2020,4,low,102021,Presencial,2.32,0,Mujer,Portal Web,22,1616000,94.0,76,Casado,59,2020,7,high,0.5899999999999999,-1,12,1168240,92,0,16,0
102280,102128,1,Presencial,2.055,3,Mujer,Portal Web,6,434068,39.0,75,Casado,46,2020,8,low,102056,Presencial,4.11,10,Mujer,Portal Web,16,1616000,46.0,72,Soltero,55,2021,2,low,2.055,7,10,1181932,189,0,9,0
103675,102094,1,Presencial,2.95,3,Mujer,Referidos,15,295859,39.0,81,Casado,44,2019,5,low,102095,Presencial,1.32,1,Hombre,Portal Web,4,998000,90.0,85,Casado,28,2016,2,high,-1.6300000000000001,-2,-11,702141,-1207,1,-16,1
103331,102095,1,Presencial,5.52,2,Hombre,Ferias & Networking,16,311348,39.0,72,Viudo,43,2017,2,low,102171,Presencial,3.28,2,Mujer,Portal Web,3,1616000,80.0,75,Soltero,42,2023,10,high,-2.2399999999999998,0,-13,1304652,2440,0,-1,1
103696,102101,1,Presencial,4.935,1,Mujer,Ferias & Networking,11,661496,39.0,72,Soltero,46,2017,7,low,102089,Presencial,6.23,0,Hombre,Portal Web,26,1616000,92.0,68,Divorciado,55,2014,1,high,1.2950000000000008,-1,15,954504,-1280,1,9,1
102222,102089,1,Presencial,1.69,2,Hombre,Portal Web,14,898565,39.0,77,Casado,52,2016,5,low,102077,Presencial,2.75,1,Hombre,Ferias & Networking,6,1616000,96.0,69,Divorciado,60,2021,10,high,1.06,-1,-8,717435,1979,0,8,0
100281,102093,1,Presencial,1.7,0,Hombre,Portal Web,1,97282,38.0,76,Soltero,14,2016,9,low,102139,Presencial,5.41,0,Mujer,Ferias & Networking,4,488000,89.0,62,Soltero,23,2021,6,high,3.71,0,3,390718,1731,0,9,1
101740,102136,1,Presencial,5.45,0,Hombre,Linkedin,3,115587,38.0,63,Soltero,21,2022,8,low,102034,Presencial,1.78,2,Hombre,Portal Web,3,1616000,89.0,78,Casado,35,2013,1,high,-3.67,2,0,1500413,-3507,1,14,1
100491,102079,1,Presencial,2.595,7,Mujer,Portal Web,1,140641,38.0,80,Soltero,17,2016,12,low,102146,Presencial,2.63,1,Mujer,Portal Web,4,1358450,80.0,81,Soltero,35,2016,3,high,0.0349999999999997,-6,3,1217809,-269,1,18,0
100557,102056,1,Presencial,2.71,3,Hombre,Portal Web,2,136704,38.0,77,Soltero,16,2016,2,low,102014,Presencial,5.24,1,Hombre,Ferias & Networking,16,1616000,70.0,63,Viudo,65,2023,3,low,2.5300000000000002,-2,14,1479296,2575,0,49,0
101444,102074,1,Presencial,1.895,9,Hombre,Portal Web,4,144817,38.0,78,Soltero,19,2018,2,low,102028,Presencial,1.35,0,Hombre,Ferias & Networking,4,1616000,80.0,83,Viudo,43,2015,12,high,-0.5449999999999999,-9,0,1471183,-784,1,24,0
101268,102122,1,Presencial,1.15,1,Hombre,Referidos,1,165910,38.0,74,Soltero,23,2021,10,low,102075,Presencial,1.83,4,Hombre,Portal Web,6,1616000,90.0,66,Viudo,48,2019,3,high,0.6800000000000002,3,5,1450090,-932,1,25,0
101698,102137,1,Presencial,1.45,3,Mujer,Portal Web,3,224733,38.0,68,Casado,25,2020,5,low,102046,Presencial,1.18,0,Mujer,Portal Web,2,845000,37.0,79,Casado,27,2017,12,low,-0.27,-3,-1,620267,-867,1,2,0
101171,102113,1,Presencial,2.505,2,Mujer,Portal Web,2,225055,38.0,65,Casado,27,2021,1,low,102041,Presencial,2.96,2,Hombre,Portal Web,6,1152410,46.0,75,Casado,27,2012,1,low,0.45500000000000007,0,4,927355,-3284,1,0,1
101581,102035,1,Presencial,5.775,2,Hombre,Linkedin,2,227784,38.0,64,Casado,19,2013,4,low,102041,Presencial,2.86,1,Hombre,Portal Web,23,1900000,83.0,72,Casado,57,2013,8,high,-2.9150000000000005,-1,21,1672216,115,0,38,0
102062,102149,2,Presencial,0.92,2,Mujer,Referidos,6,692000,38.0,72,Soltero,21,2014,10,low,102141,Presencial,2.07,0,Mujer,Headhunter,3,1409960,90.0,86,Casado,37,2017,2,high,1.15,-2,-3,717960,877,0,16,1
100392,102149,1,Presencial,2.71,2,Mujer,Portal Web,4,409054,38.0,69,Soltero,36,2021,10,low,102141,Presencial,2.07,0,Mujer,Headhunter,3,1409960,90.0,86,Casado,37,2017,2,high,-0.6400000000000001,-2,-1,1000906,-1702,1,1,1
101986,102132,1,Presencial,2.57,2,Hombre,Portal Web,8,408684,38.0,84,Soltero,36,2021,9,low,102138,Presencial,4.51,1,Hombre,Linkedin,16,1616000,25.0,80,Viudo,45,2014,3,low,1.94,-1,8,1207316,-2740,1,9,0
100906,102080,1,Presencial,1.965,3,Hombre,Portal Web,8,405575,38.0,69,Soltero,32,2017,2,low,102035,Presencial,1.93,0,Mujer,Linkedin,18,1616000,94.0,75,Viudo,47,2016,8,high,-0.03500000000000014,-3,10,1210425,-170,1,15,1
100929,102016,1,Presencial,1.455,3,Hombre,Portal Web,3,767999,38.0,76,Casado,28,2012,11,low,102008,Híbrida,2.51,2,Mujer,Portal Web,6,1616000,40.0,80,Casado,44,2017,8,low,1.0549999999999997,-1,3,848001,1749,0,16,1
101098,102153,1,Presencial,3.36,8,Mujer,Portal Web,7,427851,38.0,66,Soltero,39,2023,3,low,102143,Presencial,6.39,1,Mujer,Linkedin,5,1616000,90.0,68,Casado,41,2019,6,high,3.03,-7,-2,1188149,-1379,1,2,0
101601,102138,1,Presencial,1.555,1,Mujer,Portal Web,4,425051,38.0,87,Viudo,37,2021,5,low,102059,Presencial,3.26,1,Hombre,Linkedin,5,1616000,57.0,75,Soltero,44,2018,4,low,1.7049999999999998,0,1,1190949,-1146,1,7,1
100217,102055,1,Presencial,1.485,0,Mujer,Portal Web,4,448084,38.0,75,Casado,33,2016,5,low,102129,Presencial,1.92,2,Hombre,Referidos,8,1616000,97.0,63,Casado,42,2013,2,high,0.43499999999999983,2,4,1167916,-1162,1,9,1
100167,102137,1,Presencial,6.04,10,Hombre,Portal Web,10,449139,38.0,59,Casado,38,2021,8,low,102046,Presencial,1.18,0,Mujer,Portal Web,2,845000,37.0,79,Casado,27,2017,12,low,-4.86,-10,-8,395861,-1319,1,-11,1
101616,102094,1,Presencial,6.215,1,Hombre,Referidos,8,847823,38.0,77,Casado,39,2020,1,low,102095,Presencial,1.32,1,Hombre,Portal Web,4,998000,90.0,85,Casado,28,2016,2,high,-4.895,0,-4,150177,-1451,1,-11,0
101234,102086,1,Presencial,4.73,2,Hombre,Ferias & Networking,6,489726,38.0,77,Casado,35,2016,3,low,102085,Presencial,2.22,2,Mujer,Linkedin,7,1306940,87.0,68,Divorciado,39,2021,3,high,-2.5100000000000002,0,1,817214,1828,0,4,0
100884,102039,1,Presencial,0.925,3,Hombre,Referidos,8,254417,38.0,72,Soltero,36,2014,4,low,102054,Presencial,3.66,0,Hombre,Referidos,5,1616000,93.0,75,Viudo,49,2018,6,high,2.7350000000000003,-3,-3,1361583,1525,0,13,1
101995,102048,1,Presencial,3.825,3,Mujer,Ferias & Networking,8,259741,38.0,68,Casado,35,2013,12,low,102092,Presencial,3.99,0,Mujer,Portal Web,5,590000,59.0,76,Soltero,20,2015,8,low,0.16500000000000004,-3,-3,330259,616,0,-15,0
101090,102115,1,Presencial,2.8,1,Hombre,Ferias & Networking,7,460792,38.0,86,Casado,41,2019,1,low,102116,Presencial,2.0,2,Mujer,Portal Web,4,1616000,94.0,76,Soltero,35,2018,12,high,-0.7999999999999998,1,-3,1155208,-16,1,-6,1
101146,102109,1,Presencial,2.585,2,Hombre,Referidos,9,270556,38.0,78,Soltero,40,2018,5,low,102123,Presencial,3.86,1,Mujer,Portal Web,5,998000,97.0,82,Casado,32,2019,9,high,1.275,-1,-4,727444,504,0,-8,1
100279,102112,1,Presencial,3.435,2,Mujer,Portal Web,8,302055,38.0,81,Casado,44,2019,12,low,102031,Presencial,2.27,7,Hombre,Linkedin,1,692000,83.0,74,Soltero,26,2020,6,high,-1.165,5,-7,389945,198,0,-18,1
100502,102028,1,Presencial,5.815,0,Mujer,Ferias & Networking,3,376487,38.0,76,Divorciado,37,2012,8,low,102085,Presencial,1.39,2,Mujer,Linkedin,12,1358450,97.0,72,Soltero,35,2016,12,high,-4.425000000000001,2,9,981963,1594,0,-2,0
100970,102120,1,Presencial,4.385,4,Mujer,Referidos,6,835783,38.0,68,Viudo,50,2021,10,low,102171,Presencial,6.48,2,Hombre,Ferias & Networking,9,1616000,80.0,71,Casado,47,2023,8,high,2.0950000000000006,-2,3,780217,662,0,-3,1
101606,102101,1,Presencial,4.93,1,Mujer,Ferias & Networking,11,656662,38.0,72,Soltero,46,2017,7,low,102089,Presencial,6.23,0,Hombre,Portal Web,26,1616000,92.0,68,Divorciado,55,2014,1,high,1.3000000000000007,-1,15,959338,-1283,1,9,1
102119,102107,2,Presencial,2.22,2,Hombre,Portal Web,12,1616000,38.0,70,Divorciado,52,2021,1,low,102069,Presencial,2.4,1,Mujer,Linkedin,8,1616000,47.0,79,Casado,63,2023,6,low,0.17999999999999972,-1,-4,0,889,0,11,1
102042,102107,2,Presencial,2.19,2,Hombre,Ferias & Networking,8,1616000,38.0,78,Divorciado,57,2018,6,low,102069,Presencial,2.4,1,Mujer,Linkedin,8,1616000,47.0,79,Casado,63,2023,6,low,0.20999999999999996,-1,0,0,1818,0,6,1
103791,102107,1,Presencial,6.335,3,Mujer,Ferias & Networking,1,81892,38.0,80,Soltero,17,2019,12,low,102069,Presencial,2.4,1,Mujer,Linkedin,8,1616000,47.0,79,Casado,63,2023,6,low,-3.935,-2,7,1534108,1288,0,46,1
102911,102136,1,Presencial,5.49,0,Hombre,Linkedin,3,119783,38.0,63,Soltero,21,2022,8,low,102034,Presencial,1.78,2,Hombre,Portal Web,3,1616000,89.0,78,Casado,35,2013,1,high,-3.71,2,0,1496217,-3505,1,14,0
102456,102056,1,Presencial,2.72,2,Hombre,Portal Web,2,140471,38.0,77,Soltero,16,2016,2,low,102014,Presencial,5.24,1,Hombre,Ferias & Networking,16,1616000,70.0,63,Viudo,65,2023,3,low,2.52,-1,14,1475529,2578,0,49,0
104051,102120,1,Presencial,5.45,4,Mujer,Portal Web,2,136726,38.0,72,Soltero,20,2020,6,low,102171,Presencial,6.48,2,Hombre,Ferias & Networking,9,1616000,80.0,71,Casado,47,2023,8,high,1.0300000000000002,-2,7,1479274,1167,0,27,1
104091,102079,1,Presencial,2.605,6,Mujer,Portal Web,1,144276,38.0,80,Soltero,17,2016,12,low,102146,Presencial,2.63,1,Mujer,Portal Web,4,1358450,80.0,81,Soltero,35,2016,3,high,0.02499999999999991,-5,3,1214174,-269,1,18,1
103981,102074,1,Presencial,1.895,10,Hombre,Portal Web,4,146171,38.0,78,Soltero,19,2018,2,low,102028,Presencial,1.35,0,Hombre,Ferias & Networking,4,1616000,80.0,83,Viudo,43,2015,12,high,-0.5449999999999999,-10,0,1469829,-785,1,24,1
103297,102088,1,Presencial,1.72,1,Mujer,Portal Web,1,148084,38.0,66,Soltero,18,2017,12,low,102139,Presencial,4.96,1,Mujer,Portal Web,3,488000,82.0,65,Soltero,20,2018,4,high,3.24,0,2,339916,108,0,2,1
103212,102146,1,Presencial,4.04,2,Hombre,Linkedin,5,205914,38.0,79,Casado,26,2021,12,low,102035,Presencial,2.66,0,Mujer,Portal Web,15,1616000,77.0,78,Casado,39,2013,10,low,-1.38,-2,10,1410086,-2985,1,13,1
103103,102038,1,Presencial,1.51,1,Mujer,Portal Web,5,189391,38.0,79,Divorciado,17,2013,7,low,102125,Presencial,2.06,1,Hombre,Portal Web,12,1616000,81.0,82,Casado,44,2018,1,high,0.55,0,7,1426609,1638,0,27,0
103746,102026,1,Presencial,2.05,3,Hombre,Referidos,2,214032,38.0,78,Soltero,18,2013,2,low,102101,Presencial,2.7,1,Mujer,Portal Web,15,1616000,97.0,79,Casado,58,2017,6,high,0.6500000000000004,-2,13,1401968,1587,0,40,1
104123,102131,1,Presencial,5.555,2,Mujer,Portal Web,5,330211,38.0,85,Soltero,34,2022,12,low,102109,Presencial,5.54,0,Hombre,Linkedin,3,998000,39.0,77,Soltero,34,2021,12,low,-0.01499999999999968,-2,-2,667789,-346,1,0,1
103869,102111,1,Presencial,7.53,4,Hombre,Portal Web,9,387876,38.0,71,Casado,32,2018,5,low,102097,Híbrida,2.04,1,Mujer,Referidos,15,1616000,94.0,67,Soltero,50,2021,5,high,-5.49,-3,6,1228124,1089,0,18,1
102316,102149,1,Presencial,2.695,2,Mujer,Portal Web,4,405328,38.0,69,Soltero,36,2021,10,low,102141,Presencial,2.07,0,Mujer,Headhunter,3,1409960,90.0,86,Casado,37,2017,2,high,-0.625,-2,-1,1004632,-1704,1,1,0
102988,102046,1,Presencial,1.545,0,Hombre,Headhunter,2,387005,38.0,81,Casado,27,2012,8,low,102007,Presencial,1.68,0,Mujer,Portal Web,8,1616000,41.0,71,Soltero,50,2015,10,low,0.135,0,6,1228995,1178,0,23,1
103419,102138,1,Presencial,1.545,2,Mujer,Portal Web,4,424571,38.0,87,Viudo,37,2021,5,low,102059,Presencial,3.26,1,Hombre,Linkedin,5,1616000,57.0,75,Soltero,44,2018,4,low,1.7149999999999999,-1,1,1191429,-1144,1,7,1
104106,102080,1,Presencial,1.96,2,Hombre,Portal Web,8,405539,38.0,69,Soltero,32,2017,2,low,102035,Presencial,1.93,0,Mujer,Linkedin,18,1616000,94.0,75,Viudo,47,2016,8,high,-0.030000000000000027,-2,10,1210461,-172,1,15,1
102896,102085,1,Presencial,2.36,1,Mujer,Ferias & Networking,4,405732,38.0,77,Casado,31,2016,4,low,102145,Presencial,6.59,4,Hombre,Portal Web,12,1616000,47.0,71,Casado,39,2015,8,low,4.23,3,8,1210268,-252,1,8,1
103040,102046,1,Presencial,2.295,9,Mujer,Portal Web,4,424977,38.0,82,Divorciado,30,2013,9,low,102007,Presencial,1.68,0,Mujer,Portal Web,8,1616000,41.0,71,Soltero,50,2015,10,low,-0.615,-9,4,1191023,774,0,20,1
103678,102137,1,Presencial,6.06,11,Hombre,Portal Web,10,447604,38.0,59,Casado,38,2021,8,low,102046,Presencial,1.18,0,Mujer,Portal Web,2,845000,37.0,79,Casado,27,2017,12,low,-4.88,-11,-8,397396,-1319,1,-11,1
103880,102115,1,Presencial,6.03,2,Hombre,Linkedin,8,485629,38.0,70,Soltero,40,2020,8,low,102116,Presencial,2.0,2,Mujer,Portal Web,4,1616000,94.0,76,Soltero,35,2018,12,high,-4.03,0,-4,1130371,-598,1,-5,1
103314,102041,1,Presencial,2.625,1,Mujer,Portal Web,13,272169,38.0,66,Casado,34,2012,9,low,102147,Presencial,1.29,0,Mujer,Portal Web,8,1616000,44.0,73,Casado,51,2014,5,low,-1.335,-1,-5,1343831,623,0,17,0
103653,102022,1,Presencial,5.335,6,Mujer,Linkedin,7,267032,38.0,70,Divorciado,34,2012,5,low,102081,Presencial,2.07,0,Hombre,Portal Web,6,1616000,94.0,66,Viudo,47,2020,5,high,-3.265,-6,-1,1348968,2935,0,13,1
103912,102138,1,Presencial,4.965,2,Hombre,Portal Web,9,394916,38.0,78,Soltero,44,2021,1,low,102059,Presencial,3.26,1,Hombre,Linkedin,5,1616000,57.0,75,Soltero,44,2018,4,low,-1.705,-1,-4,1221084,-1010,1,0,0
102700,102029,1,Presencial,2.695,2,Hombre,Linkedin,10,278612,38.0,72,Casado,37,2014,2,low,102132,Presencial,5.79,2,Hombre,Portal Web,16,1616000,80.0,84,Casado,49,2017,9,high,3.095,0,6,1337388,1306,0,12,0
102741,102091,1,Presencial,2.165,3,Mujer,Portal Web,15,454464,38.0,77,Casado,41,2017,2,low,102149,Presencial,1.54,1,Mujer,Portal Web,4,1616000,73.0,77,Casado,39,2014,12,low,-0.625,-2,-11,1161536,-778,1,-2,0
103606,102120,1,Presencial,4.41,4,Mujer,Referidos,6,835393,38.0,68,Viudo,50,2021,10,low,102171,Presencial,6.48,2,Hombre,Ferias & Networking,9,1616000,80.0,71,Casado,47,2023,8,high,2.0700000000000003,-2,3,780607,662,0,-3,1
103709,102125,1,Presencial,3.535,1,Hombre,Portal Web,9,737960,38.0,82,Casado,52,2020,3,low,102096,Híbrida,4.0,2,Mujer,Referidos,5,692000,87.0,82,Casado,29,2022,7,high,0.46499999999999986,1,-4,-45960,859,0,-23,1
102276,102115,1,Presencial,2.675,1,Mujer,Portal Web,15,877439,38.0,69,Soltero,51,2019,2,low,102116,Presencial,2.0,2,Mujer,Portal Web,4,1616000,94.0,76,Soltero,35,2018,12,high,-0.6749999999999998,1,-11,738561,-57,1,-16,0
103528,102078,1,Presencial,5.93,3,Hombre,Portal Web,3,834518,38.0,80,Viudo,51,2017,2,low,102143,Presencial,2.17,1,Hombre,Ferias & Networking,9,998000,83.0,76,Casado,29,2017,5,high,-3.76,-2,6,163482,107,0,-22,0
104150,102120,1,Presencial,2.22,1,Mujer,Referidos,14,916099,38.0,71,Divorciado,58,2021,5,low,102171,Presencial,6.48,2,Hombre,Ferias & Networking,9,1616000,80.0,71,Casado,47,2023,8,high,4.26,1,-5,699901,806,0,-11,1
101295,102035,1,Presencial,0.875,1,Mujer,Portal Web,4,189152,37.0,78,Soltero,17,2014,2,low,102041,Presencial,2.86,1,Hombre,Portal Web,23,1900000,83.0,72,Casado,57,2013,8,high,1.9849999999999999,0,19,1710848,-198,1,40,1
101732,102064,1,Presencial,1.37,0,Mujer,Ferias & Networking,7,368947,37.0,71,Casado,30,2017,5,low,102067,Presencial,1.34,0,Hombre,Portal Web,6,1616000,92.0,92,Casado,43,2018,2,high,-0.030000000000000027,0,-1,1247053,250,0,13,0
102137,102046,2,Presencial,1.18,0,Mujer,Portal Web,2,845000,37.0,79,Casado,27,2017,12,low,102007,Presencial,1.68,0,Mujer,Portal Web,8,1616000,41.0,71,Soltero,50,2015,10,low,0.5,0,6,771000,-789,1,23,1
101306,102046,1,Presencial,2.295,9,Mujer,Portal Web,4,426101,37.0,82,Divorciado,30,2013,9,low,102007,Presencial,1.68,0,Mujer,Portal Web,8,1616000,41.0,71,Soltero,50,2015,10,low,-0.615,-9,4,1189899,773,0,20,1
102061,102115,2,Presencial,2.14,2,Hombre,Ferias & Networking,10,1203920,37.0,80,Casado,29,2012,11,low,102116,Presencial,2.0,2,Mujer,Portal Web,4,1616000,94.0,76,Soltero,35,2018,12,high,-0.14000000000000012,0,-6,412080,2237,0,6,1
101203,102115,1,Presencial,2.61,12,Mujer,Portal Web,5,268885,37.0,70,Soltero,41,2018,8,low,102116,Presencial,2.0,2,Mujer,Portal Web,4,1616000,94.0,76,Soltero,35,2018,12,high,-0.6099999999999999,-10,-1,1347115,148,0,-6,1
100224,102138,1,Presencial,4.96,1,Hombre,Portal Web,9,395108,37.0,78,Soltero,44,2021,1,low,102059,Presencial,3.26,1,Hombre,Linkedin,5,1616000,57.0,75,Soltero,44,2018,4,low,-1.7000000000000002,0,-4,1220892,-1010,1,0,1
101043,102091,1,Presencial,2.17,3,Mujer,Portal Web,15,456915,37.0,77,Casado,41,2017,2,low,102149,Presencial,1.54,1,Mujer,Portal Web,4,1616000,73.0,77,Casado,39,2014,12,low,-0.6299999999999999,-2,-11,1159085,-778,1,-2,0
101258,102055,1,Presencial,0.95,0,Mujer,Ferias & Networking,12,681199,37.0,67,Casado,43,2013,11,low,102129,Presencial,1.92,2,Hombre,Referidos,8,1616000,97.0,63,Casado,42,2013,2,high,0.97,2,-4,934801,-254,1,-1,0
101238,102125,1,Presencial,3.545,2,Hombre,Portal Web,9,734432,37.0,82,Casado,52,2020,3,low,102096,Híbrida,4.0,2,Mujer,Referidos,5,692000,87.0,82,Casado,29,2022,7,high,0.45500000000000007,0,-4,-42432,860,0,-23,1
102163,102120,2,Presencial,7.53,9,Hombre,Linkedin,7,1616000,37.0,75,Casado,49,2019,8,low,102171,Presencial,6.48,2,Hombre,Ferias & Networking,9,1616000,80.0,71,Casado,47,2023,8,high,-1.0499999999999998,-7,2,0,1453,0,-2,1
100143,102120,1,Presencial,2.24,1,Mujer,Referidos,14,921615,37.0,71,Divorciado,57,2021,5,low,102171,Presencial,6.48,2,Hombre,Ferias & Networking,9,1616000,80.0,71,Casado,47,2023,8,high,4.24,1,-5,694385,806,0,-10,1
103687,102125,1,Presencial,1.51,3,Hombre,Portal Web,3,143992,37.0,76,Soltero,22,2021,6,low,102096,Híbrida,4.0,2,Mujer,Referidos,5,692000,87.0,82,Casado,29,2022,7,high,2.49,-1,2,548008,394,0,7,1
103666,102089,1,Presencial,3.15,1,Mujer,Portal Web,5,333608,37.0,77,Casado,30,2019,9,low,102077,Presencial,2.75,1,Hombre,Ferias & Networking,6,1616000,96.0,69,Divorciado,60,2021,10,high,-0.3999999999999999,0,1,1282392,761,0,30,1
103649,102064,1,Presencial,1.325,1,Mujer,Ferias & Networking,7,368379,37.0,71,Casado,30,2017,5,low,102067,Presencial,1.34,0,Hombre,Portal Web,6,1616000,92.0,92,Casado,43,2018,2,high,0.015000000000000124,-1,-1,1247621,251,0,13,1
103258,102132,1,Presencial,2.535,1,Hombre,Portal Web,8,405517,37.0,84,Soltero,36,2021,9,low,102138,Presencial,4.51,1,Hombre,Linkedin,16,1616000,25.0,80,Viudo,45,2014,3,low,1.9749999999999996,0,8,1210483,-2741,1,9,1
103352,102029,1,Presencial,2.12,2,Mujer,Portal Web,7,389579,37.0,85,Casado,28,2014,9,low,102132,Presencial,5.79,2,Hombre,Portal Web,16,1616000,80.0,84,Casado,49,2017,9,high,3.67,0,9,1226421,1107,0,21,1
103597,102016,1,Presencial,1.48,3,Hombre,Portal Web,3,770854,37.0,76,Casado,28,2012,11,low,102008,Híbrida,2.51,2,Mujer,Portal Web,6,1616000,40.0,80,Casado,44,2017,8,low,1.0299999999999998,-1,3,845146,1747,0,16,1
102943,102055,1,Presencial,1.475,1,Mujer,Portal Web,4,451424,37.0,75,Casado,33,2016,5,low,102129,Presencial,1.92,2,Hombre,Referidos,8,1616000,97.0,63,Casado,42,2013,2,high,0.44499999999999984,1,4,1164576,-1164,1,9,1
102506,102094,1,Presencial,6.205,1,Hombre,Referidos,8,852187,37.0,77,Casado,39,2020,1,low,102095,Presencial,1.32,1,Hombre,Portal Web,4,998000,90.0,85,Casado,28,2016,2,high,-4.885,0,-4,145813,-1449,1,-11,0
103538,102031,1,Presencial,2.12,2,Mujer,Portal Web,6,484353,37.0,81,Casado,33,2013,10,low,102111,Presencial,2.95,2,Hombre,Portal Web,8,1610000,76.0,87,Casado,31,2017,7,low,0.8300000000000001,0,2,1125647,1346,0,-2,0
103978,102118,1,Presencial,6.35,2,Hombre,Ferias & Networking,5,268768,37.0,69,Divorciado,41,2019,1,low,102171,Presencial,4.76,17,Mujer,Linkedin,4,1616000,86.0,74,Soltero,39,2023,8,high,-1.5899999999999999,15,-1,1347232,1684,0,-2,1
102900,102115,1,Presencial,2.83,0,Hombre,Ferias & Networking,7,459832,37.0,86,Casado,41,2019,1,low,102116,Presencial,2.0,2,Mujer,Portal Web,4,1616000,94.0,76,Soltero,35,2018,12,high,-0.8300000000000001,2,-3,1156168,-13,1,-6,1
102737,102115,1,Presencial,2.66,13,Mujer,Portal Web,5,272077,37.0,70,Soltero,41,2018,7,low,102116,Presencial,2.0,2,Mujer,Portal Web,4,1616000,94.0,76,Soltero,35,2018,12,high,-0.6600000000000001,-11,-1,1343923,149,0,-6,1
103756,102109,1,Presencial,2.54,3,Hombre,Referidos,9,264252,37.0,78,Soltero,40,2018,5,low,102123,Presencial,3.86,1,Mujer,Portal Web,5,998000,97.0,82,Casado,32,2019,9,high,1.3199999999999998,-2,-4,733748,501,0,-8,1
103954,102138,1,Presencial,1.055,1,Mujer,Portal Web,4,277523,37.0,76,Casado,45,2022,7,low,102059,Presencial,3.26,1,Hombre,Linkedin,5,1616000,57.0,75,Soltero,44,2018,4,low,2.205,0,1,1338477,-1571,1,-1,1
103406,102161,1,Presencial,5.045,3,Mujer,Referidos,5,450847,37.0,77,Soltero,45,2022,4,low,102039,Presencial,3.93,5,Mujer,Portal Web,4,1409960,85.0,77,Casado,36,2016,10,high,-1.1149999999999998,2,-1,959113,-2020,1,-9,1
102913,102028,1,Presencial,1.11,0,Hombre,Referidos,10,278975,37.0,75,Casado,37,2013,12,low,102085,Presencial,1.39,2,Mujer,Linkedin,12,1358450,97.0,72,Soltero,35,2016,12,high,0.2799999999999998,2,2,1079475,1120,0,-2,0
103907,102054,1,Presencial,2.39,4,Mujer,Linkedin,8,695819,37.0,82,Soltero,45,2015,6,low,102044,Presencial,2.91,1,Hombre,Linkedin,17,1616000,85.0,74,Divorciado,41,2012,11,high,0.52,-3,9,920181,-936,1,-4,1
101705,102125,1,Presencial,1.52,3,Hombre,Portal Web,3,144799,36.0,76,Soltero,22,2021,6,low,102096,Híbrida,4.0,2,Mujer,Referidos,5,692000,87.0,82,Casado,29,2022,7,high,2.48,-1,2,547201,395,0,7,1
104016,102138,1,Presencial,6.12,3,Mujer,Portal Web,1,100176,36.0,71,Soltero,20,2022,4,low,102059,Presencial,3.26,1,Hombre,Linkedin,5,1616000,57.0,75,Soltero,44,2018,4,low,-2.8600000000000003,-2,4,1515824,-1476,1,24,1
101809,102138,1,Presencial,6.095,3,Mujer,Portal Web,1,98960,35.0,71,Soltero,20,2022,4,low,102059,Presencial,3.26,1,Hombre,Linkedin,5,1616000,57.0,75,Soltero,44,2018,4,low,-2.835,-2,4,1517040,-1475,1,24,1
101488,102111,1,Presencial,3.745,8,Mujer,Portal Web,1,104009,35.0,73,Soltero,16,2018,4,low,102097,Híbrida,2.04,1,Mujer,Referidos,15,1616000,94.0,67,Soltero,50,2021,5,high,-1.705,-7,14,1511991,1126,0,34,1
103648,102105,1,Presencial,21.005,7,Mujer,Portal Web,16,697558,35.0,76,Divorciado,48,2018,4,low,102113,Híbrida,2.07,0,Hombre,Linkedin,8,1616000,85.0,71,Viudo,45,2017,3,high,-18.935,-7,-8,918442,-397,1,-3,1
100056,102133,1,Presencial,1.215,0,Mujer,Referidos,4,296762,34.0,69,Divorciado,48,2022,11,low,102151,Híbrida,2.61,2,Hombre,Linkedin,4,1255430,98.0,65,Soltero,35,2018,2,high,1.3949999999999998,2,0,958668,-1735,1,-13,1
100960,102105,1,Presencial,21.05,7,Mujer,Portal Web,16,701359,34.0,76,Divorciado,49,2018,4,low,102113,Híbrida,2.07,0,Hombre,Linkedin,8,1616000,85.0,71,Viudo,45,2017,3,high,-18.98,-7,-8,914641,-396,1,-4,1
101033,102109,1,Presencial,3.065,1,Hombre,Ferias & Networking,7,493004,33.0,79,Soltero,38,2019,7,low,102123,Presencial,3.86,1,Mujer,Portal Web,5,998000,97.0,82,Casado,32,2019,9,high,0.7949999999999999,0,-2,504996,84,0,-6,1
103174,102110,1,Presencial,3.15,2,Mujer,Ferias & Networking,5,284905,33.0,79,Soltero,43,2018,3,low,102045,Presencial,1.6,5,Mujer,Linkedin,2,998000,87.0,76,Soltero,29,2016,11,high,-1.5499999999999998,3,-3,713095,-489,1,-14,0
103811,102133,1,Presencial,1.22,0,Mujer,Referidos,4,295132,33.0,69,Divorciado,48,2022,11,low,102151,Híbrida,2.61,2,Hombre,Linkedin,4,1255430,98.0,65,Soltero,35,2018,2,high,1.39,2,0,960298,-1735,1,-13,1
102077,102146,2,Presencial,2.27,0,Hombre,Ferias & Networking,11,1306940,31.0,64,Soltero,39,2021,6,low,102035,Presencial,2.66,0,Mujer,Portal Web,15,1616000,77.0,78,Casado,39,2013,10,low,0.3900000000000001,0,4,309060,-2806,1,0,1
102162,102146,2,Presencial,1.12,0,Mujer,Referidos,9,1616000,31.0,74,Casado,41,2022,11,low,102035,Presencial,2.66,0,Mujer,Portal Web,15,1616000,77.0,78,Casado,39,2013,10,low,1.54,0,6,0,-3327,1,-2,1
103137,102146,1,Presencial,3.93,1,Mujer,Referidos,10,407991,31.0,80,Divorciado,37,2022,10,low,102035,Presencial,2.66,0,Mujer,Portal Web,15,1616000,77.0,78,Casado,39,2013,10,low,-1.27,-1,5,1208009,-3280,1,2,0
102210,102172,1,Presencial,1.37,2,Hombre,Referidos,9,451340,31.0,79,Casado,40,2023,5,low,102020,Presencial,5.58,1,Hombre,Portal Web,7,1049000,57.0,70,Casado,29,2016,4,low,4.21,-1,-2,597660,-2570,1,-11,0
100423,102172,1,Presencial,1.4,2,Hombre,Referidos,9,446474,30.0,79,Casado,40,2023,5,low,102020,Presencial,5.58,1,Hombre,Portal Web,7,1049000,57.0,70,Casado,29,2016,4,low,4.18,-1,-2,602526,-2570,1,-11,0
101847,102039,1,Presencial,4.685,1,Mujer,Referidos,5,271221,29.0,70,Divorciado,21,2012,7,low,102054,Presencial,3.66,0,Hombre,Referidos,5,1616000,93.0,75,Viudo,49,2018,6,high,-1.0249999999999995,-1,0,1344779,2165,0,28,1
101030,102144,1,Presencial,4.095,2,Hombre,Portal Web,7,368096,29.0,83,Casado,36,2023,5,low,102156,Presencial,2.13,8,Mujer,Portal Web,11,1616000,5.0,82,Viudo,58,2015,6,low,-1.9649999999999999,6,4,1247904,-2883,1,22,1
101634,102138,1,Presencial,3.125,2,Hombre,Portal Web,12,260483,29.0,78,Casado,42,2021,10,low,102059,Presencial,3.26,1,Hombre,Linkedin,5,1616000,57.0,75,Soltero,44,2018,4,low,0.1349999999999998,-1,-7,1355517,-1300,1,2,0
100284,102132,1,Presencial,2.04,3,Hombre,Portal Web,7,260310,29.0,70,Soltero,44,2023,3,low,102138,Presencial,4.51,1,Hombre,Linkedin,16,1616000,25.0,80,Viudo,45,2014,3,low,2.4699999999999998,-2,9,1355690,-3278,1,1,1
100454,102104,1,Presencial,2.205,1,Hombre,Linkedin,13,261058,29.0,74,Soltero,39,2017,12,low,102129,Híbrida,6.72,1,Mujer,Portal Web,6,743000,91.0,61,Soltero,30,2023,4,high,4.515,0,-7,481942,1934,0,-9,1
100701,102051,1,Presencial,1.415,2,Mujer,Linkedin,8,390761,29.0,65,Divorciado,36,2014,8,low,102075,Híbrida,1.39,1,Hombre,Portal Web,11,1616000,83.0,76,Casado,46,2019,11,high,-0.025000000000000133,-1,3,1225239,1928,0,10,1
101797,102123,1,Presencial,2.765,1,Hombre,Linkedin,4,290489,29.0,75,Casado,43,2019,5,low,102043,Presencial,5.5,1,Mujer,Linkedin,16,1616000,42.0,66,Soltero,51,2021,9,low,2.735,0,12,1325511,875,0,8,1
102410,102018,1,Presencial,1.955,3,Hombre,Linkedin,5,270956,29.0,89,Soltero,20,2012,8,low,102160,Presencial,5.57,5,Hombre,Portal Web,3,692000,90.0,69,Divorciado,28,2022,2,high,3.615,2,-2,421044,3493,0,8,1
103278,102132,1,Presencial,2.07,4,Hombre,Portal Web,7,254282,29.0,70,Soltero,44,2023,3,low,102138,Presencial,4.51,1,Hombre,Linkedin,16,1616000,25.0,80,Viudo,45,2014,3,low,2.44,-3,9,1361718,-3279,1,1,0
103744,102104,1,Presencial,2.23,1,Hombre,Linkedin,13,259777,29.0,74,Soltero,39,2017,12,low,102129,Híbrida,6.72,1,Mujer,Portal Web,6,743000,91.0,61,Soltero,30,2023,4,high,4.49,0,-7,483223,1935,0,-9,1
103775,102051,1,Presencial,1.425,2,Mujer,Linkedin,8,385918,29.0,65,Divorciado,36,2014,8,low,102075,Híbrida,1.39,1,Hombre,Portal Web,11,1616000,83.0,76,Casado,46,2019,11,high,-0.03500000000000014,-1,3,1230082,1927,0,10,1
102339,102103,1,Presencial,2.215,9,Hombre,Linkedin,13,319285,29.0,70,Casado,45,2018,7,low,102023,Presencial,1.69,6,Hombre,Portal Web,3,1616000,90.0,74,Casado,45,2013,5,high,-0.5249999999999999,-3,-10,1296715,-1876,1,0,0
100649,102082,1,Presencial,1.405,3,Hombre,Portal Web,2,96994,28.0,70,Soltero,14,2016,5,low,102050,Presencial,5.5,2,Mujer,Linkedin,7,1616000,81.0,70,Casado,36,2018,8,high,4.095,-1,5,1519006,828,0,22,1
100252,102089,1,Presencial,3.28,9,Hombre,Portal Web,8,371849,28.0,78,Soltero,32,2019,1,low,102077,Presencial,2.75,1,Hombre,Ferias & Networking,6,1616000,96.0,69,Divorciado,60,2021,10,high,-0.5299999999999998,-8,-2,1244151,1003,0,28,0
101805,102158,1,Presencial,2.275,0,Hombre,Ferias & Networking,9,282419,28.0,80,Casado,45,2022,3,low,102093,Presencial,1.79,1,Mujer,Referidos,27,1900000,87.0,74,Viudo,54,2013,9,high,-0.4849999999999999,1,18,1617581,-3100,1,9,1
101569,102172,1,Presencial,2.245,1,Hombre,Referidos,12,284277,28.0,68,Soltero,47,2023,3,low,102020,Presencial,5.58,1,Hombre,Portal Web,7,1049000,57.0,70,Casado,29,2016,4,low,3.335,0,-5,764723,-2512,1,-18,0
101502,102103,1,Presencial,2.23,8,Hombre,Linkedin,15,322048,28.0,70,Casado,45,2018,7,low,102023,Presencial,1.69,6,Hombre,Portal Web,3,1616000,90.0,74,Casado,45,2013,5,high,-0.54,-2,-12,1293952,-1879,1,0,0
100568,102006,1,Presencial,4.745,2,Mujer,Ferias & Networking,10,696187,28.0,82,Divorciado,42,2012,6,low,102084,Presencial,2.58,0,Hombre,Linkedin,16,1900000,87.0,77,Viudo,57,2019,4,high,-2.165,-2,6,1203813,2495,0,15,1
101512,102059,1,Presencial,6.38,1,Hombre,Portal Web,18,721643,28.0,78,Casado,47,2015,9,low,102021,Presencial,2.55,2,Hombre,Portal Web,16,1616000,27.0,76,Viudo,50,2019,6,low,-3.83,1,-2,894357,1360,0,3,0
100471,102070,1,Presencial,6.575,9,Mujer,Portal Web,1,738558,28.0,71,Casado,48,2015,4,low,102035,Presencial,1.7,1,Mujer,Referidos,4,1616000,77.0,73,Viudo,38,2013,3,low,-4.875,-8,3,877442,-765,1,-10,1
103617,102082,1,Presencial,1.415,3,Hombre,Portal Web,2,98466,28.0,70,Soltero,14,2016,5,low,102050,Presencial,5.5,2,Mujer,Linkedin,7,1616000,81.0,70,Casado,36,2018,8,high,4.085,-1,5,1517534,828,0,22,1
102418,102110,1,Presencial,1.34,3,Mujer,Ferias & Networking,6,272402,28.0,75,Soltero,29,2021,5,low,102045,Presencial,1.6,5,Mujer,Linkedin,2,998000,87.0,76,Soltero,29,2016,11,high,0.26,2,-4,725598,-1639,1,0,1
103908,102144,1,Presencial,4.105,3,Hombre,Portal Web,6,368387,28.0,83,Casado,36,2023,5,low,102156,Presencial,2.13,8,Mujer,Portal Web,11,1616000,5.0,82,Viudo,58,2015,6,low,-1.9750000000000005,5,5,1247613,-2884,1,22,1
103846,102080,1,Presencial,3.42,2,Hombre,Portal Web,2,390911,28.0,69,Soltero,30,2016,6,low,102035,Presencial,1.93,0,Mujer,Linkedin,18,1616000,94.0,75,Viudo,47,2016,8,high,-1.49,-2,16,1225089,66,0,17,1
103403,102138,1,Presencial,3.16,1,Hombre,Portal Web,13,260684,28.0,78,Casado,42,2021,10,low,102059,Presencial,3.26,1,Hombre,Linkedin,5,1616000,57.0,75,Soltero,44,2018,4,low,0.09999999999999964,0,-8,1355316,-1301,1,2,1
103514,102152,1,Presencial,2.945,5,Hombre,Portal Web,7,300224,28.0,77,Divorciado,47,2022,12,low,102089,Presencial,2.75,5,Hombre,Portal Web,7,1616000,15.0,68,Soltero,47,2019,8,low,-0.19499999999999984,0,0,1315776,-1217,1,0,0
103180,102006,1,Presencial,4.74,2,Mujer,Ferias & Networking,10,701438,28.0,82,Divorciado,42,2012,6,low,102084,Presencial,2.58,0,Hombre,Linkedin,16,1900000,87.0,77,Viudo,57,2019,4,high,-2.16,-2,6,1198562,2494,0,15,1
102219,102070,1,Presencial,6.61,10,Mujer,Referidos,1,736958,28.0,71,Casado,48,2015,4,low,102035,Presencial,1.7,1,Mujer,Referidos,4,1616000,77.0,73,Viudo,38,2013,3,low,-4.91,-9,3,879042,-766,1,-10,0
100912,102136,1,Presencial,5.695,6,Mujer,Portal Web,1,143858,27.0,70,Soltero,20,2020,9,low,102034,Presencial,1.78,2,Hombre,Portal Web,3,1616000,89.0,78,Casado,35,2013,1,high,-3.915,-4,2,1472142,-2804,1,15,1
100556,102123,1,Presencial,7.01,3,Mujer,Portal Web,2,205064,27.0,74,Soltero,27,2021,11,low,102043,Presencial,5.5,1,Mujer,Linkedin,16,1616000,42.0,66,Soltero,51,2021,9,low,-1.5099999999999998,-2,14,1410936,-45,1,24,0
101436,102044,1,Presencial,1.305,2,Mujer,Referidos,6,327474,27.0,80,Soltero,25,2013,12,low,102155,Presencial,1.54,1,Hombre,Ferias & Networking,14,1616000,56.0,68,Soltero,47,2023,3,low,0.2350000000000001,-1,8,1288526,3382,0,22,1
101639,102134,1,Presencial,5.555,3,Hombre,Portal Web,3,294111,27.0,81,Casado,49,2023,6,low,102135,Presencial,2.25,2,Hombre,Portal Web,5,1358450,90.0,69,Viudo,31,2012,7,high,-3.3049999999999997,-1,2,1064339,-3987,1,-18,0
101299,102078,1,Presencial,4.135,4,Hombre,Linkedin,14,310851,27.0,67,Viudo,44,2018,10,low,102143,Presencial,2.17,1,Hombre,Ferias & Networking,9,998000,83.0,76,Casado,29,2017,5,high,-1.9649999999999999,-3,-5,687149,-496,1,-15,0
102059,102021,2,Presencial,2.55,2,Hombre,Portal Web,16,1616000,27.0,76,Viudo,50,2019,6,low,102069,Presencial,2.25,1,Hombre,Linkedin,8,1616000,47.0,80,Casado,52,2017,3,low,-0.2999999999999998,-1,-8,0,-812,1,2,1
100417,102021,1,Presencial,2.965,1,Mujer,Portal Web,16,894159,27.0,74,Soltero,48,2012,11,low,102069,Presencial,2.25,1,Hombre,Linkedin,8,1616000,47.0,80,Casado,52,2017,3,low,-0.7149999999999999,0,-8,721841,1603,0,4,0
104070,102136,1,Presencial,5.715,5,Mujer,Portal Web,1,139155,27.0,70,Soltero,20,2020,9,low,102034,Presencial,1.78,2,Hombre,Portal Web,3,1616000,89.0,78,Casado,35,2013,1,high,-3.9349999999999996,-3,2,1476845,-2806,1,15,1
103177,102136,1,Presencial,2.165,2,Mujer,Ferias & Networking,4,185130,27.0,80,Casado,26,2023,4,low,102034,Presencial,1.78,2,Hombre,Portal Web,3,1616000,89.0,78,Casado,35,2013,1,high,-0.385,0,-1,1430870,-3759,1,9,1
102476,102038,1,Presencial,1.92,2,Hombre,Ferias & Networking,5,207106,27.0,75,Casado,20,2014,10,low,102125,Presencial,2.06,1,Hombre,Portal Web,12,1616000,81.0,82,Casado,44,2018,1,high,0.14000000000000012,-1,7,1408894,1186,0,24,0
103615,102023,1,Presencial,1.385,8,Hombre,Portal Web,6,386799,27.0,69,Soltero,37,2013,10,low,102105,Híbrida,4.9,1,Hombre,Portal Web,4,539000,80.0,65,Casado,23,2019,12,high,3.5150000000000006,-7,-2,152201,2262,0,-14,0
102878,102078,1,Presencial,4.11,4,Hombre,Linkedin,14,312013,27.0,67,Viudo,44,2018,10,low,102143,Presencial,2.17,1,Hombre,Ferias & Networking,9,998000,83.0,76,Casado,29,2017,5,high,-1.9400000000000004,-3,-5,685987,-496,1,-15,1
102241,102109,1,Presencial,1.325,3,Mujer,Ferias & Networking,8,450958,27.0,74,Soltero,44,2018,4,low,102123,Presencial,3.86,1,Mujer,Portal Web,5,998000,97.0,82,Casado,32,2019,9,high,2.535,-2,-3,547042,537,0,-12,0
102925,102021,1,Presencial,2.92,1,Mujer,Portal Web,16,893424,27.0,74,Soltero,48,2012,11,low,102069,Presencial,2.25,1,Hombre,Linkedin,8,1616000,47.0,80,Casado,52,2017,3,low,-0.6699999999999999,0,-8,722576,1602,0,4,1
101244,102134,1,Presencial,2.16,3,Mujer,Portal Web,1,97152,26.0,73,Soltero,20,2021,12,low,102135,Presencial,2.25,2,Hombre,Portal Web,5,1358450,90.0,69,Viudo,31,2012,7,high,0.08999999999999986,-1,4,1261298,-3454,1,11,1
101981,102136,1,Presencial,2.21,2,Mujer,Ferias & Networking,4,184898,26.0,80,Casado,26,2023,4,low,102034,Presencial,1.78,2,Hombre,Portal Web,3,1616000,89.0,78,Casado,35,2013,1,high,-0.42999999999999994,0,-1,1431102,-3759,1,9,1
101061,102138,1,Presencial,6.25,1,Hombre,Referidos,6,246778,26.0,69,Casado,28,2021,7,low,102059,Presencial,3.26,1,Hombre,Linkedin,5,1616000,57.0,75,Soltero,44,2018,4,low,-2.99,0,-1,1369222,-1211,1,16,0
102081,102135,2,Presencial,2.5,2,Hombre,Portal Web,4,488000,26.0,64,Soltero,18,2015,8,low,102028,Presencial,2.04,1,Hombre,Portal Web,2,1616000,82.0,75,Divorciado,49,2017,10,high,-0.45999999999999996,-1,-2,1128000,777,0,31,1
102063,102135,2,Presencial,2.73,0,Mujer,Linkedin,1,539000,26.0,75,Soltero,24,2021,4,low,102028,Presencial,2.04,1,Hombre,Portal Web,2,1616000,82.0,75,Divorciado,49,2017,10,high,-0.69,1,1,1077000,-1284,1,25,1
100495,102135,1,Presencial,2.01,2,Mujer,Referidos,2,285963,26.0,70,Casado,31,2022,9,low,102028,Presencial,2.04,1,Hombre,Portal Web,2,1616000,82.0,75,Divorciado,49,2017,10,high,0.03000000000000025,-1,0,1330037,-1792,1,18,1
101246,102082,1,Presencial,0.835,9,Hombre,Portal Web,3,305648,26.0,74,Soltero,43,2016,9,low,102050,Presencial,5.5,2,Mujer,Linkedin,7,1616000,81.0,70,Casado,36,2018,8,high,4.665,-7,4,1310352,691,0,-7,1
103933,102134,1,Presencial,2.17,2,Mujer,Portal Web,1,100360,26.0,73,Soltero,20,2021,12,low,102135,Presencial,2.25,2,Hombre,Portal Web,5,1358450,90.0,69,Viudo,31,2012,7,high,0.08000000000000007,0,4,1258090,-3455,1,11,1
104017,102123,1,Presencial,6.99,2,Mujer,Portal Web,2,208898,26.0,74,Soltero,27,2021,11,low,102043,Presencial,5.5,1,Mujer,Linkedin,16,1616000,42.0,66,Soltero,51,2021,9,low,-1.4900000000000002,-1,14,1407102,-47,1,24,0
103901,102065,1,Presencial,2.265,5,Mujer,Portal Web,3,828523,26.0,75,Soltero,35,2015,7,low,102026,Presencial,2.44,2,Hombre,Ferias & Networking,13,1616000,45.0,60,Divorciado,35,2014,10,low,0.17499999999999982,-3,10,787477,-281,1,0,1
104089,102082,1,Presencial,0.84,9,Hombre,Portal Web,3,310357,26.0,74,Soltero,43,2016,9,low,102050,Presencial,5.5,2,Mujer,Linkedin,7,1616000,81.0,70,Casado,36,2018,8,high,4.66,-7,4,1305643,692,0,-7,1
104122,102093,1,Presencial,5.825,5,Hombre,Linkedin,6,701780,26.0,63,Casado,47,2017,1,low,102139,Presencial,5.41,0,Mujer,Ferias & Networking,4,488000,89.0,62,Soltero,23,2021,6,high,-0.41500000000000004,-5,-2,-213780,1626,0,-24,1
103493,102047,1,Presencial,2.575,1,Mujer,Portal Web,13,714730,26.0,70,Soltero,46,2014,9,low,102089,Presencial,2.67,1,Hombre,Linkedin,4,743000,14.0,70,Casado,22,2015,11,low,0.09499999999999975,0,-9,28270,421,0,-24,1
102382,102036,1,Presencial,1.93,0,Hombre,Portal Web,10,738872,26.0,79,Soltero,47,2015,5,low,102054,Presencial,1.68,8,Hombre,Portal Web,5,1616000,92.0,76,Viudo,54,2022,1,high,-0.25,8,-5,877128,2443,0,7,1
101180,102076,1,Presencial,4.075,2,Mujer,Referidos,3,271927,25.0,75,Soltero,24,2016,7,low,102168,Híbrida,1.95,1,Hombre,Referidos,9,1616000,95.0,82,Soltero,53,2023,9,high,-2.125,-1,6,1344073,2614,0,29,1
101818,102083,1,Presencial,1.59,3,Hombre,Portal Web,5,271237,25.0,75,Casado,24,2016,6,low,102147,Presencial,1.61,0,Mujer,Portal Web,5,1564490,83.0,71,Soltero,44,2021,2,high,0.020000000000000018,-3,0,1293253,1716,0,20,1
101897,102111,1,Presencial,1.56,2,Hombre,Portal Web,6,386380,25.0,75,Viudo,35,2021,3,low,102097,Híbrida,2.04,1,Mujer,Referidos,15,1616000,94.0,67,Soltero,50,2021,5,high,0.48,-1,9,1229620,66,0,15,1
101836,102091,1,Presencial,2.09,1,Mujer,Portal Web,7,385868,25.0,76,Casado,32,2017,5,low,102149,Presencial,1.54,1,Mujer,Portal Web,4,1616000,73.0,77,Casado,39,2014,12,low,-0.5499999999999998,0,-3,1230132,-868,1,7,0
100040,102051,1,Presencial,1.365,3,Hombre,Referidos,4,810261,25.0,71,Casado,36,2016,5,low,102075,Híbrida,1.39,1,Hombre,Portal Web,11,1616000,83.0,76,Casado,46,2019,11,high,0.02499999999999991,-2,7,805739,1282,0,10,0
100602,102065,1,Presencial,2.265,5,Mujer,Portal Web,3,831825,25.0,75,Soltero,35,2015,7,low,102026,Presencial,2.44,2,Hombre,Ferias & Networking,13,1616000,45.0,60,Divorciado,35,2014,10,low,0.17499999999999982,-3,10,784175,-284,1,0,1
100017,102053,1,Presencial,3.89,0,Hombre,Linkedin,4,273554,25.0,71,Casado,37,2014,3,low,102030,Presencial,1.29,0,Hombre,Portal Web,11,1616000,81.0,64,Soltero,36,2012,12,high,-2.6,0,7,1342446,-444,1,-1,0
100466,102069,1,Presencial,2.85,2,Hombre,Ferias & Networking,12,656688,25.0,70,Casado,45,2017,4,low,102069,Presencial,4.64,1,Mujer,Ferias & Networking,19,1616000,47.0,74,Casado,60,2021,10,low,1.7899999999999996,-1,7,959312,1663,0,15,1
101428,102093,1,Presencial,1.7,1,Mujer,Portal Web,6,654728,25.0,70,Soltero,45,2017,1,low,102139,Presencial,5.41,0,Mujer,Ferias & Networking,4,488000,89.0,62,Soltero,23,2021,6,high,3.71,-1,-2,-166728,1612,0,-22,0
102132,102138,2,Presencial,4.51,1,Hombre,Linkedin,16,1616000,25.0,80,Viudo,45,2014,3,low,102059,Presencial,3.26,1,Hombre,Linkedin,5,1616000,57.0,75,Soltero,44,2018,4,low,-1.25,0,-11,0,1476,0,-1,1
103242,102138,1,Presencial,6.245,1,Hombre,Referidos,6,248536,25.0,69,Casado,28,2021,7,low,102059,Presencial,3.26,1,Hombre,Linkedin,5,1616000,57.0,75,Soltero,44,2018,4,low,-2.9850000000000003,0,-1,1367464,-1210,1,16,0
103363,102076,1,Presencial,4.055,3,Mujer,Referidos,3,272285,25.0,75,Soltero,24,2016,7,low,102168,Híbrida,1.95,1,Hombre,Referidos,9,1616000,95.0,82,Soltero,53,2023,9,high,-2.1049999999999995,-2,6,1343715,2617,0,29,1
102660,102098,1,Presencial,2.825,0,Mujer,Portal Web,3,292369,25.0,69,Soltero,27,2018,6,low,102049,Presencial,1.8,1,Mujer,Portal Web,16,1616000,90.0,86,Casado,46,2021,1,high,-1.0250000000000001,1,13,1323631,963,0,19,1
102740,102051,1,Presencial,1.355,3,Hombre,Referidos,4,811738,25.0,71,Casado,36,2016,5,low,102075,Híbrida,1.39,1,Hombre,Portal Web,11,1616000,83.0,76,Casado,46,2019,11,high,0.03499999999999992,-2,7,804262,1283,0,10,1
103522,102060,1,Presencial,6.24,2,Mujer,Linkedin,10,391380,25.0,76,Soltero,38,2015,4,low,102041,Presencial,4.42,3,Hombre,Referidos,16,1616000,82.0,62,Casado,45,2013,10,high,-1.8200000000000003,1,6,1224620,-538,1,7,1
102967,102141,1,Presencial,2.06,11,Mujer,Linkedin,15,437428,25.0,66,Soltero,48,2022,5,low,102134,Presencial,1.88,1,Mujer,Linkedin,3,1100900,64.0,69,Soltero,32,2018,5,low,-0.18000000000000016,-10,-12,663472,-1448,1,-16,1
102548,102072,1,Presencial,0.71,2,Hombre,Linkedin,15,294017,25.0,78,Viudo,42,2017,12,low,102046,Presencial,2.61,2,Hombre,Ferias & Networking,3,947000,41.0,71,Soltero,30,2018,11,low,1.9,0,-12,652983,346,0,-12,0
102261,102055,1,Presencial,1.35,7,Hombre,Linkedin,12,716528,25.0,76,Viudo,47,2016,7,low,102129,Presencial,1.92,2,Hombre,Referidos,8,1616000,97.0,63,Casado,42,2013,2,high,0.5699999999999998,-5,-4,899472,-1224,1,-5,1
103757,102037,1,Presencial,3.515,8,Mujer,Portal Web,9,817385,25.0,86,Soltero,45,2013,8,low,102057,Presencial,1.12,1,Mujer,Linkedin,2,641000,50.0,76,Casado,21,2016,12,low,-2.395,-7,-7,-176385,1202,0,-24,1
102463,102085,1,Presencial,1.84,1,Hombre,Referidos,12,881751,25.0,77,Viudo,49,2016,12,low,102145,Presencial,6.59,4,Hombre,Portal Web,12,1616000,47.0,71,Casado,39,2015,8,low,4.75,3,0,734249,-494,1,-10,0
101743,102098,1,Presencial,2.825,1,Mujer,Portal Web,3,289825,24.0,69,Soltero,27,2018,6,low,102049,Presencial,1.8,1,Mujer,Portal Web,16,1616000,90.0,86,Casado,46,2021,1,high,-1.0250000000000001,0,13,1326175,964,0,19,0
100185,102075,1,Presencial,6.38,3,Mujer,Linkedin,2,285224,24.0,83,Casado,24,2015,4,low,102047,Presencial,2.7,1,Hombre,Referidos,11,1255430,90.0,76,Casado,30,2013,3,high,-3.6799999999999997,-2,9,970206,-762,1,6,0
101550,102015,1,Presencial,5.795,2,Mujer,Ferias & Networking,12,265142,24.0,79,Soltero,35,2013,2,low,102121,Presencial,6.18,1,Mujer,Referidos,10,1358450,74.0,82,Soltero,33,2014,6,low,0.3849999999999998,-1,-2,1093308,495,0,-2,1
101051,102072,1,Presencial,0.735,2,Hombre,Linkedin,15,301391,24.0,78,Viudo,42,2017,12,low,102046,Presencial,2.61,2,Hombre,Ferias & Networking,3,947000,41.0,71,Soltero,30,2018,11,low,1.875,0,-12,645609,347,0,-12,1
100939,102118,1,Presencial,2.285,2,Hombre,Linkedin,4,660125,24.0,71,Divorciado,48,2020,3,low,102171,Presencial,4.76,17,Mujer,Linkedin,4,1616000,86.0,74,Soltero,39,2023,8,high,2.4749999999999996,15,0,955875,1268,0,-9,1
102304,102096,1,Presencial,0.98,5,Mujer,Ferias & Networking,2,167940,24.0,74,Soltero,19,2017,3,low,102116,Presencial,5.11,8,Mujer,Linkedin,13,1461470,90.0,74,Soltero,42,2021,5,high,4.130000000000001,3,11,1293530,1519,0,23,1
104026,102100,1,Presencial,3.875,9,Hombre,Linkedin,6,253747,24.0,86,Soltero,40,2018,7,low,102007,Presencial,3.3,1,Mujer,Portal Web,3,1255430,21.0,59,Casado,30,2013,2,low,-0.5750000000000002,-8,-3,1001683,-1972,1,-10,1
102360,102015,1,Presencial,5.795,3,Mujer,Ferias & Networking,12,268867,24.0,79,Soltero,35,2013,2,low,102121,Presencial,6.18,1,Mujer,Referidos,10,1358450,74.0,82,Soltero,33,2014,6,low,0.3849999999999998,-2,-2,1089583,494,0,-2,0
101555,102157,1,Presencial,2.5,1,Mujer,Portal Web,8,386152,23.0,77,Casado,37,2022,12,low,102130,Presencial,0.73,1,Mujer,Portal Web,6,1616000,85.0,66,Viudo,44,2015,8,high,-1.77,0,-2,1229848,-2674,1,7,0
103402,102043,1,Presencial,5.75,1,Mujer,Portal Web,4,310314,23.0,75,Soltero,24,2014,2,low,102051,Presencial,1.03,0,Hombre,Portal Web,5,1616000,60.0,76,Casado,44,2019,5,low,-4.72,-1,1,1305686,1918,0,20,1
103783,102084,1,Presencial,5.505,2,Hombre,Portal Web,14,421268,23.0,74,Casado,38,2016,8,low,102171,Presencial,2.62,3,Mujer,Portal Web,14,1616000,89.0,76,Divorciado,50,2023,7,high,-2.885,1,0,1194732,2518,0,12,1
103607,102013,1,Presencial,2.145,7,Hombre,Portal Web,14,857251,23.0,94,Casado,47,2012,4,low,102139,Presencial,2.0,2,Mujer,Linkedin,4,743000,96.0,79,Casado,30,2022,11,high,-0.14500000000000002,-5,-10,-114251,3864,0,-17,1
101048,102007,1,Presencial,6.05,7,Hombre,Linkedin,9,267502,22.0,82,Soltero,34,2012,2,low,102070,Presencial,5.11,2,Mujer,Portal Web,6,1358450,96.0,62,Soltero,41,2022,4,high,-0.9399999999999995,-5,-3,1090948,3709,0,7,1
100910,102030,1,Presencial,1.94,1,Hombre,Portal Web,6,761140,22.0,79,Soltero,43,2013,11,low,102058,Presencial,6.34,0,Mujer,Referidos,14,1616000,90.0,76,Viudo,41,2015,4,high,4.4,-1,8,854860,524,0,-2,1
101776,102013,1,Presencial,2.16,6,Hombre,Portal Web,14,853453,22.0,94,Casado,47,2012,4,low,102139,Presencial,2.0,2,Mujer,Linkedin,4,743000,96.0,79,Casado,30,2022,11,high,-0.16000000000000014,-4,-10,-110453,3867,0,-17,1
102492,102044,1,Presencial,1.295,2,Hombre,Linkedin,2,352635,22.0,78,Casado,28,2016,1,low,102155,Presencial,1.54,1,Hombre,Ferias & Networking,14,1616000,56.0,68,Soltero,47,2023,3,low,0.2450000000000001,-1,12,1263365,2626,0,19,0
103507,102086,1,Presencial,0.99,8,Hombre,Portal Web,8,366879,22.0,75,Casado,31,2018,1,low,102085,Presencial,2.22,2,Mujer,Linkedin,7,1306940,87.0,68,Divorciado,39,2021,3,high,1.2300000000000002,-6,-1,940061,1146,0,8,1
103889,102157,1,Presencial,2.475,1,Mujer,Portal Web,8,389827,22.0,77,Casado,37,2022,12,low,102130,Presencial,0.73,1,Mujer,Portal Web,6,1616000,85.0,66,Viudo,44,2015,8,high,-1.745,0,-2,1226173,-2675,1,7,0
102636,102100,1,Presencial,1.545,0,Mujer,Headhunter,11,287184,22.0,74,Casado,42,2019,3,low,102007,Presencial,3.3,1,Mujer,Portal Web,3,1255430,21.0,59,Casado,30,2013,2,low,1.755,1,-8,968246,-2211,1,-12,0
102827,102074,1,Presencial,1.74,2,Hombre,Portal Web,14,273998,22.0,86,Casado,41,2018,4,low,102028,Presencial,1.35,0,Hombre,Ferias & Networking,4,1616000,80.0,83,Viudo,43,2015,12,high,-0.3899999999999999,-2,-10,1342002,-826,1,2,0
100342,102077,1,Presencial,1.56,2,Hombre,Portal Web,8,253324,21.0,78,Soltero,24,2016,12,low,102146,Presencial,2.27,0,Hombre,Ferias & Networking,11,1306940,31.0,64,Soltero,39,2021,6,low,0.71,-2,3,1053616,1663,0,15,0
102100,102007,2,Presencial,3.3,1,Mujer,Portal Web,3,1255430,21.0,59,Casado,30,2013,2,low,102070,Presencial,5.11,2,Mujer,Portal Web,6,1358450,96.0,62,Soltero,41,2022,4,high,1.8100000000000005,1,3,103020,3355,0,11,1
101443,102007,1,Presencial,5.045,6,Mujer,Portal Web,5,677754,21.0,88,Divorciado,42,2012,9,low,102070,Presencial,5.11,2,Mujer,Portal Web,6,1358450,96.0,62,Soltero,41,2022,4,high,0.06500000000000039,-4,1,680696,3504,0,-1,0
102620,102049,1,Presencial,1.655,2,Mujer,Ferias & Networking,12,491327,21.0,74,Casado,34,2014,12,low,102029,Presencial,6.89,0,Mujer,Portal Web,9,1616000,19.0,77,Divorciado,49,2023,3,low,5.234999999999999,-2,-3,1124673,3000,0,15,1
103185,102030,1,Presencial,8.11,2,Hombre,Ferias & Networking,8,675092,21.0,82,Soltero,42,2013,10,low,102058,Presencial,6.34,0,Mujer,Referidos,14,1616000,90.0,76,Viudo,41,2015,4,high,-1.7699999999999996,-2,6,940908,556,0,-1,1
101094,102025,1,Presencial,4.345,3,Hombre,Ferias & Networking,6,250146,20.0,77,Casado,20,2012,11,low,102132,Presencial,1.6,0,Hombre,Portal Web,9,1616000,90.0,81,Viudo,56,2018,4,high,-2.7449999999999997,-3,3,1365854,1948,0,36,1
100164,102052,1,Presencial,0.955,8,Hombre,Portal Web,4,325174,20.0,84,Casado,25,2014,4,low,102093,Presencial,4.45,0,Hombre,Linkedin,5,641000,84.0,76,Divorciado,17,2012,4,high,3.495,-8,1,315826,-752,1,-8,1
101265,102051,1,Presencial,1.96,2,Hombre,Portal Web,9,280956,20.0,75,Soltero,36,2013,4,low,102075,Híbrida,1.39,1,Hombre,Portal Web,11,1616000,83.0,76,Casado,46,2019,11,high,-0.5700000000000001,-1,2,1335044,2410,0,10,1
102665,102052,1,Presencial,0.99,8,Hombre,Portal Web,4,331580,20.0,84,Casado,25,2014,4,low,102093,Presencial,4.45,0,Hombre,Linkedin,5,641000,84.0,76,Divorciado,17,2012,4,high,3.46,-8,1,309420,-751,1,-8,1
101697,102136,1,Presencial,3.155,1,Hombre,Referidos,1,96297,19.0,78,Soltero,18,2020,5,low,102034,Presencial,1.78,2,Hombre,Portal Web,3,1616000,89.0,78,Casado,35,2013,1,high,-1.3749999999999998,1,2,1519703,-2683,1,17,0
100738,102042,1,Presencial,1.505,3,Mujer,Portal Web,1,96434,19.0,73,Soltero,12,2014,10,low,102107,Presencial,2.19,2,Hombre,Ferias & Networking,8,1616000,38.0,78,Divorciado,57,2018,6,low,0.685,-1,7,1519566,1343,0,45,1
101387,102062,1,Presencial,5.38,1,Hombre,Linkedin,3,490625,19.0,77,Divorciado,36,2017,4,low,102149,Presencial,0.92,2,Mujer,Referidos,6,692000,38.0,72,Soltero,21,2014,10,low,-4.46,1,3,201375,-941,1,-15,1
100832,102038,1,Presencial,1.95,0,Hombre,Portal Web,12,765779,19.0,75,Divorciado,35,2014,12,low,102125,Presencial,2.06,1,Hombre,Portal Web,12,1616000,81.0,82,Casado,44,2018,1,high,0.1100000000000001,1,0,850221,1129,0,9,0
101073,102162,1,Presencial,1.76,2,Mujer,Referidos,9,306950,19.0,77,Soltero,49,2023,4,low,102146,Presencial,1.12,0,Mujer,Referidos,9,1616000,31.0,74,Casado,41,2022,11,low,-0.6399999999999999,-2,0,1309050,-149,1,-8,0
102049,102029,2,Presencial,6.89,0,Mujer,Portal Web,9,1616000,19.0,77,Divorciado,49,2023,3,low,102132,Presencial,5.79,2,Hombre,Portal Web,16,1616000,80.0,84,Casado,49,2017,9,high,-1.0999999999999996,2,7,0,-2003,1,0,1
103576,102029,1,Presencial,3.275,3,Mujer,Linkedin,2,138788,19.0,82,Soltero,12,2012,12,low,102132,Presencial,5.79,2,Hombre,Portal Web,16,1616000,80.0,84,Casado,49,2017,9,high,2.515,-1,14,1477212,1736,0,37,1
103794,102113,1,Presencial,1.98,1,Mujer,Portal Web,7,429376,19.0,81,Soltero,37,2021,2,low,102041,Presencial,2.96,2,Hombre,Portal Web,6,1152410,46.0,75,Casado,27,2012,1,low,0.98,1,-1,723034,-3315,1,-10,1
100138,102113,1,Presencial,1.985,2,Mujer,Portal Web,7,431116,18.0,81,Soltero,37,2021,2,low,102041,Presencial,2.96,2,Hombre,Portal Web,6,1152410,46.0,75,Casado,27,2012,1,low,0.9749999999999999,0,-1,721294,-3313,1,-10,1
104170,102042,1,Presencial,1.52,3,Mujer,Portal Web,1,99915,18.0,73,Soltero,12,2014,10,low,102107,Presencial,2.19,2,Hombre,Ferias & Networking,8,1616000,38.0,78,Divorciado,57,2018,6,low,0.6699999999999999,-1,7,1516085,1342,0,45,1
103971,102129,1,Presencial,4.465,4,Hombre,Portal Web,2,245268,18.0,78,Soltero,28,2021,10,low,102142,Presencial,2.1,2,Mujer,Linkedin,3,590000,41.0,74,Soltero,24,2020,1,low,-2.3649999999999998,-2,1,344732,-636,1,-4,1
102500,102065,1,Presencial,3.68,6,Hombre,Linkedin,3,392468,18.0,80,Divorciado,31,2017,1,low,102026,Presencial,2.44,2,Hombre,Ferias & Networking,13,1616000,45.0,60,Divorciado,35,2014,10,low,-1.2400000000000002,-4,10,1223532,-846,1,4,1
102770,102038,1,Presencial,1.955,0,Hombre,Portal Web,12,766885,18.0,75,Divorciado,35,2014,12,low,102125,Presencial,2.06,1,Hombre,Portal Web,12,1616000,81.0,82,Casado,44,2018,1,high,0.10499999999999998,1,0,849115,1127,0,9,1
100254,102073,1,Presencial,4.495,1,Hombre,Portal Web,8,397743,17.0,68,Casado,40,2017,10,low,102139,Presencial,1.98,2,Hombre,Portal Web,11,1306940,95.0,86,Soltero,37,2019,7,high,-2.515,1,3,909197,623,0,-3,0
104083,102028,1,Presencial,2.05,2,Hombre,Portal Web,4,279889,17.0,82,Soltero,36,2013,4,low,102085,Presencial,1.39,2,Mujer,Linkedin,12,1358450,97.0,72,Soltero,35,2016,12,high,-0.6599999999999999,0,8,1078561,1342,0,-1,1
102197,102073,1,Presencial,4.48,1,Hombre,Portal Web,8,395603,16.0,68,Casado,40,2017,10,low,102139,Presencial,1.98,2,Hombre,Portal Web,11,1306940,95.0,86,Soltero,37,2019,7,high,-2.5000000000000004,1,3,911337,624,0,-3,0
101882,102144,1,Presencial,3.21,1,Mujer,Linkedin,5,431905,15.0,75,Casado,46,2022,10,low,102156,Presencial,2.13,8,Mujer,Portal Web,11,1616000,5.0,82,Viudo,58,2015,6,low,-1.08,7,6,1184095,-2657,1,12,0
102152,102089,2,Presencial,2.75,5,Hombre,Portal Web,7,1616000,15.0,68,Soltero,47,2019,8,low,102077,Presencial,2.75,1,Hombre,Ferias & Networking,6,1616000,96.0,69,Divorciado,60,2021,10,high,0.0,-4,-1,0,778,0,13,1
102047,102089,2,Presencial,2.67,1,Hombre,Linkedin,4,743000,14.0,70,Casado,22,2015,11,low,102077,Presencial,2.75,1,Hombre,Ferias & Networking,6,1616000,96.0,69,Divorciado,60,2021,10,high,0.08000000000000007,0,2,873000,2155,0,38,1
102747,102089,1,Presencial,1.85,2,Mujer,Referidos,8,285963,13.0,81,Casado,26,2016,8,low,102077,Presencial,2.75,1,Hombre,Ferias & Networking,6,1616000,96.0,69,Divorciado,60,2021,10,high,0.8999999999999999,-1,-2,1330037,1889,0,34,1
100824,102147,1,Presencial,6.51,8,Mujer,Portal Web,15,294641,12.0,79,Soltero,47,2022,3,low,102057,Presencial,1.58,2,Hombre,Portal Web,4,1616000,90.0,80,Casado,49,2022,12,high,-4.93,-6,-11,1321359,283,0,2,1
103863,102147,1,Presencial,6.52,8,Mujer,Portal Web,15,301334,12.0,79,Soltero,47,2022,3,low,102057,Presencial,1.58,2,Hombre,Portal Web,4,1616000,90.0,80,Casado,49,2022,12,high,-4.9399999999999995,-6,-11,1314666,281,0,2,1
102945,102154,1,Presencial,1.21,1,Hombre,Portal Web,6,738060,12.0,77,Divorciado,55,2023,5,low,102172,Presencial,5.45,1,Hombre,Portal Web,7,1512980,93.0,69,Soltero,39,2017,10,high,4.24,0,1,774920,-2037,1,-16,0
103973,102157,1,Presencial,4.735,2,Mujer,Linkedin,12,715749,11.0,81,Soltero,53,2022,6,low,102130,Presencial,0.73,1,Mujer,Portal Web,6,1616000,85.0,66,Viudo,44,2015,8,high,-4.005000000000001,-1,-6,900251,-2496,1,-9,1
100595,102109,1,Presencial,2.47,1,Mujer,Portal Web,18,721031,8.0,75,Viudo,52,2021,4,low,102123,Presencial,3.86,1,Mujer,Portal Web,5,998000,97.0,82,Casado,32,2019,9,high,1.3899999999999997,0,-13,276969,-566,1,-20,1
102144,102156,2,Presencial,2.13,8,Mujer,Portal Web,11,1616000,5.0,82,Viudo,58,2015,6,low,102154,Presencial,4.23,2,Hombre,Portal Web,22,1616000,92.0,76,Soltero,63,2023,12,high,2.1000000000000005,-6,11,0,3097,0,5,1
101393,102156,1,Presencial,1.795,1,Hombre,Referidos,1,116277,80.0,80,Soltero,23,2023,7,high,102154,Presencial,4.23,2,Hombre,Portal Web,22,1616000,92.0,76,Soltero,63,2023,12,high,2.4350000000000005,1,21,1499723,158,0,40,0
101551,102169,1,Presencial,2.64,1,Mujer,Portal Web,3,136273,80.0,74,Soltero,24,2023,9,high,102115,Presencial,2.24,7,Mujer,Linkedin,11,1616000,93.0,74,Soltero,55,2021,4,high,-0.3999999999999999,6,8,1479727,-900,1,31,1
100307,102146,1,Presencial,5.885,3,Mujer,Portal Web,2,136088,80.0,76,Soltero,23,2023,8,high,102035,Presencial,2.66,0,Mujer,Portal Web,15,1616000,77.0,78,Casado,39,2013,10,low,-3.2249999999999996,-3,13,1479912,-3598,1,16,0
100075,102150,1,Presencial,2.585,3,Mujer,Linkedin,2,159750,80.0,76,Soltero,24,2023,7,high,102085,Presencial,3.9,8,Mujer,Portal Web,10,1358450,85.0,75,Casado,32,2012,12,high,1.315,5,8,1198700,-3865,1,8,1
100253,102167,1,Presencial,1.97,3,Mujer,Portal Web,2,163500,80.0,67,Soltero,26,2023,9,high,102092,Presencial,5.7,2,Hombre,Ferias & Networking,2,794000,59.0,64,Casado,27,2019,3,low,3.7300000000000004,-1,0,630500,-1640,1,1,1
100041,102139,1,Presencial,2.285,0,Hombre,Ferias & Networking,2,168580,80.0,65,Soltero,26,2023,8,high,102154,Presencial,6.48,1,Hombre,Ferias & Networking,5,590000,90.0,67,Casado,25,2021,6,high,4.195,1,3,421420,-772,1,-1,1
100872,102136,1,Presencial,5.61,6,Hombre,Linkedin,1,184839,80.0,76,Soltero,26,2023,7,high,102034,Presencial,1.78,2,Hombre,Portal Web,3,1616000,89.0,78,Casado,35,2013,1,high,-3.83,-4,2,1431161,-3842,1,9,0
101880,102146,1,Presencial,2.09,2,Mujer,Linkedin,3,186980,80.0,82,Casado,28,2023,8,high,102035,Presencial,2.66,0,Mujer,Portal Web,15,1616000,77.0,78,Casado,39,2013,10,low,0.5700000000000003,-2,12,1429020,-3574,1,11,0
100950,102172,1,Presencial,1.235,2,Hombre,Portal Web,1,228795,80.0,79,Casado,30,2023,10,high,102020,Presencial,5.58,1,Hombre,Portal Web,7,1049000,57.0,70,Casado,29,2016,4,low,4.345,-1,6,820205,-2737,1,-1,0
101358,102141,1,Presencial,2.835,1,Hombre,Referidos,6,253168,80.0,75,Casado,30,2023,8,high,102134,Presencial,1.88,1,Mujer,Linkedin,3,1100900,64.0,69,Soltero,32,2018,5,low,-0.9550000000000001,0,-3,847732,-1894,1,2,1
101889,102140,1,Presencial,2.65,7,Mujer,Linkedin,6,285259,80.0,72,Soltero,32,2023,12,high,102040,Presencial,2.55,0,Mujer,Portal Web,16,1616000,46.0,69,Casado,39,2012,2,low,-0.10000000000000009,-7,10,1330741,-4316,1,7,0
101943,102172,1,Presencial,5.15,3,Mujer,Linkedin,1,430802,80.0,70,Casado,39,2023,12,high,102020,Presencial,5.58,1,Hombre,Portal Web,7,1049000,57.0,70,Casado,29,2016,4,low,0.4299999999999997,-2,6,618198,-2780,1,-10,1
100269,102139,1,Presencial,6.435,4,Hombre,Linkedin,4,405355,80.0,77,Casado,38,2023,10,high,102154,Presencial,6.48,1,Hombre,Ferias & Networking,5,590000,90.0,67,Casado,25,2021,6,high,0.04500000000000082,-3,1,184645,-833,1,-13,1
100496,102171,1,Presencial,4.12,2,Mujer,Ferias & Networking,7,262213,80.0,80,Casado,45,2023,7,high,102088,Presencial,2.57,4,Hombre,Linkedin,8,1616000,80.0,69,Casado,43,2017,10,high,-1.5500000000000003,2,1,1353787,-2113,1,-2,1
101041,102172,1,Presencial,0.805,12,Mujer,Linkedin,13,457755,80.0,82,Casado,46,2023,7,high,102020,Presencial,5.58,1,Hombre,Portal Web,7,1049000,57.0,70,Casado,29,2016,4,low,4.775,-11,-6,591245,-2652,1,-17,1
100179,102171,1,Presencial,1.995,9,Mujer,Portal Web,3,282183,80.0,65,Casado,47,2023,12,high,102088,Presencial,2.57,4,Hombre,Linkedin,8,1616000,80.0,69,Casado,43,2017,10,high,0.5749999999999997,-5,5,1333817,-2272,1,-4,1
102095,102171,2,Presencial,3.28,2,Mujer,Portal Web,3,1616000,80.0,75,Soltero,42,2023,10,high,102088,Presencial,2.57,4,Hombre,Linkedin,8,1616000,80.0,69,Casado,43,2017,10,high,-0.71,2,5,0,-2195,1,1,1
101365,102171,1,Presencial,1.16,2,Hombre,Referidos,11,284107,80.0,74,Divorciado,48,2023,10,high,102088,Presencial,2.57,4,Hombre,Linkedin,8,1616000,80.0,69,Casado,43,2017,10,high,1.41,2,-3,1331893,-2217,1,-5,0
101799,102171,1,Presencial,5.935,2,Hombre,Linkedin,5,303806,80.0,77,Divorciado,49,2023,8,high,102088,Presencial,2.57,4,Hombre,Linkedin,8,1616000,80.0,69,Casado,43,2017,10,high,-3.3649999999999998,2,3,1312194,-2148,1,-6,1
100986,102155,1,Presencial,1.63,2,Hombre,Portal Web,11,633863,80.0,66,Soltero,51,2023,7,high,102159,Presencial,1.78,1,Mujer,Ferias & Networking,1,590000,39.0,80,Soltero,20,2016,10,low,0.15000000000000013,-1,-10,-43863,-2458,1,-31,1
100670,102139,1,Presencial,3.405,4,Mujer,Portal Web,3,636788,80.0,71,Casado,50,2023,7,high,102154,Presencial,6.48,1,Hombre,Ferias & Networking,5,590000,90.0,67,Casado,25,2021,6,high,3.0750000000000006,-3,2,-46788,-748,1,-25,1
102120,102171,2,Presencial,6.48,2,Hombre,Ferias & Networking,9,1616000,80.0,71,Casado,47,2023,8,high,102088,Presencial,2.57,4,Hombre,Linkedin,8,1616000,80.0,69,Casado,43,2017,10,high,-3.9100000000000006,2,-1,0,-2141,1,-4,1
101454,102171,1,Presencial,2.765,1,Mujer,Portal Web,5,681414,80.0,66,Divorciado,53,2023,9,high,102088,Presencial,2.57,4,Hombre,Linkedin,8,1616000,80.0,69,Casado,43,2017,10,high,-0.19500000000000028,3,3,934586,-2181,1,-10,1
100756,102161,1,Presencial,2.995,2,Mujer,Portal Web,16,698985,80.0,69,Soltero,53,2023,11,high,102039,Presencial,3.93,5,Mujer,Portal Web,4,1409960,85.0,77,Casado,36,2016,10,high,0.935,3,-12,710975,-2580,1,-17,1
101334,102171,1,Presencial,4.73,1,Hombre,Linkedin,9,760167,80.0,85,Casado,56,2023,12,high,102088,Presencial,2.57,4,Hombre,Linkedin,8,1616000,80.0,69,Casado,43,2017,10,high,-2.1600000000000006,3,-1,855833,-2261,1,-13,0
102912,102162,1,Presencial,5.905,7,Mujer,Portal Web,1,81009,80.0,76,Soltero,21,2023,10,high,102146,Presencial,1.12,0,Mujer,Referidos,9,1616000,31.0,74,Casado,41,2022,11,low,-4.785,-7,8,1534991,-326,1,20,1
103307,102156,1,Presencial,1.805,2,Hombre,Referidos,2,123287,80.0,80,Soltero,22,2023,7,high,102154,Presencial,4.23,2,Hombre,Portal Web,22,1616000,92.0,76,Soltero,63,2023,12,high,2.4250000000000007,0,20,1492713,157,0,41,1
103076,102169,1,Presencial,2.65,0,Mujer,Portal Web,3,138269,80.0,74,Soltero,24,2023,9,high,102115,Presencial,2.24,7,Mujer,Linkedin,11,1616000,93.0,74,Soltero,55,2021,4,high,-0.4099999999999997,7,8,1477731,-901,1,31,1
102628,102146,1,Presencial,5.915,3,Mujer,Portal Web,2,141556,80.0,76,Soltero,23,2023,8,high,102035,Presencial,2.66,0,Mujer,Portal Web,15,1616000,77.0,78,Casado,39,2013,10,low,-3.255,-3,13,1474444,-3596,1,16,1
102812,102171,1,Presencial,6.3,6,Hombre,Portal Web,4,165646,80.0,69,Soltero,26,2023,9,high,102088,Presencial,2.57,4,Hombre,Linkedin,8,1616000,80.0,69,Casado,43,2017,10,high,-3.73,-2,4,1450354,-2171,1,17,1
103865,102139,1,Presencial,2.275,1,Hombre,Ferias & Networking,5,161109,80.0,65,Soltero,26,2023,8,high,102154,Presencial,6.48,1,Hombre,Ferias & Networking,5,590000,90.0,67,Casado,25,2021,6,high,4.205,0,0,428891,-773,1,-1,0
103634,102171,1,Presencial,2.83,11,Mujer,Portal Web,4,187804,80.0,69,Casado,26,2023,7,high,102088,Presencial,2.57,4,Hombre,Linkedin,8,1616000,80.0,69,Casado,43,2017,10,high,-0.26000000000000023,-7,4,1428196,-2098,1,17,1
102694,102146,1,Presencial,2.115,1,Mujer,Linkedin,3,191369,80.0,82,Casado,28,2023,8,high,102035,Presencial,2.66,0,Mujer,Portal Web,15,1616000,77.0,78,Casado,39,2013,10,low,0.5449999999999999,-1,12,1424631,-3576,1,11,1
102683,102142,1,Presencial,2.635,2,Hombre,Portal Web,1,212094,80.0,71,Casado,29,2023,11,high,102047,Presencial,2.48,2,Hombre,Portal Web,3,1255430,90.0,66,Soltero,36,2019,7,high,-0.1549999999999998,0,2,1043336,-1601,1,7,0
102407,102172,1,Presencial,1.245,2,Hombre,Portal Web,1,227719,80.0,79,Casado,30,2023,10,high,102020,Presencial,5.58,1,Hombre,Portal Web,7,1049000,57.0,70,Casado,29,2016,4,low,4.335,-1,6,821281,-2736,1,-1,1
103483,102170,1,Presencial,3.17,0,Hombre,Linkedin,1,249545,80.0,79,Soltero,31,2023,8,high,102055,Presencial,1.62,0,Mujer,Portal Web,8,1616000,78.0,72,Viudo,48,2013,2,low,-1.5499999999999998,0,7,1366455,-3827,1,17,1
103416,102141,1,Presencial,2.83,1,Hombre,Referidos,6,250379,80.0,75,Casado,30,2023,8,high,102134,Presencial,1.88,1,Mujer,Linkedin,3,1100900,64.0,69,Soltero,32,2018,5,low,-0.9500000000000002,0,-3,850521,-1896,1,2,1
104087,102140,1,Presencial,2.7,8,Mujer,Linkedin,6,293621,80.0,72,Soltero,32,2023,12,high,102040,Presencial,2.55,0,Mujer,Portal Web,16,1616000,46.0,69,Casado,39,2012,2,low,-0.15000000000000036,-8,10,1322379,-4315,1,7,0
103782,102150,1,Presencial,1.995,1,Hombre,Portal Web,5,289247,80.0,66,Casado,32,2023,8,high,102085,Presencial,3.9,8,Mujer,Portal Web,10,1358450,85.0,75,Casado,32,2012,12,high,1.9049999999999998,7,5,1069203,-3904,1,0,1
103243,102162,1,Presencial,3.29,2,Hombre,Referidos,2,347710,80.0,83,Casado,36,2023,10,high,102146,Presencial,1.12,0,Mujer,Referidos,9,1616000,31.0,74,Casado,41,2022,11,low,-2.17,-2,7,1268290,-323,1,5,1
103459,102172,1,Presencial,5.11,2,Mujer,Linkedin,1,426476,80.0,70,Casado,39,2023,11,high,102020,Presencial,5.58,1,Hombre,Portal Web,7,1049000,57.0,70,Casado,29,2016,4,low,0.46999999999999975,-1,6,622524,-2777,1,-10,1
103472,102171,1,Presencial,1.445,1,Mujer,Headhunter,11,410255,80.0,85,Soltero,39,2023,8,high,102088,Presencial,2.57,4,Hombre,Linkedin,8,1616000,80.0,69,Casado,43,2017,10,high,1.1249999999999998,3,-3,1205745,-2154,1,4,1
104138,102158,1,Presencial,0.87,2,Hombre,Portal Web,6,426818,80.0,74,Casado,40,2023,9,high,102093,Presencial,1.79,1,Mujer,Referidos,27,1900000,87.0,74,Viudo,54,2013,9,high,0.92,-1,21,1473182,-3641,1,14,1
103830,102171,1,Presencial,1.855,6,Mujer,Linkedin,10,485352,80.0,75,Soltero,43,2023,9,high,102088,Presencial,2.57,4,Hombre,Linkedin,8,1616000,80.0,69,Casado,43,2017,10,high,0.7149999999999999,-2,-2,1130648,-2179,1,0,1
102926,102171,1,Presencial,4.11,3,Mujer,Ferias & Networking,7,258640,80.0,80,Casado,45,2023,7,high,102088,Presencial,2.57,4,Hombre,Linkedin,8,1616000,80.0,69,Casado,43,2017,10,high,-1.5400000000000005,1,1,1357360,-2112,1,-2,1
102717,102172,1,Presencial,1.98,1,Hombre,Portal Web,3,268197,80.0,79,Casado,45,2023,7,high,102020,Presencial,5.58,1,Hombre,Portal Web,7,1049000,57.0,70,Casado,29,2016,4,low,3.6,0,4,780803,-2627,1,-16,1
103567,102171,1,Presencial,1.965,8,Mujer,Portal Web,3,281159,80.0,65,Casado,47,2023,12,high,102088,Presencial,2.57,4,Hombre,Linkedin,8,1616000,80.0,69,Casado,43,2017,10,high,0.6049999999999998,-4,5,1334841,-2270,1,-4,1
104098,102172,1,Presencial,0.805,12,Mujer,Linkedin,13,460337,80.0,82,Casado,46,2023,7,high,102020,Presencial,5.58,1,Hombre,Portal Web,7,1049000,57.0,70,Casado,29,2016,4,low,4.775,-11,-6,588663,-2650,1,-17,1
103987,102155,1,Presencial,1.625,1,Hombre,Portal Web,11,633879,80.0,66,Soltero,51,2023,7,high,102159,Presencial,1.78,1,Mujer,Ferias & Networking,1,590000,39.0,80,Soltero,20,2016,10,low,0.15500000000000003,0,-10,-43879,-2457,1,-31,1
103810,102141,1,Presencial,5.665,2,Hombre,Portal Web,6,793977,80.0,80,Casado,52,2023,8,high,102134,Presencial,1.88,1,Mujer,Linkedin,3,1100900,64.0,69,Soltero,32,2018,5,low,-3.785,-1,-3,306923,-1923,1,-20,1
102441,102171,1,Presencial,4.73,1,Hombre,Linkedin,9,756101,80.0,85,Casado,56,2023,12,high,102088,Presencial,2.57,4,Hombre,Linkedin,8,1616000,80.0,69,Casado,43,2017,10,high,-2.1600000000000006,3,-1,859899,-2261,1,-13,1
